...............................................................................................................................................
.   ...  .. . .  . ..   .   ...  .. ...  . ..... X.    . . .. .  . .... .  . . .  ...  ...  .  ..  ... . ... . .     ..   .    ... .  ... . . .
... .   .   . .  .   . . ......      ..    . . . .    ...  . ....  .    ..  ..  . .. ....  .....   .  ..  ... . ...      . . . ..  . . . ..  ..
. ..       .  . ..  ..  ...     .... . ..  .. . .....   ...  . ... .  ......   .  . ..  .  .   .... . ...... ...   . . . ..   .  . . ......   .
.  . ..  .  .  .      .   .  .. .   .  .  .  ..  .  .... ..  . .... .  . . .   ...  . .. .   ...   . ... . . ..... .  .. . .. .. .. ..  ..   ..
. . ... .... . . .. .  .  . ..   . .  .   .  ...    . . .  .. ..    ...    ..  .. .  .. ... .. . ... . ..   ... . .. ..  ...  ..   .  .  ..  ..
.   .. . . . .  . ...  .    ..   ...  ... ... ..  .    .... .  . . . ... ..  ...   .  .  .  .  . .  ......  ... .    .   .   .   ..  .   .   ..
.   . .. .    .   .. . .. .. ..   .. ... ....     .. .. .  . . ... ... .   . .. . .  . .   . .   . ..... ....  .  .  ..     .. ... ..  .    . .
.  ..        ...  . ..... . .  ... . .. .. . ...  . .. .  ..  ... .. .. ..  . .  .  .. ..  ... . ..  ...  .... .. .  .   . .. .. .     .. . ...
. ..    ....     ...  ... .  . ...  . ....   ... .  ..   . .  ..   ....  .   .... ..  ...  ... . . .  .   . .   ..    . .. .... .. . . .    ...
.   .. . ......   ....      .. ...   ..   ........ . .    . .   . ....  ...  ....  .      . ... ..      . . .   . .   ..    .  . .     .  . . .
. . ....  . .. .. . ..   .  ....    ... ..   .. .. .    .   .   ...   .  ... .    ...  .  . ... ....... ...      ..   . . ..   . ... ..   . ...
.... .     . ..   .... ..     .. .. ...... .   ..   . .   .....  . ... .   ..   ...       .. ..  ..  .    .... .. .     .  .... ... ....    ...
....  . ...  .. . . .   .. .  ... .  . .  .  .  .  .   . . .  ..  . .. .  ... . ..  .. .   .. .. . . .... . . . .. .      .. .    . ...  .    .
.... .   . . .. . . . ..   . . .. ....... . . .     .... ........ .. . ... .  .. . .  ..  . . .....     ... . ...  .    ..... .....  .     .. .
..... . ..  ... . . .  . ..      .. ...  .    .... ..  .  .  .  ...  . ..  .    .. ....... . .   . ... ... .   .  .  .. .  .  ..   .  ..  . . .
...............................................................................................................................................
