...........................................................................................................................................
..   .  .   .  .    .. .         ...  .         .  .     .             .         .  .    .  ..       .   .   ...   .  .   .               .
.     .    ...       .        ..    ...     ... .     .     . .  .     ..          .       .            .        .   .     .     .       ..
.   . .     .  .  .     ..   . .. . .  .            .      ..   . . X  . .        .    .      .                 ..    .     . .           .
.       .      . . . .    . . .  .   . . .                  . .        . .               .   .  ...  ...    .   .      .    ...     ..    .
.   ..  ..  .   ...    .       .   .     .   .      .  .. .          . ..  .    .        .       .           .       .        .        . ..
.    .                .       .       .      ..  .. . .  .      .    .   .  .      ..     . .         .    . ..  .         . .         .  .
.   ..                                .       .        . ..            . ...  .  .   .  .   .      ..  .   . ..   ..  ..       .          .
. .      .  .   .     .  .      .         .      . .              .               .    .. .    .  .  .             .    .   .           . .
..         . .  .                    ..    . .           .   .  . ..             ....  .    .     .. ..    ..     .                    .  .
. .            .. .   .      .    . ..     ..      .  .       .    .  .       .        . .    .     .. .  .     .             .  . . .    .
.           .  .   .         .      .    .        .     .    .             . .      .      .  .     .   .                      .   .    . .
.   .      .  . .            .  .      .       ....       .       .   .    .         . .  .   .         ..  .. . ..  .        . .. .      .
...........................................................................................................................................
