..................
.                .
.     .          .
.  .         .   .
.                .
.        X       .
.                .
.  .    ..       .
.  .            ..
. .          .   .
.               ..
.      .         .
..        .  .   .
.   . .        . .
.       .        .
.         .      .
.        ..   .. .
.                .
.   .           ..
.     .          .
.                .
.                .
.  .             .
..  . .       .  .
.      . .  .    .
.  ..            .
.    . .. .      .
..      .    .  ..
..................
