......................................................................................................................
.     .                              .    .           ..             .. .              .                      . .    .
.                .               .  .    .                                   .                                       .
.                                 .      .  .       ..     .  .                .          .                          .
.             .          .         .           .     .                                   .          .              . .
.                    .                            .              .                        .       .                  .
.                                            .          .      .  .  .     . .          .                   .     . ..
.    .                                    .                        .            .     .          .              .    .
.         ..      .               .                 .          .       .     .        .            .    .   .      . .
.          . .             .                .       .  .   .            .     .           .          .          .    .
.   .                   .                                      .     .  .                 . ..        .              .
..       .               .     .         .                 .            .            .  .           .  .     . .  .  .
...      .             .                                .     .                              .       .       .       .
.            .               .                         .                .   .  .                          . .       ..
.     .          .  . .           .                   .                .                            .     .  ..      .
.                                      .                           .     .     .          .                .    .    .
.  .                .     .                    .   .                    . .                   ..     .  .    .       .
.  .                            .                   .        . .        .        ..        .  . .  .                 .
.    .  . .                 .      .                        .          .    .      .             .       .    .     ..
.      .                .  .        .                   .        . .            .                 .         ..       .
..                       .         .   .         .                      .         . .        X   .  .  .             .
..                               .      .    .   .                                                                   .
......................................................................................................................
