......................................................................................................................................
. . ..      .. . .. . ... . ....    .    .... ........  . . .  ... .  . .  .  ... ... ..  . ....  .. ...   . ...  . .      .  .. ..  .
.  ...... ...    . . .. ... .  .  .   ..... . .. . ..  .  .  ... .. ...  . .  .. ..  .  .. ..... .   . .  .  ... .   ...        ......
... .  .. . ..       ...... ....  . . . .. ..    ...   .  .. .   . . ...  ... . . .. .. .....  .. .. .  ...   . ... .  ..  . ... ..  .
... ...  . .   . .     .... .... ..    ..  . ..  .. .. . .  . .. ..    .. . .. .  .. ...    ..  .    . .   ..  ......  . . . .. . .. .
.. ..... .. ....   .. .. ... ..      ....  . ..... ...  ..  .   .  . . . . ... .     .. ... ..   .  ..  . . .... .. .   .   . . . ....
..  ... . .. .  . .. . . .. .  . ..  .  .  .... ... ......... .  . .... . .    .. . .. .  .  . ... ..... .  . ..... .. .... ....   ...
. . ...... . . .. . . . .. ....   .   . .  .... ...       . ...  .  ... ... ... ... ...... .  . ....  .... ...  ...   .. .. ... .  . .
.     .. .   . .  .  .  . .. .  ...  ..    .. ...  . ...   ..    .  .... .  ... ... ...     ....... .   .... ..... ...   . . .  . ....
.  .  ..   ......  . . ..  ....  . ..    .. .. .. .. . ... . ..    .  ..   .. ... .        .   . .... .. .... .    .  .      .. . ....
..   .     . . . .  .  ...  ... . . .  ..    ... ... . . ...  .  ...  .....   .   .... ..   ..  ..  ... .... . .........  ..  . .. ...
..   . .  .   .  ....  .   .  ....  .... .   .   .. . . ..   .   .     .... . .  ... ... ... .  . .  .......     .  . .. . ...   .   .
.  ..   .... .. .    . ....  . . ....    .  . . . ...  ... ...... . ..   ....  . . ....    ... .   . .   ....  . ....... .. . ..  .. .
. ....  .... .   ..       . .. ..   .  ...       .... . .    .... ....   .   ...     .  ... ...... .  . .  .. . ..... ..  .. ..   .  .
..  .. .............  .  .     .  ...... .   ..  . .. .  .... .   . . .. .. .. ...  . .....  ..  .  . ..    ..    ....  . . .. . .....
..  .. ............ .  . . . ..  .  ....  .. ..  . .  .. ..  . .   . ..   ..   .. .    .. . ...   . .. .. ..    .. .. .    .  .   ....
...... .  . .. .. .  ...   ........   .... . .... . .  ... ..  .. ..  .      ..       .  ....  ... . .. .... . ..     .  .   ... .....
.. ..  .    .   ... .. .... ....  ..  ... .... .. .    ...... ....  .    ..   . .... . . ....   .  . .. . .  .. .....  ... .. . ..  ..
. . ..          ..  ..  ..  ...... ....  .. ...   ..     . .... .    .. . ... .  .   .......  . .. .      ....  .. . . .. .  ..  . ...
.  ...   .. . ... .   ...    . .   . .   .  ....... . .  .   .. ...........  .  ..  . .. ..   .. .  .. ..    ..   . .       . . .    .
. . ....     .    ... . .. .   .. ..  .     .... . .   ..  ....      .  .   . ....  .... ... .   .    . .      .   . . . ... . .......
. . .  ... ....    . . .  . . . ..   . . ... ..    .......       . ... ..   .. . .. ...   . . ...  . . . . ..  ..... .  . .. ..  .. ..
. ..  . . .  .   . ..  . .   ....      ... .. . .... . ..   . .....  .. .. .  . .... ..    .    .    ...  .  . ... .  .  . ..     .. .
.  . .......   .....   ..  .. ..  ..... . ........  . ..   .... .. ..  .   ..  ... . .... . ... . .    ..   ... . . .. .. .. ...  .. .
.. .  ..   ...   ..  ..       .. . . .  ..  ... . ..  .. .. ...   . . .   ... .. . ....  . ... . .  ..  .. .. . .  . .. . . .  .. . ..
. . . .. .. .  ... .. ..  . ....  .... .. ....... ... ..  . . .  ..     .. .   . . . . .. .   ....   ........ . . .... ..... ..  .. ..
. ... ...    . . .. ..  .        ..   . . ..  . . .  .   . ... ....  ... .X.. ...  .... ... .... ... ...  .  ..  .. .   . . .......  .
......................................................................................................................................
