.....................................................................................................................
.                                     ..                .   .. .          .            .        .                  ..
.            . .          .            .                      .     .      .          ..                .        .  .
.  .  .   ..     .        .     .                      .  .   .           . .      .       X.                       .
.       .    ... .                    ..       .                   .                                . .     .   .   .
.                .  .         .  .    .       .     .         ..          .     .        .   .   .   ..   .         .
.. .  . .          .        .         .             . .                            .    .                         . .
.....................................................................................................................
