................................
....      ..  .       .   . ....
.  . . .. .  .. ..  .. . . . . .
...... .. .   ... . .. . ..    .
.. .     ...  .  ...   . .. .. .
. . .  ..... .... .    ...  . ..
.  . .. ..  ... .   .         ..
.   ....X.  .. . . . .. .....  .
. ..    .. .. . . ..   .... .. .
. .     .... . .. . .   ..    ..
.  .       ..        .. .. .  ..
.    . .  .   . . ..   .. . .. .
.. .   .    ..   ......   . ....
...      .   .. .   . . .      .
..   . .    . ..  .. .. . ..  ..
................................
