...............................................................................................................................
.      .    . .  .            .          .   ..             . . ..  .    .. .  .  ... ..     . ..    .    .   .      . .. .  ..
. .. .      .     .. .  .         ..  .   . .   ..           .    ..    . .  ..  .  ...   .    .    . .           ..   ...  . .
. . . . . .  .. .     ..  . .  . ..     .       .  . . ..  .  . .           .        ...   . .   .     ... .  .  .   .. .     .
.. .   . .  .     .     ..        .  .                 .. .           .. ..     ..      ... .                  . ..   .  .    .
.     ..    .       ...    ..           ... ..   .  .     .   .   . .   ..   .  . .     .      . .     ..    .  .  .    ..   ..
..   ..       .       . .  ..    ..           . ..  .   ..      .   . .  .    ..  .  .    . .      .. .   . ..          ..    .
.    ... .       .    .             .     .        .  .  .    .   .      .. ... .  .         . . .          .  ..  ..    .    .
. .    .   . .           ..  .     .  ....  .. .. .. .          .   ..  . .  .     ..    . .     ..     ..     . .    .  . .  .
.              . .         . ..     .  ..                .      .       .  ..     .   .     ..   . .        . .  . . .    ..  .
.        .     . . .   . ..           .      .    .  .     .. ..    . .  ...   . . .  .   ..  .           ...   . . . ..    . .
.  ..   ..           .               .  ..  .   .. .      .. .   .  .      ..    .   .      ..    .   .      .  . .     .     .
..       . . . .    .   .   .. ..      .. .  . . . .        ...  . .     .  .     . .  .   .   . ..     . . .     . .     .  ..
.   ... . .   .   .       ...   .  . .  .. .  .  . .          ...     .   .  .  .            .. ... . .  ..    ..    . .   .  .
...   .  .        . .. .    ..       . .    . ..    .        .  .        .   ..         .   ... .       .   . .   .   .   . ...
.               .    .                ..... .   .         ..     .  . .   ..    .   .. .. .  ..    .  .      .  . .. ...      .
.    . .   ..      . .     ..   ..         ..  ..  ... ...    ...  .   .  . ..     .      .   . .     . .   .   . .. .   X    .
.  .      ..     .  . .    .     . .   .  .        .  .       . .    .. .  . . ..  .  .   .     .     .    ..       .        ..
. .      . .  .        .   . ..  .  .  ...  . ... .  .   . .   . ..    .  .    .... .           .    . .   ..   ..      . . . .
..             ..   .    .   ..  ..    .         ..      . .      .   .  .                 . ... . ..  .    .   .     .....   .
. . .  ..    .       ..  .  .     . . ..    .  . .   ...     . .     . .  ...  ...       .....    . .  .. .  .  .   .    . . ..
.    . .. .      . . .   . .      .    ...    . . . ....  .  . .  .   .      .. .   ..        .     . .  .. .  ..      ..     .
.... ..        .          .  .       ..   .     .  ...  .       .   . ..  .. .   ..      .    ..  . .    ..  .  .    . .    . .
.. . ..   .   .  .    . .  .  .  . . .        ...   .    ...    .     .      ...  .. . .     .             .     . .   . ...  .
.         . .  . . .   .  ..  .    ... .  .      . ....     .         .  .  .      .     . .    .     .        .         .    .
.    ...     .   .  ...   .  .    .     .      .         . . .       ..         . .    .  ..  .     ..     . ....    ..   . ...
. ... .   . ...      .      .   . .  . ..     ...  ..  . ..  .  .    .      .       .           . .    .    .          .. .   .
.     .    ...  . .          ....       .  . ..       . ..         ..         .    ..   .      . ..   .         .. .   .. ..  .
...............................................................................................................................
