..........................................................................................................................................
. . . . . . .          .  .. . ..  .    . .... ..    ...  .       .    . .             ..  ..   .  . . .  .           .. . .  ..        ..
.    .. ..       .     .  . .     .. . . . . .    .  .      .      . . .  .       . ....     .   .   ..     . .   .  . . .  .   ....     .
.  .     .    . ..   . .     .   ..       .            ..  .  . . . .   . .  .....          .   .      .  . .    X..   ..   .      ..    .
.    .          .        .    ..      .   .     .            .  .         .    . .    ...   ..   ..       . .     .  .  .    .      . .  .
. .                    .   ..   . .       .       ...    .    ...        .  .   ..    .           .    . .        . . .      . . .   ... .
..........................................................................................................................................
