........................................................................................
..   ... ..........     . ... .. ......   .. ...   . . .. .  . ... .. ...  .. . . . . ..
.. . .....   .. .. . .. .  . .     . . ... ... . ....  . .. .. ... . .  .  . . .   . ...
. .  . .. .  ..     . . ..........  . ......   ..... ..   . .. . .  ..  .. ....     ....
.   .. .  ....... ... . .... . .. . ..... .  ........   ...  ... . ..  . .  . . .  .. ..
. .  ..    ....  ..  ..... ..    .   . .. .   .   .  ... ........  . ..  .. .  ....... .
.. ..  . . . ....   . .... . .   ... .  ...   ..   .. . ..... .. .    ... . ...... ..  .
... .. .   .   . ..      . .   . . .    .  ...... ......   ... ...  .  .. .   ...      .
. . .. .... .   . .  .....  .   ..      .. .. .     .....     ............  .. .. ... ..
.. . . .. ..  .. .....  .   ... . .. . .  . .   ..  . .. ..  .   .  .. .... .. .. ... ..
....  ..    ..   .... .. ..  . .  ....  ...  . . .... ...   ...X   ..... ..   ... ..   .
..   .. ...  ..... ... .  ..      .  .  .. ..... .. . .. . ....    .. .    ...   . . ...
. ... . ... .    .. . ..  ...     .......   ..   ..... .... ..  .....   ... . . . ... ..
... .  .    .  . . . .  ...    .... . . ...   .. . . .  .....  . . ....  ..... ..  .   .
.. . ... .  . ..... . .    ..... .   .    .. ......   .... .  ...... .... . .... ...  ..
........................................................................................
