...........................
.   ..   . ..  ..   ..... .
. ... .  ..   ..    . ... .
.   .. ....     ..       ..
.   ......  . ..  .  .. ...
. ..  ...    .....    .....
.  .  . .    . ...... .  ..
.....  . .  . .   ...     .
.  .  ...  ..  .   ...    .
.  .. .  .    .. .  .   ...
..  . .     .. .    .  .  .
.  . . ....  .. ....    ...
.... .   .  . X... .. ..  .
.. ..      .  .   .      ..
...........................
