..............................................................................................................
.       .                  ..  .          .    .    ..                       .   .  .    ..    . .    . .    .
.    . .                        .      .              .    .      ..  .   ..               .          ..     .
.                          .    .  .        .    .     .    . .       .  .             .        . .   .      .
..                   . .        .  .   .   .                .  . . .  ..         .  .        .    .   .      .
.            .      .       .                             . .  ...    .     .       ....      .     .        .
.                 . .   .               .       .    .       .       .                         .    .        .
.     .   .  .                 .         .     .    .                                   ..   .    .      . . .
.           .               .          ..       .       .                 .         .   .    ..   .          .
.                .      .  .    .        .    X   .        .     .            .     .    .   .  .            .
.  .  .        .            .  .    .                    . .            .          .                  .      .
. . .               .             .     .                   .    .                .            .   .  .      .
. .. .          . .     .    ..        .           . .      .              .          ..                     .
.   .    .           .         .                    . .                           .              .           .
.  .        .  .           .          . .    .                                    .    .   .                ..
.         . .             .            .        . .  .                   .                                 . .
.                       . .      .      .       .    ..    .  .       .    .                       .  .  .   .
..              .                 .      .   ..   .  .  . .        .                  .     .       .        .
.       . .         .   ..  .     .            .                      .  . .  .   ..                         .
.    .      .                       .               ...    .           .            ..        .    .         .
..............................................................................................................
