...........................................................................................................
. ... .   .. ..   ..  . .       .  .....    ..   .. .  ..      ...  ...   ..  . ... ..  . ...    ....  . ..
.     . .    ...             . ..  .  .   .   .     .    ..   .       .   . .  ..      .  . . ..  .....  ..
.     ..    .. ... .   .. .   .  .   ....      .  . ... .  ..  ..    .    ..... . .. ..    .     ..     . .
.    .  .   .       . .. ... . .   .  .. . .  . . . .    ..   .. .  .   ..   .    .        ...   . . .. ...
.. .       .  . ..  . ...      ..    ... .  . .........  .  .  .  . . . .         . . .. . .. . ...     ...
.. . . . ....      .   ..  .  ..    ... ..  . ....    ..  . ..  .  . .  .   .      . .  ..  . .   ..    . .
....   .... .     .. ... . .    . .    .  ..  . .. . ..     . . ..   .  .     ... .   .   .. .   .. . ..  .
. .. ... .  . .  ...    .. .. . .  .. .     ... .  .. .  . ..... .. ....    .   ...     . .  ..       . ...
.  .  .     .  .  .  .  . .. ..            . .   ... .  ..  .   . . .   ... .  . .  ..  .   .   .   .  .. .
. .    .  ...  ...    .   .  .     . ..   .  ..   .   .   .... ......    ... ....        .  ...... .  . . .
. .         .   . .   .     ..  . ..    ..  ..   . ..    .. .    .  .      .    ...     . .... . ..   .. ..
.  ...  .    .   .... .... . . ..   ..  .   . ..   .. . . .      .         ... ...... ... .  .... . . . . .
.. .. .   ...   .  ... . . .   . .  ..   ..   . .  .....    .  . .    .  . .   ....    .  .  .  ... ... . .
.        .  .     .. .    .      . .. .   .  .. .   . . ...      .   .....   .  ..      ...  . ..     .  ..
. ..   . .   ... .. .....  .  ..  . . . .     .       ....        ..     .  .. .       . ...       ... .. .
..  ..     ... .              .. ...  .... .     .  ......  .      .   . .       ..  .  ...   . ..    .  ..
. . .    ..   .....     .    .  .  . ... .   .   .. ..     ..    ...   .. ..    .   .  .. .. ..     .   ...
.     ..   .      ...   .        . .      .    .  .   ...    .  .   .   .    .. ... . .   .  .. .. .  ..  .
...  ......   . ...    ..     ..    .  .. . .. . ...   .... .    .    . ..   .  .. . . .     .. . ....... .
.. ..    ..  .  . ..  ..... ... ....  ...  . .   ..   .   .   . .     ..  ..  .   .  .... . . ...   .. .  .
. . . ..      ..  .     .   .   .   .   ... ... . ... . .        .      .  ..   .  .      . .     .  .  . .
...  .      .   .  ...  . . .  .   ... ..  . .    .. ... .    .  . ..... .    ..    ... .  ..  .   ... ....
... .   ....   .  .   .. .     .   . .. .  .   . .  ..  . ..    . .  . .   ..    . . . .    .  .. .  . .  .
....     .  . .. .... ..  .   .  . .. . .  . ..      . .   ..  . .  ... . ..    . .  .   . . . .        . .
..   . .          . . ..    ..      .     ... .  . ... . ... .   .       .  ...  ....     . .   .. .. ..  .
.  ..  ...     . . . .   ..  .. . .  .    . ...     . .   ...  ...    .  .          .  . ..    .  . .  .. .
.  .  .   .      .. .   .. ..X  ..  .         .    .. . ..  ..  ..    ..  . . ..    . . .  .  ....   .. . .
...........................................................................................................
