....................................................
..  .      ... .   .      .  .  .         .    .   .
.. ...  .    .    .       .    .  .   .  ..     .  .
.           . . . .  .  . .    .    .   . .   ..  ..
.. .      .                . . .       ..     .  . .
.    . .    ..  . .         .        . ..          .
.          ..           .          .       .  .    .
. X .   . .       ..     .        .     .   .      .
.        ... .           .      ..   .     ..    . .
.           . .      . . .      .  .. .   .  ..    .
..    . ..    ...   .        .. .         .     ....
. .    .      .  . .      .  ...   . ..   .    .   .
.     .  ..   .   ..             .     .  ..      ..
. .                    .      .  ..   . .         ..
.              .                .       .        . .
.      ..  .  .      .           .               . .
...        .      .  .   .         . .          . ..
..          ....  .   .    . . ...        .       ..
...  . . .  .       .. .  .     .   ..      .    . .
.     ..         ..      .  .                   .. .
.    .     .    ...      ..      ..  .  . . . .    .
. . .    .   .   ..  ..            .   .     . .  ..
.      .                           . . ...         .
.  .     .  .  .   ..          .         .      . ..
..            .  .. .   .   .  .       .    .  .   .
....................................................
