.................
.    . .        .
..              .
. .    X .  .   .
.  .  .     .  ..
.        .      .
.     .   .     .
.    .   .    . .
.       . .     .
.               .
.    .  .    .  .
.           ..  .
.   . .     .   .
.     .         .
..   .  .   . . .
.   .    .      .
. ...       .   .
..     .        .
.   . .        ..
..            . .
.             . .
.       .   . . .
.             . .
.      .     .  .
.   .           .
.   .     .     .
.................
