...............
. . .   ..  . .
.  .   .      .
..    .       .
....     ...  .
..     .   . ..
. .... . ... ..
..    ...     .
. ...   .. .  .
.... . . ...  .
.     .       .
. ...  .X     .
. . .     .  ..
...............
