.......................................................................................................
.. .   ..     ..        .   .    .   .X.   . .. ..... .   .       .   .    . . .   . .. .   .... .  . .
..      .           . .....   ...     .        ..   .. .     ..   ...  .       .   ..  . .. .     .....
.  .     . .   ...    ..      ..    .   .  .  ..    .      .    ..   . .. .  .    .... ...    .. ..   .
. . ...   . . .  .. .  . .  .     .  ...      . ... . ..        .. . . .      . ..  .   . . . ... . ...
. . ..  . . . .  ..     .....  ..       . .    ..  ..  .. .. .. .    .. .. . .   .  .... . .     .    .
..  ..  ...    .. .       ..   . ...   . ....  .  . .. .. .. .  .   . ... .       .. ...      . ..   ..
... .  . .....  .       ..  .  ..  ..       .          ...  .    ....   .   . ... ...           .     .
.   ... .. . .  .  . .  .  ...  .   ...  .    ...   .. . . .  ....   .. .  . . .....  ..    .. .. .  ..
.  .  ...  ..  ....    .. . .   ..   . .     .   .  . . .  .   ..   .  . . .  . .         .   .      ..
..   .    ..    ..   . . .        ..   ..  .....   ..   ..  .    . .     . . .    .    .      . . .   .
..       ..  .. . .   .. . . ..       .     .. .  . . .  .  .   ..      ..     . .  .   . .      .. . .
... ......    . .   ..  .    . ...     ..     . ..    ....  .. .. ..    ..    .   .. .   . . ..   .. ..
.  .      . . . . .       .      .     .    . .  .  .. .. ...    .. . ...    ...  .      .   .   . .  .
.   .    . .   ..  ...  . .      .     .. ... ..  . ..  . .  ..  .. .  .  ..  ..   .      .    . .  . .
.   ..        ....      ..    .. ..    . .. .      .      .     .. .      .  ....  .  .          .. . .
.. .  . .  .   . .     ....   . ..  .... . .  .... ....  .. . ......  .   .   ..          ... .      ..
. .  . .     . .      ....  ..    ..   . ...      .    ..   ..  .      .         .  . ..   . . .      .
..  .      ....   . .   .    . .  ..  ...     . ...  .  ...  ..   . .          . .... .    .    ....  .
.    .          .      .           . ..    ....      .    .   .  .  .. . ...   .   .    .     ..    . .
.   . .  .    .       .    .    ..   ..   . .. ..... . . . . .  .   ...     ....  . .      .    .    ..
.   .    . ..        ..    .        ..  .. .   ..   .             ..    . . .. .       ..  ..     . . .
.     .. . ....  . ..   .       .   .  . . .  .       ..   ..         . ... . .. . .  .    ... . .  . .
. .    .  .     .  .       . .       .. .  ..   . .  .   .....              .. ..   ..    .... . .  . .
.......................................................................................................
