..........................................................................................................................................
.     .. ...         .         .          .                     .                 .  .   ..       .         .   . . .  .      .          .
.   .    .  .       .  .         ..  .         .       .     .  .         ..     .  .        .  ..     .   ..     .     .   ..     . .   .
.   .          .        . ..                . . ...                  .X    . .      . .   . .          .   . .  ..  ..  .               ..
..     .                 .      .    .    .             .               ...         .    .       .. .           .       .            .   .
. .   ..   .                         .       . .      .    .      .   .                   .     .     .                            . .   .
... .         ...      . .      .            .    .    .      .              .  .    ..  ..        .       .       .           .   .     .
.     .  .           .  .    .   .   .                    .                      .        .               .   ..                ..       .
..........................................................................................................................................
