.........................................................................................
.     .. . .  .    . ..         . .   ...    .   ..   ..  .     .    .                 ..
.                .        ..            . .  .      .  .                  .  .         ..
.   .     .  .. .     .                ..  ..           .  .    ...           ..  .     .
.   .                .    .                   . .  .    . ...    .   .              . ...
.     .      .   . .  .          . .    .. .     .    ..       .  .   ..      .   .   . .
. ..   .    ..         .    .   .         ...   .   .  .      .  . .     .       . . . ..
.                   .... X         .  ..      .     .  . .      . .. . .       .      . .
.   .    .      .   .      .      . ..  .   . . ..            . .    . .           .. . .
...        .      .  .        .        .         .  .               .      .. ..   .  . .
.                  ..  . .        ..      .    .    . .. .      .  .  .  .       .      .
.  .     .    .   .. .     .    .   .       .     .. .   .        ..        .       ..  .
...    . .                   ..  .     .         . ....      .      .       ...         .
.   .           ...    .. .              .  .          .        .                      ..
.  .    . .    .    ...   .  .     . .    .      .       .    ..   .     .     . .      .
.........................................................................................
