.........................................................................................................................................
. ...     ......   .    ..   .. . ...   .  ....    ..   .   . .  .  ....    .... ...  ... ..      .  .   ..   .    .... . ....   ..   . .
..  ....  .. . .  ..   ..   ..... . ... ..  ...  . .         ....  .. ...  . . ..   .   . .  . . . . . . ...   .     ..  ...  . .   . . .
..   .   .. .  .  ... .    ... ....  ..... .  . ............... .... ... .  . ..  .  .   ....... X...   .   ...  . ...  .. .. . . ..    .
......  .. ..  .  ..    . .  ..    ..    .. . .    .  .       . .....  ..  . . ..  .   ....... ..  .  . ..   ....... ...  .   ........  .
..    .      .  .... ..   .  . .. .....  .   ...... .....   .  .  .   . .   .    .  .. . ..  ..... .      ..  ..  .. . .  .    ..... . ..
..   ....   ... .. .. .   .. .  .. ...   .. . .  .  . .    .. .... .. .  .   .... ...  .    ....   .  . .  . .... ... . .... .      ... .
...  . .  .  ... .    ......  . . . .   .   .  ..  ..    .   .  .....   .  ..   .. . .... . ... .. . .   . ..    . .. ...  .  .. ..  . ..
.  ..   ..   ...... ... . ..    .   .  ... ...     . .  .  ..... ... ..     ..  ..  .      . .. .      . . ..  .... . ..    ...  .. .  ..
..   . . ..  . ....   .. . ... .  .   ..  ..  . ..  .. ..  . . . ..  ..   . ..  ..  ......  .  .    ....  .  . .. ... . ...    ... .    .
.........................................................................................................................................
