...........................................................................................................................................
. .....  . ..  .  .  .     . .    . .   .  . .  ..     .  .  ...... . ...     ..  .  .   .   .   . .       .. .  . ...  .   . .    .. .. ..
. . ..  . .  ... ....  ...   .  .  ... . . . .. . ..  .. ...  . .  ..... ... . .. ...  .     .      .       ...  .   .   .    .    ...  ...
...  . .    ..    . ..... .  .  ..  .   ...  . . . ...  .     ..   . ...  .. . ....    .... ....  ........     .     ... .. .....      . ..
. .. .  .  .  .. .  . .  . ...   .   .  .   .... .... ..    .     .     . ......    .. .. . . . .. . .   .      .  . .  .   .  ..   ... . .
. . ... .  .  . . .  .  . ....    . ... ..  .    .. . . . .... ..  ..     .  ..  ...  .. .   .. ....       ... .    .. . .   .  .       ...
..  ..   . .. .  ..        . .  .. ..  .....  . .    ..  .... .  . .  .    .. . . .  ..  .  ....  .     . .  . ...  ..  ....   . .    . ...
. ...    .   ..      .. .... ..     .  . ...  ..  .. . ..    ...  ....  . ..   .  . .   . . ... .   .. .. . ..     ....      .......    . .
..   .  . .. ..   .     . .  ..    .  ... ....    .  . ....   ... .. . ..   . . X.....      .     ....    .              . .  .  .. . .   .
.  .  .. ...  . ...      . .   .  ...         .... .... .  . .. .     . ..     ..  .. ...   .  .   ....     ...  .. .. ....   .  ..    .  .
..  .    . .        . .  . ....   ... .      ....   . .  .  ..  ..   . ... .  . .. ......   .     .    .  . . .    . .  ...  . .  ..... . .
...........................................................................................................................................
