.................................................................
.. . .. ....X.  .. .  ....   ..   ...    ..           .  .. . . .
....   .  .  . . .. .   .     . ..   ..  .  .  ...  . ..... ..  .
. ..... . ..  .  .   . . ...... ..  .  .. .  .       ... . .. . .
.................................................................
