..........................................................................................
... .  . . .   . . .    .  X.  . . . .  ...         . .       .               ..  ....   .
..  ..   . .  . . . .. . . .. ......   .  .  . .     ...  ..   ...   ... . ..  ..   . . ..
.. .  . . .      ...       ..... . ... .   .   ... ...   .. ..   .  .    . .     ... .  ..
..   .. ..   .  ...    .   .   . .   ..      ...  ..     ..   .   .. .       .. .      . .
. .   ...  .       ..   .  ..... .. .  .   .... . .. .... . .      ..   .  .   .. .    . .
.. .    .  .     ...      . .   ...       ..  . . ... .. ... ... .    . ...          .   .
.       ....   ..   ..  . ..... .     ...     ...   .    . .  ......   . . .  ...  .  .  .
.  . .     .. . .     . .. .... . .... . . . . .  . ... .       ..  .   . .   ..  . .    .
.  .  ... . ...  ..   .  ..  .   ..   . ..   . ..   .. . .  .....   . . .      . . .   . .
.. .  . . ..  .  .       .  .    ... ....   ..  .   ...  .   . . ....   .    . .    .  . .
... . .. ..   . .. .. ..  . .. .. ...  .  ....     .    .  .   .     . ..  . ..   . . .. .
. .  ... . .        .    .   ..        . .   .   . . .  ... ..   .  .  . ..     ..    . ..
..........................................................................................
