..................................................
.               .         .       .       .      .
.    .            ..                    . .   .  .
. .    .   .        .    . . ..                  .
.      .         .                               .
.      .            .           .           . .. .
.   .                       .           .        .
.            .              .        .           .
.                       .                   .    .
.     .              ..     .           .        .
.       . .                                      .
. ..                .                .           .
.   . .            .       .               .     .
. .       .                                    . .
.            .                    .      X       .
.   .           .    .  .       .        .       .
.                              .      .      .   .
..................................................
