..........................................................................................
.   .                   .   .   .      .          . .        .  ..            .          .
.     .       .        ..         .         .     .  ..   .   .      .  .   .      .  .  .
.  .      .  .    .                 .          .         . .   .       .  . .  .. X     ..
.                   .   .      . .        .  .   .         ..                            .
..        .    .   ..      ..   ..   . ..  .                    .     .          ..    . .
.                 ..     .     .                            .                            .
.   .  .              ..     .     .           .   .   .      .         .   .....        .
.      .             .    .                   .        .                         .       .
.         .         .             .                                .   .          . .    .
.             .     .    . .      .   .               .      .                 .        ..
.       .           .      .      .             .              .                         .
.           .  .   .. .        ..          .   .   . .       .          .               ..
.        .           .      .    ... .      .         ...  .        .       .  .      .  .
.       .   .            .       .                             .      .   .    . ..    . .
..........................................................................................
