.....................
.  . ..        ..   .
.  .  . . .  .   .  .
.             .     .
. .   .     .       .
...        .    .  ..
.  ...      . ..... .
...      . ..      ..
.             .  .  .
. .    . . .  .  .  .
.  .   .       .    .
.. .    .        . ..
.         ..  X.    .
. .  .  ..   . .  . .
.                   .
.....................
