.........................................................................................................
....      .. .  ..  .     ..   ..   ..     .   ..    . .   .  . .   ... . .  ..      . .   . ..   ..... .
.. ..  .     . .. .     .  . .   . .. ..  .      ..   ..... . .   .       .        .   ...  .. ..     . .
... ..      . .. ..  .   ..  . .  ... . . .  .. . ...      . .   .     .   . .. . .  . ...   . .  . .....
... . .  ....    ... ..   .. . .  .. .   ..   . .....      ...      .. ..  .   ...   ..   .  .     .. ...
..  .   .. ..... . .....   ..  ... ..      .. . .. .        .  . . ..   .    ... ..   ..   .    .    .  .
.  .  ..   .... . ... ....  .. .. .    . . . .  .  ..     ..    .. ..   X....  .... .  .   .. .. .. .  ..
. ..... .  .  ........  .. ..         ..  ..     ...  ..     ..  . .  ..  ..    .   . .    . . .      . .
.  .    . .. .... . ... ....  .     .. . .  . .  .  . .. .. ..  .. ..  ..  . .    .. .  ....         .. .
.........................................................................................................
