...................................................................................................
. .    .           ...              .  .....      ..  ..  ..   .  .    . .     .     .   . . .   ..
.               .   .  .    .  ..            ..                        .          .     .  . X .  .
.   .  .    . .           . .  .  .                ..  ..      . .      .      .   .  .    . ..   .
. . ..               .. .   .   ...  . ...       .. ..   .    ..  .  .  .     . .  . .    ..      .
...................................................................................................
