.................................................................................................................
..  .    . . ..  ...  .   . ..  .       .     . .. ...   .  .    ..         .  .. .    ..    .    ..     .      .
.   .  .  . . .  .  .  . .  .   .   .         .... ... ...  .  .          . ... .... .  .  .. . .... .          .
.   .   ......        . .      .  . .  ..  .   .   . .  .  ..   . .      ...  ..     .   .   ..... .   .     .  .
.   .     . .          .       . ..       . ... .  ...  .   ..        ..         . . .. . . . .      .      .   .
.   ...      ..      ..  . .    .         .            . ...     .  .  .X  ..    . .      .. . . .   ..  ....  ..
.................................................................................................................
