.................................
. .  .   ....   ...    ..       .
. .. . ...  .    .. ..   .    . .
.   ...    .  .     .  ...     ..
. X.  ..........  .. .  . .     .
.     . . ..   ....   .. . ...  .
.  ...... .  .    . ..  ..    ...
.................................
