............................................................................
. . ..  ..   . ..  .  .    .. . .. ...  .  . .  .  ...  . ...     ....... ..
.    ...   .     .. .  . ....  . . ....      .   . .   .... .. .  . .     ..
. . . .. .. .. .      ......   ..     .. .. .. .    .   .  .. . . ...    . .
..  .   . .. .  .    . ..  . .....  . .  ....    .  . .   .   .  .   . .. ..
.  ....  .  . .......    .  ..     .  ..   . .....  . . ...   . ..  . .  ...
. .  ....   ...  . . . ..   ..       ....  .... ..... ... .. ..   ..... .  .
. ...  .  .  . ...... ..   ..     .  .. ....   . .  . .. .... .   . ..  . ..
. .  .  .    .. . .. ... . ...   . . .....        .  ..  .   .  .... .    ..
....   ...  .. .   .. . . ....   ... .  .  .    ...  ..  ...  . ..  .   .. .
..  ......  .  .   .  . . .  .. ...  .. . .   ...... ... . ....   . . .  . .
.  .. ..  .  . . .  ..   .  ...  .  ... .. .  .  ....    . ... . ..  .. .  .
......X . ... .    ... . . . ....  .   .. .. .  .. .   .... . ..  . .     ..
. ... ..... ...   .. ...  .    ... ..... ..  .  ..  .....    . ... . .... ..
...     ..   ....   . .  ....  ... .. .. .. .  ...      . .  .   . ....    .
..   ..  .. . .  ... . . .... ..  . ....   .. .. ..  .. ......   ... .     .
. .........    .. ...         .....  ..  . .  .  .. .. ..    ..   ... .... .
.  .... .  .. .  . .  ..  .  . ...  ....  .    .... ....   ..  .........   .
.... .    ... .... .. ..  ......... .. ... .... .  .  .   .  .. ..  .. ..  .
. .  . .  . .  . .  .  .  .    . . .  .  . . ....   .. .. . .. .  ...  .   .
............................................................................
