....................................
..       .  . .      .     .  .  . .
.       .. .       .  ..          ..
.               .. .    X   .     ..
.    .     .          .   .        .
. .     .    .  .           ..     .
.. .  .  ..         .       ..    ..
..                    .    .  .  ...
... . .                 .    . .   .
.  .    .    .    .         .      .
.  .    .      .  .                .
.    .    . .     ..    .         ..
.    .      .     .    .    . .    .
.. .         .         . .       . .
.     ..              .    .     . .
.   .      .   .     .      .     ..
....................................
