.............
.    .    ...
...    .   ..
.           .
...  .  ..  .
.    . . .  .
. .... ..   .
..   .      .
...  .  .  ..
.          ..
...   ..   ..
..     X    .
.............
