.....................................................................................................................................
.   .   .   .. .  . . .  ..  .. ...  .. .   .  . . .  ..... . ...   ..   ... .    .    .  .  .  . X   ... .....     .       .... .  .
.     . ..  ..  ..  ......  . .. .. . .  .   . .   .... ..... .  . .  . .   . ..  .  .. .... .. . . . ...   . .    ...  .  ..... ....
... .. . . . ...    ..  ..  . .. ...  . ....   .......  ...  .. . ..  ... ..  .    ....   .... . ..    ... .. .. .  .  . ..  ... . ..
.       ..   ... . ...  ..... ...  ...... ....   ...    . .  .. .   .    .  ..   .. . . . .... .   ... ..  .. .  ..  .. ... ...   ...
. ..   ..   ..       . .....  .  .    ..   .... . .. .   ......  .  . .   ..  . ...  ..  .. ....  ..    .  .. .      .... ..  . . ...
...      ....    ..   .... . .   . ... .... . .... .... ... .   . .  .. .  . .  . .....  . . ..      .  ...... .    ... ..  .   . ...
....   ..   .  .  ...  ..... .  . . ....  . .... .   . . . ....... ..  ..   .. .... . ..  ..   .. ..   .... ..   .  ..... ... . .. ..
.. . . ..   ...      .  . .. .     .. .   .. . ..     .. ...... .. . .   . ....  .. .  .    .    .    .  . .      ........ . .... ...
.      .  .. . .  . ...    ..    ..  .  . . . .. ....  ..  .  .  . .   . ..  .. .. .  . .. . .. .. . .   ...... .....    ..  .. .. ..
. ..  . ..   .. .. .  .. . .   ... ..  . .  . ... .. .  .  .. ..  ... .  ... .. .  ...  . .. ....    . . .... .  .  . ..   .......  .
. ..  . .  . ... . ... ....  ..  ..     ..  ... ...  ...  ...  .. .  . ... ...  .. . ..    .  ....  ... ..   . ....   . ... .... ....
...    .. .. . .... ..    ........ ...... ...  .   .  . .    .... .   .. . ...... .  .   ..  ....... . ..  .  .          . ..  ..  ..
.  ..   . . .......    .  .. . ..   ..  ... .    . .... . .  .... .     ..   .. ... .... .  ..... ..  ....  .  . ..  .    ..   . ....
.. . .  .  .   . . . ... .. .  . .. . .  . ... .    . .   . ... .. ... .. .... ..  .. .  ..  . ... .  . .  .. ..       ...  ..    ...
..  .      . . .  .     . . .  .. ..  . ....   ...      .. ...   .     ..  ... . .. .     . .... ...  .... .  . ...    .... .   ..  .
.. ....  . .. . . ....  ... .. ..... ..... .. . ..... . .. .. .. .. ....... . ......  ...  . .. ... .... .. .   .... .. ... . .     .
...    . ...... .  . .     .... ...  . ......  ......  . .  .    ....  .  .  .. ..  .... ..   ... .. . ... . . .     . ...  ..  .   .
.....................................................................................................................................
