.............................
. .   .. .   . .. . ...... ..
..X  .   .. .   ..   .  .   .
.  . .  .. .. .... . . ..  ..
. .. . .  . . .......  .  . .
. ..     . . . .   .. . ..  .
. .      ... .   ..  ...  . .
. .. .  .. . . . ... .    . .
.. ..  ..  ... .    . .  .  .
.............................
