..............................................................
. ...  ..  . . . . ...  .. .. . . .. . . ... ....   ....  ....
. ..  ..  .  . ..X.        ... .. ... .   ..    .    ...   ...
.. ....  ..  .   ...... . ..  . . ...     ...   .  .       . .
...  .  .  . . ....   .... ...... .. .. . .... .. .. . ...  ..
. ... ..      ..  ...   .  ... ...   ......         ..     . .
.. .  .  ..  .         ....    ..  . . ....   .   .         ..
. . . . .  . .   . .. .   . ....  ..     .  .     .  .       .
. .. .    .  .. .  . .  ...   ..  . . .   .. .  . .   .  ..  .
.....   .   ... ... . . .  .  ...... .. .. . . . ..    ...  ..
. . .   .   .         . .     .  .    ..  .. ...    ....  .. .
.  .. .   ..  .   .. .  .  .... . .... ..    . ... .  .. .....
.   .  .   ....     ....     .  . . .. ..  .. .  . .  ...   ..
...           ...   . .   ... ... .......   ...... .     .  ..
. ...... .   ..     ..      ..     . . .    . .     .  . .   .
..    . . .  . ....   ....       .. . ....       ..  .  .. ...
..............................................................
