.....................................................................
.         .   .  .      . .   ..  . ..   .   .      ...        .   ..
.. . .          .       .  .      .   .         . .    .. . ..  . . .
.  ..          .  .                        . .         .. .      .. .
.   ..     . ...             .       .   .       .   .      . ...   .
.....  .         .      . . . ..  ..           .  . .  .      .  .. .
. . .         .  .    .   ..         .         . .. .      .     .  .
.      .     .  . .   .     ..         . . .   .  ..  .. . .        .
.    .    .. ..    ..    . ..              .        .   .    . .    .
.      ..   .     .    .        .  .           .  . .        .      .
. ... . . . ... .  .....         . X        .     ..   . . . .  .   .
..    .. . .   .    ... . .  .  ..  . .             .        ... .  .
.        .               .  .       .      .     . .  .     .  .   ..
.  . .    .  .      .              .  .             .               .
.   .    .   ..     .    .  .   ....              .    . .         ..
.....................................................................
