.................................................................................................
.      .  .      .     .     . .  .        . .   .             .  .    .     .           .      .
..   .   ..   .       ...        .. ..                 ...        .   . .       ..          .  ..
.. .    . .        .   .     ..       .. ..      .      .  .         .   .       .  ..  .       .
.     .  .  .    .... .  ..  .     .  ...    .. .     .    .    .     ..       . ..      . .   ..
.    ....  ..      .. ..           ....     .  .  .  .   .           ..  .      .  .        .  ..
.        ..     .                   ..    .     .    . . .       . ..   .      .  .  .  .     . .
. .  .  .  ..          .   .           .  .  .       .      .     .         .   .   .       .  ..
.     .      . .. .     .  ..   .    . .   . .         .  .       .        .     ...   .  .     .
.      .   .   .     .  .   .. .    .     . .  .   . .     ...      . ..  . .      . .        ...
..     .  .    .  .       .   ..             .... .     .          .          ..   .   .  ..    .
.    .   .        .  .         X     .     .. .    .   .  ..                 .  ..   .  .. . . ..
.   .  .  ..      .   ..  .    .  .  . .. .      . .  .      ..       ...          . .  . .. .  .
.              ... .  .  .         .  .. ..  . .  .. .     .  ..  .         . . .       .    .  .
. .     .   . ...     . .  ....                       .    .   .   .      .             .  . .  .
. . . .     .  .    .   ..                 .           .   ..     .    .       .        . .   . .
.     . .     . .  .    .    .  .  .              . .  .    . .       .  .  .  .   .    ..      .
.   .   .  .  .     . .      .    .   ... .      .     .  .           . .   .            .      .
. .  . ..  .        .    . .  .  .  ..   .        ... .   .  .. . .    .          . . .      .  .
.   . .. .     .              .  .        .. ..       ..     .     . . .  .   ..    . . .  .    .
.                         .    .    ..         . ..  .    .     . .   . .  .           ...      .
. .   . .   .   .        .. ..            .       . . . .      .   ..    ..     ..          .  ..
.   .   . . .        .   .. .  .   .   .    .    .    ...     .      . ..  .       .       .    .
. .      .   .. .    .                   ..    . .   .. .     .  .    .   ..  .   ...   .   .   .
.    . .    . .   .   .       .  .    .   .    .       .         .     .  .       .    .   .  . .
.    .          .     .   .   . ..         .   ..  ..   ..    .  .      . .    .    .     .     .
.................................................................................................
