....................................................................................................
............  .  ... ...  ..   .....   . ......  . . . .   . ..  ....   .. ..   . ..   . ........  .
.. .     .  .. ..  .....  ... . ...  .. ..  . .  .... .....      .. . ..   .. . . ... . ....  .... .
..  .. . ... ...  .. .....    ..  . .  ... .. ..   ..   .      . . .   .  .  . . .  .  .. . .. .   .
.......    . .....  . ...  .... . .  ..  . ....  .. . .   ............  .....   .   .   . ..   .. ..
....... ..... ... ....  . .... ...   ..  .... .  .... ..    .     . .. .. ..  ...  X     ...   . ...
. . .      ..  .    ...   .. .  ..  . . .     .    . ........   . .  ... .. ...  . ......  .  . .  .
.... .       .... .    .    ..   . ..... .. ... ....    .   ..    .  . .  ..   .  ... .     .  .   .
.....  . .    .  . ...   ..   .    ..  . ......  . .  .. ..  ... .  .   .... .  ......... . . .  . .
..    .    . . . ..     .         ... ..    . ... . . .  .  ... ...     .....    . . ...... ...    .
.. . ..    ... ..    .  .  ..   . ..... ..  .   ..    . ... . . .   ..     .  . ........ ...   . ...
....................................................................................................
