......................................................................................................................................
.    ..     .. .       .   .  .   .      .         .           .     .              .     .    .   ..  .         . .                 .
.              .     .        .   .         ..                    .      . . .              .  .          ..       .  .              .
.  . .            . .  ..                            .      .                              .   ..          . .      .     .          .
.    .          .   X    .        ..      . ..          .      ...       .               .     . . .     .     .  .   .            . .
.               ..               . . .          .            .  ..           . .               ..        ..   .               .    . .
.. .    .   .   .      .            .                         .          .            ..   ...    .  .   .                         . .
.                  .     ..            .         ...                       .       .             .         .     .  .. .   ..  .     .
.         .   .   .      ...      .     .      .           ..    .. .        .    . .       . .                   .      . ..  . . . .
.                    ..     .     . .                           ..    .    .  . .              .   .         .               . . . ...
...    .    .   .   .    . .      . . ..  .  .     ..   .     .         .            .      .    .                 .    . . ...     ..
.           .  ..             .   .         .  .                         .    .   .   .         .         .  .  .  .          .      .
.     .            .  .   .              .  .    . . ..           .        .             . .          .   .      .   ..  .    ..     .
.    .      .      .. .. .      .   ....   .  .  ...      .      .   .    .     . .      ..          .    .    .                  .. .
.                       . .                   .      .     .   .  .               .  ..     .       .   .      . .       .  .   .    .
.                 .                     .          .                           .  .            .     ..           .        . ..      .
..    ..                .        .    .      .  . .       ..        .      .  .  .   .   .   .    .       ..         .               .
...               .           .      .          .      .        .     .              .        .  . .  ..  .       .   .          ..  .
......................................................................................................................................
