............
.          .
.        . .
.        X .
.     .    .
...     .  .
.          .
...   .  . .
.          .
.          .
. .        .
............
