..................................................
.   .. .  . ...... .  ..  .   ..  .     .. .    ..
. .. . .     ...     . ...  . .  .   .....  ..  ..
.. ..  ....    .  .  . ..  . .   .  . .. .  . .  .
..  .. .    .. .....   . . . .    ...  .... .  . .
.....   ... . .  . ....X    ... ........ .. ..   .
. .... ...  .. .     .... . ..   .  ....  . ..  ..
.   ..  ... .   . .... ..   ... ..      .. .  ....
..................................................
