..............................................................................................
..      .    .   ..  . .    . ...    .       .     .         .  .   ..     . . .         .   .
.    . .   .  .    .                  .         .  .         . .     . . . ..  .  .  . .     .
..     ..     ...       .      .   .      .      .       ...  . .   .  ..                .   .
.     .       .   . .....    .  .        .  ..    .. .    .  .     .    .  .       .      .  .
. . .  . .       ..             ..         .      .        .         X..  . .  .  .          .
. .   .            .   . ..     .        .       .. .  ..   . . . ..      .         .    ..  .
.  .    .. .   ....    .   ..    .        .               .                .  .    .  ..  .  .
..............................................................................................
