...............................................................................................................................................
.    .  .        .       ..            .                                                        .         .                                   .
. .                 .   .                                 . .                                       .               .               .    .    .
.        .      .     .           .          .       .                   .                                          .           .          .  .
.                      .   . .               .           .                                                  . .        .                      .
.                                            .                                                       .                          .             .
.                            .                                                                            .                                   .
.           .               .                 .  .   .                                  .                         .              ..           .
.                                                                .        .         .                  .      .   .                       .   .
.           .                                                                                               .  .           .                  .
.      .                   .         . .                               .        .                       .                                     .
.            .             .                                               . ..                .                 .                            .
.                    .      .                                              . .                                      .    .                    .
.      .                .                                                      .        X                                .                    .
.                     .             .                                                           .                                   .         .
. .           . .                                       .           .            .                                                            .
.         .        .     . .      .                .               .             .             . .                    .     .             .   .
.                                      . .                             .        .    .                                                        .
.        .     .                                                                                                                              .
.                             ..     .                          .                             .           .                    .             ..
...............................................................................................................................................
