.............................................................................................................
.   ... .  .       .  .. ...  ..   . .. . ..   ..  . ... . ....... .  . ....    . .  ..     . .   .   ... . .
. ..  ..... .   .. ..  .......   .  . ..   . .   .. ... . .  .     ...    . .    .  ..  . ..    .   ..  .....
.  .. .....  .   . ..  . ... ...  .. ... .  .. . .... . ..  .....    ...  .. .    .. . .. .  .. ..  .    .  .
.  .     .. . .      .X   ...  ...... ...  .     .  .. .   . .......   ....... .. .  ...    .. ..   .    ....
....      .  ... ..   ..  .. ...  .   .  ..     .    ... .. .. .  .   .... .... . . .....    . ..  . ..   . .
. .      .... .. . .. ..   ....   .  .  . .. ....   ..  ..   . ... ... ..     .   ..  .... .  .   .. . .   ..
.     . .....   .  .  . ... ...... .     .   . .. ..  .  .  ..    ...... ..   . . . . .  ..... ..  .  .   . .
. .     ..... .... ...  . . . .   .. ... .... ..    ... . .  ..  .      ... .   . .   .    ...... . . . . . .
..  ..  .  .   ......   . .  .. ..  ....    .  . .......  .  ...  .... ... ..    ..  .  ..    . .        .. .
... . .. ..       . .. .... ... ..  .  .. .. .  . .  ...   .    .   ................  . .  .  .  ...   .   ..
.............................................................................................................
