......................................
.   .  . ..  .   .   .    . .. .   . .
....     ..  .   . .   .  . ...   . ..
..   .  .. .  .  .  .. ..  .     .  ..
. . .     .  .  .   .. .     .  .   ..
.. ..  . ..     .   ......    .  ..  .
.   . .  .  . .     .. . ..  . . . . .
..     ..  . . .     .     . .  . .  .
. ...           ..   . .  .    .. .  .
..   .  . ..   .  .      . ..    . ...
.. .. ..  . . .  ..  . .  .  .    ....
..  .     .   .  .    .  ..  . .  ....
..          . .  ..     .  .  . .. . .
. ..   . .  .    ..         .  .    X.
...   . .  . .       .     ... .     .
...  ..        .  ..     .   . .     .
. ..   . ..  .   .   .     .. .      .
. ..  ..  ..     .   .. .  .. ... .  .
.    ..   ..   ..  ... .     ... .  ..
......................................
