..................................................................
..        . .  ...           .   . .   .     .. .. .    .   .    .
..      ..      ...     . .  ...  .        .  . .  .  ..  .   . ..
.  ..    . .     .  . . .. .. .     .   .                . .  .. .
.. . .   . ..  .  . .  ..   . .   .     . .   .  .   . ..   .    .
. .     .  .  .      .     . . .   ..  .. .    . . . .   ..     ..
...  .         . .      .   .  ...       .   .  .    . .     ... .
.    ..  .      .  ..     .   .      .     .    .       ..       .
.    ..X   ...  ..       .    ..    . .  ...  . .     .   .. .   .
.    . . ..   ..        . ..           . .  .   . .. .          ..
.   . ..             .  . .    . .....    . ... .    . . .   . ...
... . .   . .  .  .  ... . . .      ..    .   .      .. . .  .   .
.    ... . . .. .  ..                ...      ..   .  .       ....
..................................................................
