..................................................................
.            .  ..  .. .  .    .     .    .  . . .   . .     .   .
.  .  ..  ...    .  ..     . ..   . . . .  .             .  .  . .
.         .        . .  .  ..  .     .. .   . .  . .  .  .   ..  .
. ...   .         . ..   .  ..            .        .         .  ..
.    . .     .     .       .      .    .    ...  .         ..    .
..  ...  .  .         .   . .   ..  .. ...        .  .   .     . .
.        .    . .. .       .   . .   .      .    .   .        .. .
. . . .     .        ..  .. ..   .      . .       .        .   . .
.     .     .     .   ...     ..         ...   .     .    ...  . .
. .      . .....      .   .   .          ... .  .   ...  .   ..  .
.   .   ..     . . .      .. .    .    ..  .           ..  .     .
.     .   .      .. ...   .      . . . ..       .         ...    .
.    . ..         .  .    .   .. .           . .           .     .
.       .        ..   .     . .         . ... .   ...  .   ..   ..
..  ... .   ..  .   .   .  .  .    ...  ..   .  . .   .   ..   ...
.   ...    .    ..  .      . ..            . .         X     .   .
. .       .  .  .  .  .     .     . .    . ..    .  . .  .       .
..................................................................
