......................................................................................................................................................
.             ..          .                             .                   .  .  . .   .                            .             . .   .      .    .
.    ..               .   .     .                  .               .       . .                    .               .              .   ..              .
. .      .     .  .              .             .                 .                       .            .  .          . .                        . ..  .
..  .                  .  .   .   ..          .         .  .        .          .          .                .   ..           .            .       .   .
..  .      .      . X    .   .                   . . ..  .                                .       .     .           .                .      .        .
.  .   ..   . .        .        .                        .     .   .                   .                  . .             . .  ..   .   .            .
.      .       .       ..          .        .           . .         .      .        .          .     .         .      .   ..       ..                .
.            .               . .  .   .. .        ..   .      .                           .    ..   .              .                 .               .
.     .  .               .  . .      .           .   .      .             .               .  .                 ...        . .                       ..
.  .          .           .       .           .                   .                                             .  .                     ..  .       .
..          .. .       . .       .         .           .               . .           .     .  .         .              .               .    .   .  . .
.          . .   .                      .           .       .       .            .      .                   .          .    .               ..   .   .
.    . .   .    ..    .   .  .   .   ..      .        . .  .                .         .         .                     .             .             .  .
.                .  .      .     .   .     .    .       . ..        .     .  .             .                                              ..  .  ..  .
.              .      .  .         .        .   .     .        .      .          .       . .          .   . .          .       . .                   .
.         .     .             .  .     .             .                    .                  .                   .                       .     .     .
......................................................................................................................................................
