..............................................................................
..   ..    .   .   ..  ...  .     . ...   ... .      ..      .. .  .   ... . .
... . ..  .  .    ..   .... . .  .    .     ..  ... .   .   .. ..  .  .   . ..
. ...  .  . ..  ..   . .. . ..   ..      .  ...  ....  ... ... .. . ....   ...
... .. ... . .   . .   . ......     . . ..... .. .  .   .. . .   . ..  ..    .
.    .. . .. .  .   . . ...   .    . .  ...   ..  ... .. .. .. .     .. .  ...
...   ......    .  .. .   ...   ..    .... .... .  .  . . . . ..  ..  .. ..  .
.. . . ..  ... . .  .   ..  ......  .  ....   .   . ..      .     .  . .   . .
. . ... . . .. .      . .  .. ....       ...   ..   .. ... .   .... ..  ..   .
. . . ..  . .     ...        .. ..... .  .. ..  .  ...   .   .  ..      ... ..
.   .    . . .. . X      . .. ..    .. .. .....     ..  ..    . . ... .....  .
.. ....  . ..... ...      .. . ... .   .. ... . ..      .   . . .    ....  ...
.      ....    . .. .  .  .     .   .   . . . .. ....   . ... .. ...  ....   .
.  ... .. . ....   .   .  .   . .   .... .  ....   . ..  .... .. .  .    .. ..
. .   . .     .    . ...  .  ... .  ..  ..... .... ......   . ...... .       .
. ..    .      .  ...  .. ..        .. ....   .... . ...  .   .  ..  . . .  ..
....   .  ..... . .   .  ..  ..  . ...     .  .. ...       ...   ....     .  .
. . . ..  ..  .  .   .      ....  .  .. ..  .. .    .. ..   .    .   .   ..  .
.... . . ..   .. .    ..  ..  ...  .. .    ...  .   .....      . .  .  ...  ..
..............................................................................
