...........
.         .
. .   .   .
. .  .    .
.  .      .
.    ..   .
.  .  X ...
. ..   .  .
..        .
..     .  .
. .       .
.         .
.   . .. ..
..      . .
.     .....
. .       .
..  .     .
.   .. ....
. . ...   .
.         .
.   .  .  .
.    .    .
.        ..
...  .    .
..      ...
..        .
...........
