.....................
...   ..            .
.       .       . ...
.   X  .      .    ..
.....................
