.....................
. .     . . .   .   .
.   .        .  X.  .
.... .  .. . .   .  .
.       .  ..   ... .
... .  ..  .        .
..   .. . ..   .   ..
....          . .   .
... . .     ..  .   .
. . .  .  .  .      .
.     ... .    .    .
.  .          .   ...
.. .. .. . ...  .   .
...         . ..    .
...   .  .   .      .
.....................
