................................................................
.    ..  ..         ..  .          .   .  ..           ..  .  ..
.       .    ..   .  . . .   .    . .      .   . .. ..     . . .
.     . ....   .  . .    .     .      ..   .  . .    .   .  .  .
....      .        . .   .    .    .  .  ..      .             .
.  ..     .. ... .  ... .           .       ..           . .   .
.        . .   ..     ..    ..       ..     .  .. ...    ..    .
. .    .  ..     .. .      . . . .  .. . . ..     .  .    .. ...
.  ..      .          .    .. .  .   .  .....       .  ...  . ..
. .    .     .      . ..   . .    . .   .  .. . ....       ... .
.       . ...   . .  .  .  .             .       .     ....  . .
.  ... .    .. .  .        ....  . .   ..   . . ..  .          .
. . .       .  .  .. .        . ..   .                   .  .  .
.    .. .              .  .         .     ..  .  .     . .  .. .
. ....  .      .  .  . . . ..      .  .. .  .  . ..  .   .     .
..          . .  . .    .   .       ..             .          ..
. .     .. .         ....  .     ..   ..  .     ..     .   ... .
.     .. .   . . .        . . ..   . . .. .       .... .  .. ...
. .  . .     .. .          .   .      . .    .  ..... .      . .
.   . .   .  .  ... ...  ..   ....       ...     . .   ..    . .
.  .. .  .  .   ..             . ..  .   .  .    .  .  .X.  .. .
.   . .  . . . ..         .    .  .. ..   .     . .        . . .
.  .    .. .  .. ...   .    .   .    .  .   ..   .   .       ...
.   ... ..  .      ..   . ..  .  .   ..  ..       .    ....  ...
................................................................
