.....................................................
.   .. . .      .      .   ..  . . .   .    .. .    .
. .   .       ..    .  .     ..      ..  ..    ..   .
. .   .    X.   .   .  .   .  .          ..     ... .
.       .     ....  .  . .  .  .   . . .            .
.   . ..   ..  . ...  .     ..  ..    ..  .    .. ...
. .      .. ..   .      . . .  .   . ..     .    .  .
. .      .       .     .           . ..  .          .
.    . .. ..   ..  . ..     ....         .         ..
.  .      .           .    ..    .  . .     .       .
.  . .      .  ..     .   .     .   .. ..  .. ...   .
. . .     .               . .  ..          ....  . ..
.   .   .      . . .     . .     .   .. .. ..      ..
..    .  .         . . .  .   .   .  .    .     . . .
...   .  .... .    . .  ... . ... .. . . . .  ... . .
. .  ..   ......       .  .      .     .  .  .. ..  .
.  .   .          ..         .        ....  .   .  ..
.            ..  .        .    ..     . .. .   .  ...
.     .   .    .  ...   .     . .... . ......   ..  .
...      .   . .   .  . .    .            .  .  .   .
.  ..  .. .     .    . .  ..            .  .   .  . .
. . .    .     .  .   .  .     ..    .  ..  . .   ...
. ..  . .  .  .      .          .     ..    . . .   .
.   .  .  ..   . .     ..   ..              .       .
.  .  .. . .  .     . .            .    . . .     . .
.      .  .       . . .  .   .      .    .       .  .
.  ..     .  .       ...   ..  . ..   .    . . .. ...
.....................................................
