.......................................................................................................................................
..   . . ..  .. ...   .... .. ..  .        .  ..  ... .  ... .... ...... ..... .  .        .   . . .. .      ..  . .  . .. ... ..   . .
.. ..  .. .. .  .....  ..   .   .  .   .... . ... .    ...  . .   ..... .    ..    ..      .  .   .  ... . ..   .... . . .  . .     ...
. . .. . . ...   ... .    .  .  .  ... .    .       .... .. .      . .. ........  . .....  .... . ...   ..     .X .  .. .    ..   .....
.  .    ... .. . .. ....   ..  .. .     .  .  .     .   .   ..  ..  . ...    ..      .. . .. ..      .    . ..  . ..   .  . .     . . .
. .  ...   .  . ...  . .....  . ...... .         . ...... . .   ..  ...  ..  .... .. . .  .  ... ..........  .. ...  . .....   . ..  ..
.. ..  ..  ... . . . .    . . . ..  .  ....  .   ..   ..   .  ...   ....... .   .. .. .  . ..    . .   ... . . .      ..  . .  .. .   .
. ..... ...  . .   ..   ... .  ..  ..  .   .  .. . .  .. ...  .. .. . . . . .. . ...  .....     . ... .   ..  . ..  .        .. ..... .
..    .. .    ....   .      .         .    ..     ..  ...  ...  .. .  ..   .    . .  ....  . . .. . .. .  ... . ... . ... ....  .     .
.  .    ...... .... .. .....  . ..     ..  .     ...   . .     ..      ...    .. ... .  . . ..    .  ....   .... . .  . ..  .  . ..  ..
..     ...     .. .. .  .  .    ...... ..   .. . . ... ..    ....  .. .   .. ..  . ..  .  ..  ...       .. .. .   ...    ... . .. .. ..
. ..  . .     ..   ....   . ..  ..  .  .  . .. . . .... .... . ..  ..       .. ... .    .  .......... . .    . . . ..  .          .. ..
. ..      ..  . ..  ... . . . ....  . ...   . ... .  ..  ....  ... .. . .. ...  ... .  .   .... ......  . ... . ....    .    .  . ..  .
.. ... .. .. . .. ... ..... ..  ......  .     ... .      .. ..  . . .   .    .. ..  .  . .  .... .  . ......  . .    . . .  .. .  . . .
. . ...     . . ...   . . . .. .   ....   ..  ....  ...  ..   .... ....  .     ... ...   . .... .  . . ..   .  . .    ... . .  . ..   .
.      .  . . . . .     ..     .   . ....   . .... .  .  . .. . .. ..   . . .  .  .    ..    ..  ..... .. . . . .  .... .  ...  . .....
.  .. .. .    .  .   ... .. .  .  .  .    ..  . .. .  . ..  .    .  ... . . ...  ...  .. .  ..   .  ... . ... ..   ..... .. . . ..    .
..  ... . ..... ..  .. . . .. .  .. .    ... . ..  ..  .  ..      ..    .. ..     ..  .....  .    . .    ...  .. ....... .   ..  .. . .
.    ... . . ...  .. ..  ..    . .     . ..  ..  ... ......  .  .  ..   .  .   ....   .   ......     .  . . ..   . . . . . .  .   ... .
.. . ..       . .      . ..  .. . .... .. ......   . .        .     .  . ....  .   .    .. ......  ..  .. ...... . ... ..  . .  ..  ...
. . . .  .  ... . . .  ... ..   . .. . ... .     ..     ....... ..     . .      ... ..  .  . .. .   .   ..  ..   .......   . .. ..  . .
.. .  ..  .. .. .  .. . .   ...  .  . .  . .....  ...... ..  ... . .. ...  .   .  .....      .. ..    .  .. . . .... .  . .   ... . . .
.. .    . . . ... .... .  . .   .. . .  .. ..   . ...... .    .. . .... . ......  .. .. ... .. . ..   ..    .   . .       ..  ..   .  .
.  . .   . ... ..  ...    .  .    .. .. ..  .     . . ... .  .      . ..   .  ....    . ... . .  . .      ....  ....  .... .... .. . ..
.  .. .. .. ..    .. .. .       .. .  ..         .    . ...         ..   .  .. ....  .  ..   ...     . .... ..    . .. . ..  ..  .  ...
. .. .  ..    .......     .  .    ... ...  ...  . ..  .  .   .  .    ..  .. ...   . .  .   . .  ... ..    . ..     .  .     ..... ..  .
.......................................................................................................................................
