.......................................................
.              X .. .       .   .        .         .  .
.   .       .        . .   .    .      .           .  .
.                      . .      .                  .  .
.               ..         .                          .
.               .       .      .    .             .  ..
.                         ..     .                    .
.        .     .          .  .   .   .                .
.             ..    .    .      .   .  .     ...      .
.......................................................
