..................................................................
... .         .    .       . ..    . .   .    . ..   ....        .
.   .        ..  . .   ..  .    .  .    .    .         . ..      .
..   .   .                  . .  .. ..   .  .     .    ...  .    .
.     ..  . .   .    .      .    .  .  . .  . .           .X     .
..         .    .          .    .     .  ..     . .    ..        .
...   ..             .             .            . ..      .     ..
.  ..    ....             .      .        .              . ..    .
...     . .   ...  ..    ..  .   .     . .      .  .        .    .
.    .     ..  .      .   . ..     .              . .           ..
.               .. .         .  ..            .      .   .      ..
.  .   . . .    .     .    .    ..  .         .    .       .   . .
. . . .      .  .. .       ..      ..            . ..       ...  .
..................................................................
