.............................................................
. ........ .      .  . . . ..  .. . X.  . ...... . ..... .  .
.   ..  . .. .....     ...    . . ... . ... . ..      . ..  .
. ...   . . . .....   ... . . .. ..  . ... .  . .        .. .
... .  . . . . ..   .. .    ...... ... .  .  . .. ..  . . ...
.............................................................
