.........................
. . ..   .        .     .
.    .  .      . .      .
. .          .  . .     .
..   . .    . . X ....  .
.   ..  . .   .         .
.    ..       .  . . ....
. .   .. ..   .        ..
.   .. .   .     .   .  .
.     .  .       . .    .
..     . . .         . ..
.  .    .  ..           .
.      . .    . .  . .  .
.  .     .        .   . .
..       . ..           .
.            . .    . . .
. .       .  .          .
.  .          .     . . .
. .   .  . ..       .  ..
.........................
