...................................................
..     . .   .   .. . .       .      .    .   . ...
.   . . .  .    .    .         . .       ..       .
.  .  .      ...  . .     . .              .     ..
..   .   .     .     .        . . . ..     ..   . .
.    .  .     ...       .  ..... ..  . .. .  .    .
..     ...   .      .      ..        ... .  ...   .
. .     .        .  .      ..   .. .     ...    . .
.        .    .    .    .   .        . .     ..   .
.    .   .          ..  X    . .   .         .   ..
.          .   ..         .    ..  .   .  .     . .
...................................................
