..............................................................................................................................
.                      .                            .              .        .           .      ..                            .
.  .   .          .               .  .                                                           .                           .
.                           .   .                               .       .    .                     .      .                 ..
.          .           .                  .         .                                         ..          . .               ..
.   . .  .                                                       .       ..                                     .            .
.                                     .                  .        .                       .           .           .          .
.                      .            .         .                      .        .      .                                       .
.                X       .    . .                 .                                                .                  .      .
.       .             .   .           .               .                    .                 .                          .    .
.            .          .                                                                    .            .         .        .
.     .                    .                                 .             .            .      .            .                .
.                        .            ..           .         .                                  .    .   .           .     . .
.                        .                                                                 .     .. .                        .
.                                              .              .      .                                              .        .
.                  .                . .                                                  .            ..                .    .
.                                   .                           .       .                          .                         .
.       .         ..      .              .         .      .         .                                                        .
.      .          .                            .                               .   . .                                       .
.                       .. .                                           .     .                         .                .    .
.                      .     .             .                                                                     .           .
.             .               .   .                 .             .                 .              .   .            .     . ..
.       .                                          .                      .   .                                        .  .  .
.               .           .                             .                                      .              .            .
.    .       .        .                     .   .                  .                      .                    .    .        .
.                   .     .    . .                    . .                                         .                  .       .
.  .   .     .                       .                    .        .        .      .      .          .   . .                 .
.                         .                               . .            .           .                        .              .
..............................................................................................................................
