.................................................................................
. . . .    . .... ..  . .            .    .  .. ..  . . .  .     .            . .
.  .     ... .   .   ..   .      .        ...         .  ...   .   .....    ... .
.    ..        .. .   . .  .. .    . . .  ...  .. ..   .. ..   .          ....  .
. . ....  .   ..       .      . .   . . . ... . . .  ..    . . ... ..    . .    .
.  .. .   .     . ...  .. ..   . .. .  .   .  .  . . . .....  ... .. .       .  .
..     . .. .    ..  .     .. .. .  ..  . ..    .. .  . .   .. .. .      . ..  ..
.    ..   .   ..  ... ..   .....  .. ... .  .....   .   .....  .. .      . ..  ..
.  .   .. . .     . .     . .. . ...  ......... .     .. ..    .  .     .   ..  .
..         .   .   . . .   .   .    .    . .. ..  . ....   .... ... .   ...     .
. .  . . . .   .      .. ..    .  .  ...  .. ..   .  .      ... .....  .. . .. ..
.. . ..      . .    ....   .. .     ..  . .       . . ......   .  . .  .. .   ...
. ..  .    .....  .  . ....   .  ...  .   ... .   .     .     .    ... ..    .. .
.  . .     . . ..... .    ....  .. .   ...  . .         .          ..   .  .. . .
..   ..   ..   .... ... .  ..   .  . .    .. . . .  ....   . .... .    .      . .
.. .   . . .  .. .. .        .... ...   .  . ....  .   ..    . . . .. .. .  .   .
.... . .   . ... .. . .... .       ... .. ... . .      .  ..      ..   .  ..  . .
. .        ...  .  .. .  .... . .. ......... . .     ..  .    .  . .  .  .    ...
..... ...  ..   ..  .  . . .  . .  . .  .  ....  . . ...    . .. . .   ...    . .
. .   . .   .   . .     ..           .  .. ..    .   ..    . .    . .    ..    ..
. .        .. .  . ..  ....  . .      .      .....       .          .. . . .... .
.  ..  .     .  .  ..  . ..        . . .       ..  . ..    ... ..  .  .  .    ...
.  ... .     .  .. .. ...  .. .  ..    . .  ...  .... .    .   . ....     .  .. .
..    . .. . .     . ... ...    .X.  .  .... .   .   .  . .    .   .. . ..   .. .
..... .  .      ..  . . . .. .     .  ...   ..      .    ....      .  ..    ... .
.. .  . .  . ..  ..  .  .. .  .....  . .. ...      .   .      ..    .  .... .   .
.................................................................................
