..........................
....    ...   ... .    . .
.    . ..    .  ..   . . .
.. . . .. . .  . ..  ..  .
.   . . ..    .  ..  .   .
....  . ..        ..     .
.   .. . ... .  ..  ..   .
.....  .. .    . ..      .
.     .  ...  .   ... . ..
. .....       ....  .  . .
. ..    . ..  .  . ..... .
.   . . ..     .  . .    .
.. . ..... . ........ . ..
. .. ...   .. .  .........
.  .... ... .     . .   ..
.... . .  X....  ..    . .
....  .....   .. .. . ....
.. . ....  . ..  .  .   ..
.      .  . .   .  .    ..
..  . .  .    .... ..   ..
.. .   . ......  ...... ..
.. .. .   . ..... .     ..
.  .. ..... . .  . .  ....
.. .  . .   .  .     .  ..
. ..  ..   .  .... .  . ..
...  . . ..  ....       ..
..  . .  ..   ..     . . .
..  .    .   ...   .... ..
.    ..       ...  .   ...
..........................
