...................................................................
..  .       .           .    ..   . .           . .     .   ..    .
..                . .   .     .            X    .    .   ..       .
.       .     .           . . .      .  .       .     . .  .      .
..    . ...   .        .  .  ..       . .       .                 .
.                   . . .                              .       . ..
...................................................................
