.........................................
.     .  . .    .      . . . . . . . . ..
..         ... . ..  ..     . .. .      .
..   ..   . .   .. .     .   .    .. . ..
.....  .      . .... ..     .         . .
.         .. .  .... ..   .    ..   .   .
...   .. . .      .        .    ..  ... .
. .. .    ..   .  .. .  .  .     ..     .
.    .X.. .      .  . . . . .    .      .
.........................................
