...................................
.    .   X       .  .    . .     ..
.          .  .     .  .        . .
.       . .     .   .   ..        .
.             . .            .    .
...................................
