..........................................................
.  . .   .   . .  ..   ..     . .    .  .. .             .
.           .     .    .  .. . .    .   . . .  . ......  .
..     .  . . . .      .  .    . .     ...   ..          .
.  .    .   . ..    .  .   .     . .     . ...  .      ...
... ....  . .. .   .. .   .     .  . ... .             . .
.  ..        . .  .  .   . ...  .  .          .   . .  ...
..       . .  .      .  .  .. .       .   .       .    . .
..      ..      ..     . .     ..                 . .. . .
.  .. . .. .  . ..     .        .        .        .  .   .
.. .  . ..     . .    .     ...          . .       . . . .
.           .  .       . ..   .   ..    .    . ...    .  .
.         .    .  .  . . .     ...       . .        ..   .
. .    . . .      .     . .. . .     . .            .    .
.   .        .. .     .  . .   .      . . .... .... . . ..
.  ..  ..     ..        .     ..   .  . .     . .   .   ..
...    ...    .  ..   . .   .         ..  .  ..  .  .  . .
.     .. .        ..  . ... ..      ... .  .     .. .    .
.                    .       .. ..    .  .         .    ..
. . ...       . . ..        ... .. .      ..          . ..
.   .  . ...   ..        ..  .. .     ..   ..   ...     ..
.      .   .    ...          .     .  .         .     .  .
. .  .       .      . .      .   .     .   . . .   . ..  .
.    .  .     . .   . .                    . .. . .      .
..     .  . . .. ..       .      . ..        .   .. .    .
.   .   . .  .  . .          .            .   . ..  .. . .
.        .    .  .   . .     .  .  .  ..         X.     ..
.. .  .   . .                 .    ... .. ..    .  .     .
..........................................................
