....................................................................................
.. . .... .....  . .      .. .  .    . ...  ...  .  .    ..  . . .. . . . ..    . ..
.  .  . .. ...    .  . . ..      .  . .   .   . .  . . ... .... . .  ..  . . .   . .
.  .    ....    ...  .  ..  .. . . .   .. . ..   .  .. .   . ..  .    ....  ..     .
. .   .  .      . . .. .  ...  ... . ...   .  .. . . ... .. . ...  .  .         ....
.      .  .  . . ..   .  ...  ... ....... ... . ..   .   ... .    .  .        .. ...
.    .  ..  .. .    .. . . ..... . .. . .. ....    ..  . ..      .   .      .   .  .
....    ..     .....  .    ...  . .    . . .   .  .     ....   . . .. .... .    ....
.    .   .  . .   ...  ..    .    . . .    .  ...  .. . .  ..  . .  .. .   .  . .. .
..      . . ...... .  .... . ..  .   .   .. .      .  . ..... .    ..  ..    .    ..
. .. .  ... .  .  ...  .       .    ....   . ... . ..   .. .. . .   ..      . .... .
.... ..       . .  . ...  . .  ......  .....   .  ....  . .. .... .. .. .    ....  .
. .  . ..  . . . ...     ..    ... . .     . . . ..  ..  .. ...  ..  .      ... . ..
...   . .... . .   .  .       .   . .. ....... .. . ...       ..    ..    . .     ..
. .  .   ..      . .      .. .  .  . .  . .  . . .    ... . .    ... .     ... .....
.  . .   ..   . . . .... .    .. . .     ..  .  ..  ..  ..  .. ....   . ...  .  .  .
.. .  .   ... ..    .  ... ..  .  .  .. .   .     .. ..  ... .  . ...  .  . .  ... .
. ...  . .       . ... ..   .. ..   .       . .   .... . ... .  ..  ...  .  ..   ...
.. . . . . ...  ...  . . . .  .....     .. .  .      . .   ..    .. .. . ..... .   .
.. .  .   .. . ... . ..  .....  . .  .....  ..    . ..    .... .   . . ...     . ...
. ....  . ...    ..   . . . .  . .. .    .  ..... ..     . . . .  ...   .  .    . ..
.  ..   .  .   . . ...  . . . .. . .. .    .     .  .  ... ..  .  . ..    . .  . . .
......     . ...... . .  ....  . ..   .....    . .  ...     . .... ..        ..... .
.. . . .     ..    . .. .    ..  .  .   ...    . ..  .   .. .... ..  . .... .      .
.. .   .. ....  . .  . ..     ..   .. .  ..    . .. .  ..    . .  . .  .X . ........
....................................................................................
