......................................................................
... .  ..   . ........          .  ..  .      .. .        .  .    .  .
..  . . .          .. .  .  .     .    ...   . .  . ..     .  ...... .
.. .         .   . . .   ..  .. ..     ..   ..  .     .     .  .. ....
.    ..       .      .  ....  ....   . ..  ..  .     . .  . .    . . .
.    ..   .   .    . . . .. .. .. . .        .    .  .   .....      ..
..   . .. . .  .     .   .     .  .    ...   ..           ..   .  .  .
.  . . .   ...   . . .           . .. .   . .     ...  .. . . .  . . .
..  .    ..    .  . . ... . ..     .. .      .  .  .     .  ...   .. .
.  .   .    . .   ..     ..      ....  ..      ..    . . . .  ...   ..
..         . ...  .       . ...       ..  ..   . . . . .    .      . .
. ..  .             .     .   .  ..   .   . .      . .  .. ...    .  .
...      ..  ..  .  ....     .   ...       .   ...        X      .  ..
...    .... .. . .  ... ..   ... .         .  . .   .  .  .  . .   . .
.. .    .   .   .   .. .  . .       .   ... .. . ..            . ..  .
.  . .    .  ..  .   ..    ...      .    .  .. . . .   . .  .  .     .
... . .  ..      .. . .    ...  .        ..    .. .      .   .       .
......................................................................
