................................................................
... .  . . .             . ..    .  . .. X. ..      . .   .. . .
..     . ... .   ...  ..     ..   ... . .  ...   .   . . .   ...
.    ..  ...  . .     . .   .       ..  ....        .    ..  . .
................................................................
