.....................................................................................
..  .... . .. .    .. .. .. .  ....    .... .. .       .. . .. .    .  .    ...    ..
.      . . ...   .    . .... . ...   .    .. ..   .   . .  .. ... .. .  . ......... .
.  ... ...  .  .    ..          ....   .   .. ......   ... ...  ... . ........ .... .
. ..   .  .  . . ......    ..... . . . .. ... .   .   ..   ..... .  .  ..     .   . .
.. . ..    . ... .. .   .   . .. . ... .. .  .   .     ..           . .   ..... ..  .
.. . . . .  . . .   ..  . . . ..  .. . .  ... ...     . . .. .... .   .  . .   .    .
.. .   ..  .....    .. .     .   .... .     .  ...   ..   .  ...... .. . ...  ....  .
... .     .    .   ... .  .    ....  .. .    .        . .   .  ...  ....    ...   ...
... . . .    .   ....  .  .  .  .. ...   ... .  . . .   ..... . .. .  . . .      .  .
. .. .   .  .     .   . .... . . . ....... ..      .   .  ...  .. .     .. .. .  . ..
...        . . ... .  X  ..  ..    . .. .. ... ..... . ... .. ... ..   .  . ...  .. .
.        .      . .     . . ..    ..... . .. .....  . ...   . .     . .   .. . .  . .
...  . .. .. . ...   .  .    . . . .... . .  . .  . .. ... . . .. . . .   ..  .  ....
... ... .. .  . ..  ... ...  ...     . ..   . .  . . . .....  . . ...      ..  .. ...
.  .. ....   . .  .   .. . ...    ...      . .    ....     . .  . ..    . .. . ...  .
.. ..  . . ...   . ...    . .   . ..    .   . .....   ...   . . .  .....  ..  . ... .
..... . .......   ... ... ..   .. .   .   .    ....   ..   .     . . ..  .   .   .  .
.. ..  .    ... ..  ..    .. .      . ... .. . .. ... ..... .......     ..  .. .    .
.. ..   ..    .  ..    .... . ..  .. .  . ... .... ... .  ... ..      ....  .   . . .
. . .  ..   ....   .. ...  ..    .. .. . .  .  . ...    ..       .    .... .. .     .
.. .. .. .. . . ..  .....      . .. ....  .     .  ... .  .. .  .   .   .. . . . ....
.  .   .    . . . .... .   . ..   .   .... .    .  .. .  .   ....  .   . . .  . . . .
.  .. .. .. . .... ...  . ...  ..     ..  . ..  ..   .    ....   .    .   . . . ... .
.. ... . ...    .....  .   .  .  ..      .    .... ..  . . .. ....  .... .... .  . ..
.....................................................................................
