.....................................................................................................................................................
..  . . ..           ...     ..            .. .  .     .  ... ..  ..  ...   .  .. ...        .   .  .  . ..  ...  .. . .    ... .   .   ..    .  . ..
. ...           . ..    .    .  . .    . .    .   .  ..  .    .   . .  ..   .  ..   .   ..  ...    . .            .   .  . . .  . .     .  ..    .  .
. ..  .  . .. .  .  .  ..       .. .  .  ... .. . .     . . .  . .  .    .    .  ..   . .. ..  ..   ...    . ... .    .  .... .  .   .    . ...   . .
.  ..   ..  .. .. . .  . ... .  .  . .       ...      ... .         .          .        . .  .  . .    .... ..    . .   ..  .  .    . .         ... .
...  .       .    .  . ... . .  . .       .  . .    ..  ..   .. .    . .  ...   ...  .      ..  ....  . .   .   ..     ..        .   ...  . ..    ...
...   . .      . .  . .  ...    .  . ..      .. .  .    .      . ....  .    .   ..   ...      ..  .      ..   ...  ..  . .         ..     .   . .  ..
.  .  .   .   ..   . . .  .    ..   .    . .   .   . ..  ....   . . .  .. . ..    .. .   ..         .          .   .... ..     . .     . . . .     ..
.    .. . .   ... .... .  . .. ..  .    .   .   ...  . . .    X.....  .. . .    . .   ..   .. ..   .. . . .        . .     . .    ....... . .   ..  .
..      .. .  . .    .      ..   .. .   . .           . .   ....   .  .    .  .    . . .. ... ..    ... .      . ...   . ..  . .     ... ..     . ...
.       .  .  ..   . . . . .                . .   . .  . ..    . .. .  ...         .  ..   . ..    .. .      .   .. . .       ....  .  . .  .  .  . .
.  ..       .  ...              .     . . ..  . . ......      .   ..      ... .  .    .             . .     . ... . .      .       ....  .    . .   .
.. ...      .     ..   .   ...   ..      ..  .   .     .   ...   .   . .. .. . ..  .     .  ..   .           .      .   ..   . ..... ..    ..       .
.        ..   ...   ... .   .   .  ...  .    .. .   .   .  .       . . . .      .. .       ..   .. ..  ..     . . ..      . .. ..   ....   .  ...   .
. ..   .  ...  .. . .    ..   .  . .  . .  . .     .      .    ..   .. ....    . .. . ..  .   . . ...   .         .   . .   .     .  ..   . .       .
.    .. ...     . . .. ...   ..  .      ..  .. .   . .. ...                 . .  . .   .. .  .          . . . . .. . . ..   ..  . . .       . .     .
. . . ..     .     .   .. . ..  .           .. .  ..   .  ...     . .        ..   ..    .     ..  ..  .  ..   ..     .  ..  . . . ...  . . . . ..   .
.. ...   .      ....  . . .          .  .         .. ..    . ...    .  .         .     .   . . ....   .       . . . .    .     .  .   . ... .  .   ..
..  .. .  . ...     .  ... . .   ... . .  ....   .  ..        . .         .    . .   . .. .... . .   .     .  ..  .  .   .  .    ..     .    .     ..
.        ... .  .... ... . ..  .  . .   .       .. . . ..   ..   .. .     . ...    .. .    ..   ...  .  ..  . ...  .            ...    ..   . . .  ..
. .       . . .. . . .     .    . .  . ...       .        . ..      .  .... ... .       . ..       .  .. .   . . .   .  ..   .      .   .. .        .
.  .    .  .. ...   ...       . .    .  .         .. ..   .            .  . ......   .  . .     .. . ....    .  . ..   . .    .  ..      ..    .    .
. .    .    .     .. ..  .    .  .   ... .   .         .          .    .    ..   .              .  . .  . ....   ..   . ..      . .. .       .      .
. ..  .          ...  .   . .     . .... .  . .      ..    .  .    . .    .  .   .   ..  . . .   .     .  .      .   .      . .    .   .  .  ..     .
...        ..   .     ..  .  ..  . ..  .. .      .      .  .    ..  .      . .. .. .... .      .   ...    .         .  ..    .. .   .... ...    .. ..
. . .   .          .  ..  .      .  .    ....   ....  .  .   .    .    ...   . . .. . . ...    .. ....   . ..  ..        ..   . .  .    . .   ..    .
.  .. .  ..   ....     . . . .   ..  ....     ..  .  .   .  . .  .  .  .. .. .  ..           .          ...    ...  . .        ...  ...   .    ..  ..
.....................................................................................................................................................
