.................................
.       X          .    .       .
..               .              .
.     .             .  .        .
. . .   .           .      .    .
.   .  .       ..  .        .  ..
.                            .. .
.         .      ..  .          .
. .                 .      .    .
.      .      .                 .
.                  .          . .
.       . .                .   ..
.     . .  .        . . . .  .  .
. .      .           .        . .
.   .  .               . .      .
.     .               .         .
.................................
