...............................................................................................................................................
.  .      .     .   . .       .. . .     . .       . ..      .    X..     ..  . .... .   .  ..       ..  .  . .   . .....   ....  ..   ..  .  .
. ..    . . .   . .  ..  .. ...  .. .  ..       . .. .  . . ...    ...  .   ........ .       .     . .. . .. ..  ..   .    ...   .. .     . ...
. .  .. .  . ..    ..       .  . .. ..  . .  ..  .  .. .  . . .  ....  ..... . . .  . . .      .. ... . ..     . .. .    . . .   ....         .
..    .  .  .  .    .    .    . . .    . ..    .    .    ..    . . . ....    .      .     .   ..       . ...  .. .. ..   . .  .   .  .    ..  .
..   .        ..  ... .. . .   ...... ..   ........  . ..   .   .. ...          .   ..  . .    .  .    .   .  .   .  .  .       ..      ..   ..
.             .    ..      .  ...   .. ..   .  .. .   .   .      .  .  ..    ... .  .    .     . .. .. .. ..   .   .  .  . .    .    .   ...  .
.  .    .      . ..         ....     ..   . .       . .       . .      ..  . .    . ..    ... ... .. .  .       ..    . ..     .. .. ...   .  .
....  . ..  .   ... .. .            .   . .. .    . .. ..    ..    .   ..   . .  ..   .     .     . .      . .      .. ......    . .  ..   . ..
..        . .       .  ...   . .  .    . . .....   .. .   ...  .    ... . . .. .......    . .   .   ..   .. ...    .  .. ..  . .    ...       .
...............................................................................................................................................
