.........
.  .    .
.    ....
. . .  ..
.  .. . .
.      ..
.       .
.       .
.  .   ..
.    .  .
.    .  .
..     ..
..X     .
.  .    .
.........
