...............................................................................................
... ..  . . . ... .  .  ..  . ... ....  . . ...  . ....... . .. .  . .  .. ..... ....   . . ...
...  .. .......  . ..       . .. . ... .. .  . .    . .  . .. .   . . ....       .   .. ... . .
.   . .. ..     .   ..      ..........  ..    . . . .. . .... .. ..      .... .    ..... . ....
........... . ... ..     ......  ..    ....  .  ........ ..... .  .  ...     ... .. ....  ... .
. .  . .......  . ....   ... . .   ..  .  . ... ..  .  .. .  . .. .     . . . ..  .   ...    ..
.. .     .. . .. ...  .... .   ... .  ..   . ...   ..     . ...   .. .    . ...  ... ..  ......
.  ...    ..  ...  . . . .    ...  .... . .... . ....    ... .. ..   .   .....  . ... ..  .  ..
..   .   . . . .  . ........  .   ........ ... .    ..  .   ..  ......    ....  ........ ......
. .. ..    . . .. ... ...  .  . ...  ...  .   .     ...  .. .  ... . .. ..    . . ..  .   .   .
...    .   ........ .. .. .  ..     .   .  ..   ..  ........ .    .  .  ..   ... ...  ..  .....
.. .  .     .    .  . ... . .   ..  ..    . ... .. .......   ...      ... . ..  .   .    ...  .
...... . ...  ..   . ...  ... ... ...       ...    . .   .  .  .    .  . ..  .........    ... .
....   ....   ... . .. ... ......   ...   ... .. ..   ...   . . .... . .....   .     . .. ..  .
.... ... . . .    . ..... . . ..  ...... .   ...   ...   ... .. . ..... .... .  ...... ... . ..
...     .  .... . .....   . ... ........ .... . ..  ....  .  ...  ... . . . . ..  .  .   . .  .
. .  . ...    ..   ...... .  . . . .  .. .   .      .. .  .... .. ..  .. . ... ...  . .. .... .
. . .....   .  . .   .. .  . ...    ...... .  . .      . ...  .X... .   . .. ...       .  . ...
. . ... . . ..  . . . .. .... . ..  .. .  . ...    ..      ....  .    ...... .. ...   . ..  . .
....  .   ..  .. .... .. .     . ...  .  ...   ... ..  .. ..   .    . .....   .. . . ..    . ..
..  ... ... . . ..... .. .. .  .. .... ..   .....          .  . .     .. . ..  . ..   . ... . .
. ...  . .....   . ..  .  . ... .  ..   ... .  .   .  .   .. .   .. ... .   .. .. .  .. .. ....
.... .. .... ..  ....  ......    . ....... ... .. ...... ..     ...    .. ..... ..     .. ... .
... .. . .    . . .  ......  ........ .. ..  ..  .... .. . . .....  ... . . . .... .... ..   ..
..  ....  .   . . . ...  .  ..  ..  .. ... ..     .   ... ..  .. ...  .. ..  .. .  .. . . .. ..
. ... . .....   .....    . .. ...  .. . . .. . ... ... . .. ..... ..         .    ... .   ..  .
. .... .. .. .... .  . ..     .. ..  . .....  ....  ...   ...   .. ... ..   .. . .....  ..... .
...............................................................................................
