.....................................................................................
. .. .    ...  .  ... .   ..   .. . . .. .. .  . .   .  .....           .  .    .  ..
.   ..  ...         .... ..    ..... ...   . ... ..    .  . ..  ...    . ..  .. . . .
. . ..        . . ... .   .. . . ... ..   ..   . . .   ... .  .. ..       . ....  ...
.  .   .  .  .. .. ... .   ..   .   .. . .     .. .  . .....   . .. .  .   . .. .   .
..   .  . ... ... ...  .   .   ..   .  .   ... . ..    ..  ..    .....    .. .     ..
. ....    . . .  ...   ... ...   .  . .....  . ... .     .  ..  ..     .     . . . ..
. ..  .    .....  .... .  .    .    ..     .    . ..         .        ..     . . ....
....      .  . .. .   .              .  . . . .   ...   . . ...      ....... X .. . .
.  ..        . ..    .      . .. . .  . .....                  .  .  . .   .    . . .
.. ... ..   .... ..          . .    ..       ....  .  ..  .   .   . . . .... .... . .
.   . ..  . . .. .      ... ..        ..    ........  . . .  .  .  ...  . ....    ...
...  . .....     . . . ..  ... .  . ...  .......     .  ..           . .     ..... ..
.....................................................................................
