........................................
.         . . . .   . .   .     ..     .
.                     .   .  . .   ..  .
.   ..   ..   .    .           ..      .
.   .    .    .      .   .     ...    ..
...  .    .      . .  .     . .   ..   .
. ...  ...     .  .    ..   .        . .
.                 .    .   .   .    . ..
.  .             .   ...               .
. .       . .    .      .  .       .   .
. ..       . .       .        . .      .
. .. .. ..   .       X     .       . . .
.      .  .    .  .    ..             ..
.       .     .      .  .     . .      .
.        .  .    ...      .  .         .
.  ..           ..   .   .             .
. . .  .            .     .  . . .     .
.               . .  .    . . .     .  .
.   ..   . .     .   .              .  .
.. ..     . ...   .     ..   . ..    . .
.   .   ...      .     .       . .     .
. .. .    ...     .    . .  .. .       .
...  .   . .   . ...   .      ..   .   .
.                 .        ..       .  .
........................................
