........................................................................................
. ...  . .  . .  . .   . .  .  ..  . .     .   . ...  ..  .  ......   ..   ...... ..   .
.  .     .. .          ...      .. .  .  .    ...  ..  .     .   . . ...   ...  . . ....
..... ... ..  ...    . .    . . ..  . .. ......    . .  .   .      .... .    .. . .   ..
..  . . .  . .   . .. .. .... ... .        ..    .  .    .      .  ..  .     .. ... .. .
.    .  .....     .  .  .  .    ..    .  .... .   .. ..      ..   ..   ...    .. .   ...
.   .. ...    .. . .   . .      . .  . ... . .. ..  .....  .     . . . ..  .. .     . ..
.     ...  . . ..     .     .  .. . .     ... . . .....  ... .. . .  ..  ... .   ....  .
...  ..... ....  . .  ... ..    .  .  .   .. ..   ...   ... . ..  ..    . .   .     .. .
. . ... ....  .   .  .. .   ... ... . .      .         ... .  .  .   ... ...  ....  .. .
.  .   .  ...  .  .    . .  ...  . . .. .  ..      .      ..   .  .... .  .   .    . . .
.   ..   ..  .    .  ..   ..   . . ..    .... .      . ... .      . .        .  .     ..
.    . . . ..     .  . .    . .. .      . ....  . .        . ..  .     . . .... . .  ...
.     .  .       ..        ..  .. . .  .   .             ..  . .     ..  ..    .  .  . .
.    . .. .   ..   .  .. .      .   .  .... ..  . ..   ... ... .. .. .  ... . .. .  ....
.....     ..... .         ....   ..  .   . . ..    ... ... .  ..   . . .       ... .  ..
.    . ... ..  ..   .   ...   ....  .. ... .    .... ... ... ..    X     ...    ...  . .
.. .  . .  .. . .  . .. .      . ..          .. ..   ..   .  . .   ... ...  .. .. . ....
..   .     .. .   . ..   .        .  .   ...  ..  ... ... .  . .     .. .   ...   ..   .
. . ..  . .. ...  ..    .        ..  .  .. . .  . .    . .  .    . .  ..    .  .   .  ..
. ....     ......     ...   . ..    .  ..  . .  ..  ...  . .  ....  .   ..   .  .  . . .
.. .   .....  . ... ...  .   ..    .  . . ...        . .  .... .. ...   .   .    .    ..
.........   .  .    .. .  .  ...   .  ..   .. .  .   .. . ...  ..    . .. . ..  .. .....
..  .....    ......   .    ..  .   .. . .        ... . . .  .. ... .. .   ..  ......   .
........................................................................................
