...............
.     .   .  ..
.     .     .X.
.          . ..
...       .  ..
..      ..    .
.     ..     ..
..    ..     ..
. . ..  .  .  .
. .. ...    . .
.   .  ... . ..
.       ...  ..
. . .  ..     .
.. . . .  .   .
..    .       .
. .   .   . ...
.        ..   .
.    .   .  . .
.  .  . ..    .
..   .        .
.        . .  .
.   . .. .    .
...   .  .   ..
..      . .   .
.             .
..        .....
. ..   .    . .
.        ...  .
.         .   .
...............
