............................................................
.         .  .  .           .     .       ..     .   .  .  .
.     ..          . .   . .  .     . .  .     .  .         .
.. ..              ...  .      .  .         .      ...    ..
.     .       .         .    .  X     .                   ..
.    ..     ..           .  ..  . .   ..                   .
.    .  .  .   .   ..    .  ..   ..           .        .   .
.                      .        ..    . .                  .
............................................................
