..............................
..      ..      ..     ...  ..
.   .. .      .     .   .  . .
..  .     .      . . .  .   ..
.  . . .      ... ..     .   .
. .. .  .  .            .    .
.   X   . .  . .  . .   .    .
......  .    .  .       .    .
.. . .   . ..  ..        .....
. .   .  .  .    ... . .  .  .
.. ...    .     .  .         .
.  .   ..     .  . ..  .. ....
.  ...  .  . .   ....    .. ..
..    .   .  .. . .....  ..  .
.      .  ....      ..      ..
..............................
