.......................................................
.        X .     .   ..... .  .     ...    .  ....  . .
.      .  . ... . . .        .       ..         . .   .
. . . . ...  .   .        ..       ..         .       .
...        . .    .        .  .     . ....  .  .  .   .
.    .         ...  .    .         .. ..  .. .  ...   .
.     .  .           .  .     . .    . .  . .    ..  ..
..  .    .    ...           ......   .      .  .   .  .
..        .          .   .  .       ..       .      . .
. ..     ... .  . .  .  ..      .. . .     ...        .
..      .       .    ..... .    .  .     .   .  .    ..
.......................................................
