.................................................
...... ..  .  .. .    ..  . .. . . . . .   . ....
.  .. ...   .. . .  .... ......      .  .........
. .  .     .   . ....    ..    .  . ........ . ..
.   ... ...... .  ...   ..  .  .   . ....... .  .
. . .. ... ..   .  .. .. ..     .. .   ..  ... ..
.. ..  .... .  .........  ..   . ...    . . ..  .
.... . . .. ... .    ...  .  . ..   . .   ...  ..
. .  . . .  ..  .      . . .. ...  ....  . .. ...
..   ...   ...... ..  .  . ... . .... X.. . ... .
.... . .  ...  ...   .. .. .. ... .  ..    . .  .
...   . ... ..... .  .  . ...   . . .  .  . ... .
..  .    .   . .... . .  .   . .  .  ... .. . ...
.................................................
