..........................................................................................................................
.  .  . .       .         . . . .    .   . ... .  . .   .. .    . ...            ..  . .   . . .  .     . .... .    .    .
.          .    .    .      ..  .     . .  ...  . .   . .   .  .      ..     .     ..   ..  ..  .  .    . .. .  ... .  . .
.      .  ... ..     .                   . ...  .    .    .. ... ...    ..  .. .   .        .    ... . . . . .. ....     .
.  .   . .       .    .. ..       .    .... .  .  ..   . ..... .    ....    .         ..      .     .. . ..       .. .. ..
. . .  ... ..            .    .  .. . .    .  . .    . ...     .  . . . .      ..      .  . ...    . ..  ... .    . .. . .
..     .            . .   .        ... ..        . ..   ..  ..           . ..         . . ..    .   .  . .  .   ...     ..
.   ..      . .   .  . .    .  .    ..   . ...       .    .  .   . ..    .. .  .       . .     .      .  .        .    . .
.      ..  .    .         .    ... ..  . . ....   .  .    . ...    ..    ..     ...      .     . .. .. .. ..      . .    .
.   . .    ..      .. ...    .   ...   ..       .        . .   .   . .  .  ..  .    . .     .  ..        .    ..  .. ..  .
.  .   .    .... .  ...   .    .. .   ..  .   .. .    . . . . .. .     .    . .   .     .   .    ..   .. ... . ..   . .  .
.   .       .  . .    ...           .           .    .     .  .  .  .  ..... .  .   . . . . .         .   . ..       . . .
.    . .    . ..      . . .     ..         .. ..  ..     ..   .. ..   ..      . . ..  ..   .        .    ... .  ...   .. .
.     .    . ..     .. .              .              ....      .   ..    .             .   .      .      .     . .   .   .
.   .    . . . ...  .      .   .     .    .       . . .  .   .     . .  . ..  .   .  ...        ...    ... . .     .   . .
..    .       ... .          .     .    ... .    ..  . .... .  .       . . ... X    . .   .....    ..    .  .  ..    ... .
..........................................................................................................................
