................................................................................
. . . . . . .      . .   .  ....  .. .   .    .  .   ..  . ....     .. .  .    .
..        .....    .  ... ... ..  ..... . . .   ..    .. .    . .       .. ..  .
.... . ..     .....  ..  .. ..     . .   ...    ..  . . .          .   .     . .
..              ....  .  ...    .  .  .. .. .  ..   . .  .         . .    .. ...
...   .. ... .  .   . .     . .. ..  ..   . ......  . . .  .       .   .    ....
.   ... .  ..    .. . ......     . . .      .. .  .. ..X ..   ... .. .. . .  ...
..   .. ....  .    .  .   . .     .. ...  .     ..     .     .  .. ..      .  ..
. .....   . . . ..   ..     .. . .  . ...  .  . .     .    .    . .   . .      .
..       .    ..   . .  .     .. . ....  .   .. ..  . . ....  . ..  ...   .. . .
.. .  ........    . . . ... ..   .. .  ....     . . . .    . . . .   .. . .. ...
.. .  . . .  .... .  .  . ..... .. . .       ....  .   . ......   ......   . . .
..    .  ... .  .    . ... ... .    . ..      ..   .. . .   .    .  ..  .   . ..
.   ..   ... ..    .    .... ..    ..    .    .       .   .. ..    ..          .
.. . . .       .       ...... .. . .  .   .   . . . .  . ..    .   .           .
..  .  ..     . ........     . ...        .  .  . .  . ... .  ..        ..  .. .
.. . . . ..       ....   . .               ..    .   . . .  .. ..   .. ..      .
.     ..   . . . .      .   .  . .  .   .. .. ..    .     . .     . ..  .. .. ..
................................................................................
