........................................................................
.  . ..    .. ..   ...     .  ..    .. ..         ..  .      .      .. .
...                  .        .     .    .     ...   ..      .  .  .  ..
.    . .. ..  ...       ..  .         .. ...    .             ..  .    .
.X.     . .  .  . .   .    .  .  ..        .    .   .  .    .      .   .
. . . . ..   .      .   . ..     . ..                   . ..  .        .
.   .     .   .         . ..   ...  ..   .        .   .   .   . . .. . .
........................................................................
