.................................
.                  .     .      .
.      .       .                .
.           .                .  .
. X.          ..         .      .
.             . .   .           .
.................................
