.....................................................................
.       .           .   .      .    .    .    .        .            .
.   .   ...           .    X          . .    .        .             .
..     .        .              .  .       . .     .. .    ..        .
.....................................................................
