......................................................................................................
..    .. . ..         .      . .     ...  ..    .       .   .    .. .   . ..    . .     . .  ..  ... .
.    .    .  .. ..     .   . .   .    .   . .  .  .....  . .   ..  . . ..       . . .   . . .. .  .  .
..  ....  .. .    ..     . .. .   .   ..  .     ..  .  .  ..    .. .    . .. . ...   .  .  . ... .   .
... .    ..        . ..  ..    .  X   ..   .  ..    .  .. . .. ... ..     .     ....        .  .    ..
. .  . .. .   .   .... .   .  .. ...      .  ...  .. .  . .    .           ..    .  ...    .  ..     .
.. ..          .. .   ...  .     ... ..  ..  .     .   .      ... .   .     ...     ... . ..  .      .
.        .  . ...   .    .    .   ..  . .  .  .. .. .  ..  . ..  ..   .....  .   ..  .  ...  .  .   ..
.  ..  ..    .   ..           ...      . . .     .. ..     .  .   ..  ..  .        ... ..    . ..   ..
.             . .      .  . . . .    . .    .       .  .  ..    .  .                .         .. .. ..
..     .  .. . . .... .. .  .  . ... .  .   .     .   .     .   .  . .  ..    . .    .  . .     .   ..
.    .      .  ..    ... . ...    ....   ..   .    .  . . .     . .   .. .      .. .  .. .. . . . . ..
.        ....   ..     .     .....             .       . .. .  ..  ...  . .....      . ...  .. ..    .
....      ..  ..      ... . .  ....         .  . .  .  .. ..   .  .   .. ...    .  .   .    .. . ... .
.. .   .     .  .  ... .. . .            .. .     .  ...    .. . .    . .. ..       . .   ...  ....  .
.   .  .. .            ...  ....  .  .    .   .. .. . . . .    ...  ..... . . ..  .. .....      .    .
..          .. .   . .      .       .      . .. .    .  ..  .. ..    . ..  . .   ..  .. .  . ..  . ...
.. .  .  . .  .         .. .   .    . .   .. . .... .    .  .    ..   .      . ...     ..... ...    ..
..   .     .      ....... . ..   .   .   .  .  . .   .        .  .  .   .  . .   .. .     ....   .....
..  .  ...  ..          ... .    . .   . ...    . ..  .    .     .  .....  .      . ..      ..  ...  .
.     .. . .  .  . .    .      . . . .... .     ..   ......     .  . .         .    . ....      ..  ..
...  ..             .  ...    ...  .   .  ..  . . .. .   . .   .    .. . .          .. .....    . .  .
.  .      . .. ...    . . .......   . .     .    .  ..  . .     .   .. . . ..       .. ..   . . .  ...
...  . ....  . .      .           .   .. .      .     .   . . ..... ... ..  ..   .   .  . .   ..    ..
......................................................................................................
