.............................................................................................................................................
.  .     .       .  .            .                 .        . .                .   .   .                .       .   .             .        ..
.  . .           .       .      .                  .    .                .  .    ..          .      .   .              .                    .
.  .  .                 .            .         .       .     ..        .  .        .  .        .                             .  . ..        .
.            .   .    .    .  .                                               .       .       . .      .          .      .     . .   .      .
.           .             . . .   ..        .            .    .                ..       .      .          .                               . .
.       .                          .  .  .       .         .   .    .       .                       .                  .              ..    .
. .        .                                     ..      .       .                                   .    .                            .    .
.  .   .     . .  .  .       .              . . .  .          .  .            ..          .     .      .  .                 .     .        ..
.       .                      ..                     .                         .       .          ..       .               .               .
.       .       ..      ..  .  .                   .               . .      .                    ..      .. . . .      X         .          .
.         .       .   .                     .      .     .        .     .     .             .              ..  .   .                        .
. .    .   .                                 ..   .       .                 .      .                           .    .  .    . .          .  .
.............................................................................................................................................
