......................................................................
.       ..       ....    . ..          .         .    ..             .
. ..        .          .                    .     .. .            .  .
.              .  .    .       . .  .       ...       . .. ..    .. ..
. .  .. .    . .     .    .      .  .   . .  .    . ....             .
.   .         . .  .    .. ..    .      .       ..       .     .   . .
....         .     .  .. .     ..    . . .      . . .             .  .
..   .   .  .  ... .    .      .  . .. .    .  ...    ..             .
. .    ...         .       .   ..     .  .   .  ..    .       .      .
.  ...        .. ..          .       ..       . ...  .   .   ..  . ...
.  .                  .          .         .     .       ..  .    .  .
.       . .         .  .  .  .      . .  . .     .. . .   ..   ...   .
.    .       .      .  .      .          .      .       . ..     . ...
.   .    . .          . .     ..   .  ..     ....  .          .      .
. .       . .  .. . .      .                             ... .    ....
..   .  .  .  .   .                             .    .       . . . . .
.       . .  .       . .    X     .  .     ..  .      .        .    ..
. .             .  .  .            ..                .  ..      . ....
.        ..      .            .   .....        .           .     . . .
.  .    .          . . .     .      . .      .. ..  .  .   .     . ...
. .    .      . .  ..   ....    ..      .           .   ...         ..
.       . .   .  .             . .         .  .    .      .   . ...  .
.  . .  .     . ..   . .                  .      .   . .            ..
.  .     ..                   .     .              ..        ..    . .
..  .    .                .  .  .  . .    .   .            .   .   . .
......................................................................
