...................................................................................
.. ..  .  .   .   .  .  .    ...  ..  .. ..   .  .     .        ..       . . .  . .
. . . ...       . ..      ..      ... .  .          ...   ..    . ... . .      ....
..    .        .. ..        .     . ...         .  .        ..           .    .   .
.     .  .  ..    . .   .  .  .   . .    .   .  .     . ..   . ...   . . ..    . ..
...  . .   . . . ..     .... ... . .  .. .   .  .       ...     .  ..   .        ..
. .    .  .      .     ...  . ...       .. .. ... .  .   .  .  . .   . .    ...   .
.         .  .     . .. ..   .      .    .. .   .          . .   . ...   .      ...
.. .  . .     ..      .      . .    .  . . ..   ...  ..    .. . .    . . ..    .  .
.        .    . .  .          ....  ..       . .... . . ..          . .    . .   ..
.        .  .         .  .     ..  .. ...                 . . .    .  .  . . .. ...
.  .     .    .     ..      .    .   ..         .        .  . ....  . .       .  ..
.  ..  .  ..    .    .   . . .          ..    .    .. .    .  .  .      .   ..   ..
. .. .       .... .  .   ... ... .    . .   .        ..   .        . .  .     . . .
.  .    ..  . .     .  .  .  .   .   .      . .  .  .      .   .    ...  .  . ..  .
..   ..    ..   ..              . .    .   .. ..   .     .  .... ..    .. . .   . .
..   .  ..  .. .  . . ... . .          .. ... .  .   .  . .    .      ... . . .   .
. . .. ..  . . ..... .         .. .  . .  ....   . .      . . ... . ..   .    ..  .
....      .  .         .        .     ...        .     .....       .. .         . .
.  .....  . .. .         . .. .   .. . . . .     ... .. X  .    .   . .   .  . .. .
.. . .        ...  .   ..                 . .   .  .   ..   ..     .   .      ... .
...................................................................................
