...........................
....    . . ... ..  . . ...
.. . ..  ......   .      ..
. .  .. ..  .... .X. ......
. ... .... ....   .. .. ...
.. ...     . ..  .  ... ...
...     ....... .  ..   ...
..... ....   . .  ..   .. .
.   .. . ..  ..  . ....  ..
.  .... ....     ...  ... .
.. . .  . .   .    ..    ..
. .............   .... .. .
.    ...   . .. . ... .....
... .. . .. ..   . ..   ...
. .. ..    .   .. .. ..  ..
. . .   ...  . .... .... ..
.........  ..  .  .   .. ..
...  ...  . ....... ... ...
.. ...  .....      ... . ..
...........................
