.................................................................................................................
. .....   ... ..... ... ...  .    .   .... .   ... . . .   .  .... .     .. ..    .   . ..   .  . ..........   ..
. . . . . . .....  .     ...    .   ......  . .  . . ....  .. . .      .       .     ......   ..  .   ..   .. . .
.    ...... ...... .. . .. .       ...         .  ... ..     . .... .   .  .. .. .   ... ...  .   ...   .  . . ..
.. ... .  .  .   ..X....    .  . .    ...  . ..  ... .   .. .  .  . .....  . ..  .....   ..   .    ... .  . ..  .
. . .   .   .  ... .. . .....  .. . .. . ...      .   .. .....       . .. .    ...  .  .   .   ..      ..    ....
.   .. . ... ... . ..  ..  ..  ..     ....     . . .  ...       ..  ..  . .   ....  .  .. ..   .. ...   ..   .  .
.. .    .... .  .... . . ..     ..    ..  . ...  .  ..... .. ....  ..  ........... .. .    .  . ... .... . ...  .
..  .   . . ..   .   ...  . . ..  .   ...    ....  . . . .... ...     . .   .  .. . .   . .   ..  ... . .. .. ...
...     .  . ..    .. .  ...     .. .. .. ... ...  .. . . . . .. ....  .. . . .. .    ..... .   .....  ...    ...
... .. ... . .... .  . .... . ..  . . .. .  ...   .  ..  .    ... .     .  .. ..... ... . . ..   . ..   ...  .  .
. ..  .           .    ..  .  .   .    ...... . ... .  ..       . ....  .    ..  .  ..  .  . . ...   .. .... ....
.................................................................................................................
