.................................................................................................................
.          . .      .            .    ...       .   .   ....             . .   .. .. .         . ....   . ...   .
.   .  .  ..    . . .  .  ..              .       .       ..  .    .     . ..     . .. .  .       .     ..      .
.      .   .  .         .    ... . .      .     . .   . .   .      ..  .  .    .    ..   .      ... .           .
.   . ..    . .. ..           .    .      .   .   .  .   .    .. .    .    .  .   . .      .  . .        .     ..
.   . .  . .   .  ..       ..       .... .   . ....             .. ..  .        .    .     .       .   .  .    ..
.  .            ..   . .     .   ..  .            . .   .    .   .    .  ..    .   . .   . . .                  .
. .. ..   . .   .  .       ... .  .  ..              ...   .   .      .       .     . .  . .    ...             .
. .       .. ... .   ..     .      .      ...           ..     .      .  .    . .        .   .   . . .        . .
.X .  . .       .    . .    .. . .      .     .  ..               .  .       .   .    . .  .   .                .
. .    .   . .                 .                      ...   .          . .           .    .  .        ..   .    .
. . .   .   .    ..     .     . .       .       .    .  ..            . .      .        .  .                 .  .
.   .   .          .     .             ....   . .   .. .  .   . ..    . .      .  .. . .      .   .. .          .
.    .  . .   . ..     ....      .  .   ..    .          .  .    .  ..      .  .   .  .   .  ..   .. .   .    . .
.      . . ..     .     .  .      .   . .      ..   . . . .    .   . .  ... ...    .     . . . .  .      ..     .
. ..    .   . .  .  . ..       .   .         .  ... .  .  ..     .    ..     .      . ..  . .      ..     .   ...
. . .    .              .    ..  .    ..     .        .   .      .   . ..      .  .  .   .         .      ..   ..
.  .  . .       .  ...   . .    . . .    .  .   .                 . .. .   ...  ..   .     .. .    .  .    .   ..
.          .   .    ..    ..  ..      ..  . .    .     .  .     .  .. .    ..   ..      .      .   .    .   ..  .
. .    .  ..   .    .  .                 ..                .        ..         .    ....       .     ..  .. .   .
.................................................................................................................
