..........................................................................................................................
.....  .. .X.  . ....  .. .   .  .... ..  . .    .... .  ..   ..  .. ... .  ...... ..    .  ...   ..  .. . .. ...   .  ...
.   .... ...  .    .   . . .   .  . ..  .   .. ..  ..  ...... .    ... .    .  ..... .  . ..   . ..  ...      .. .. .   ..
. .... .. ..    ...   ..   . ......   ...   ... .. .   .    .... ...      . ..  .. ..  .  .   ...... ... . . .   .  ..  ..
.  ..  .... . .  . . .   .  ... .   . .   . .   .. .. ... ..  .  ... .. ...  ..   ..   ... ..... ..... ..........  . ..  .
....... ..  . .... .   .  ..  . . ...  .... .. ..  ..    ......  ..   .....     .  .. .  .. .    ...   . .  . .  .  ..  ..
..  .  .... .... . . .. ..  .   ... .. ...    ..    ..  ...  .. ..  . .         ..     .  ...  .. .      .  . .  .. .  . .
.  ..... .  . ....      .... .... . . . ...   .. .  .   ..  .   ... ....... ........ .    . .. .. .... .. ..  .. .     ...
.  .  ... ..          .    . ....  ... ..   . .. ..  . .   ..... .    ....... . ...  . ..   ..  .. ......... . .. ..  .. .
.. .  .. ... . ... ... .   .. ..   ..  .    .... .      ... ..... .   . ...    ... ... .. .   . .   . ...  .   ....  . ...
. . .. ..  .   .... . . .......     . ..    .   ....  ... .   ......  . ....    . . ..  . .. .   ......        .  ........
......      ..   ..   ..  ..      ... . .... ...  ... ..  .  .. . . .   ....   ...   .. ... ..... . . ..     . . ...... ..
... ...  .  .       ...    ..    ..    ..   .     .. .. . ......   .  . .  . .. . ..  ...  ..   . ....  . .. ..     .... .
.. .. ..   .. . .  ...   .. ..    ....... .  .....  ....... .. ...  ...  .... .  . . .  . . . . .. ...  .   .     .. ... .
.    ...... . . ..   .. ...    ....  ..  .  ..  ... .. . . . . .....   .  .  .. . .  .  .   .. ....... ..  .  . ... .... .
.   ....    ..        . . ...      .      ....      . .   . ..  . ..   ..  .   . . ... .. . ..... ....  .   ...   .   ....
.. .   .  ... .       ...  ... . . .  .  .  ....   .... .    .  . . .....   .         .  .. .  ... . ... . ..    . .  ....
.    ..    ..  .. ... ...   .... .. .     .........     .. ... .  ..  .   .....  ... ..   .    .... . . .    .... .. ..  .
. .....  .  .....    .  ... .. . ...  ...    ..... ...  .. ..  . .  . . ....  .  .      ...............  .. . . . . .  ...
. .....     ..   . . ..  ..  ....    ..     ...  .  .. ... .....  .. . ...   . ..   ..  . . .. ... .   . ..  . ..  . .  ..
..   .. . ... ..  ....  ..   . ... . .. .. .   . .  .. .   ..  . .... . .. ... .  . ......  ..... ..   . .. .    .   ..  .
...      ..  .. ..  ... .  .. . .  ..    ..   .   . .  .  .. .. .   .... ..  .    ...... .  ..   .... .. .     . . .  ....
.... .. .........  . . . . ...... .... .. ..  .. ..  .... ..  ...       .. .  .     .  ..  .. .   .. .   ..   . . .. . . .
..... ...  . .  . . . ..   . . .  ...    .  ... . .  .. .     ...  .  .  . ..  .     . . .  .  .     ..  ..   .... .. . ..
.  ....   ... .... ...   ..... ..... .. ..        .  .   ... ..  .. . . ...  .. ...... ... .. ...   ...  . . ...     .  ..
.  ... . ..   . ..     ... . .. . ..  .  .  ....... . ...        . .  ..   ..   ..  ...  ...     ..      ...    .. . .   .
.....    ... . . ..   ..  ..  .  .... .   .    .. ... ....... ... .......  .   ..   ... . ..   .  . ..       .  . . ..   .
..........................................................................................................................
