.................................................................................................................
..   . ..    .       .   . .. .   .  .  ...    ..           .  .  .      .  .   .         .          .         ..
.    .     .         ... . .   .          .. . . .        .         ..    .   .        .   .            .  .   ..
.    ..          .   .   . . .           .      ..     ..     ...   .     ...   X.      . .           . . ..    .
.................................................................................................................
