..............................................................................................................
.   ...        .    . .....  ..   ... .         .  .. .  . .  .  ... ...            ..        ..  . .... ..  .
.  .        .   .  . . .  .. .       .  . ... .  .  . ..  .  . . ... . . ..  . ... ..  ..     .      .. .... .
.  .  .  ..   ... ...  ..  . . ... ..  .   ..   .  .     . ..  .  . .  ....   .  ...    . .   .  . ......  ...
. .. . .   .   .  .  .   ... . ...   .   .   ....  ..   .. ... ..  .     . .   .  . ..   ... .       . .   . .
.  ...  .. . .  .   . . .  .            .    ... .  ..     . .... . .  .    .     ..      .   . ..   . ...  ..
....  .  .   .  .   ..    .. . . .  . . ...          .. ..   .  .. .....  ..... ..  ..  .      .  ..       . .
......        ...           .   .. .   . .  ... . . .  .....   .  . ..  .. .. .  .....   .....     . .. ..   .
..   .       ..    .  .     .   .    . .    . . .    .. .. . . ..   . ...  .   . ..   .   . .      .      . ..
...  .   . . ... .. ...  . .. .     . .. .   ..    . ..  .   .. ..    .  ..  .  ...    .     . . . ... .  .  .
..... ...    ..   .   .  ..    . ... .  . ..         ..    .  ..      . .  .   .  ..   . .  ....  ..   .     .
.   . .   . .    . ... .   . . .  . . .  . ... .         .. .       . ..   . ..  .        ..    . .  .. ..   .
...  ..  .. X.  .. ..   .. .   .....   .  .  .   .  ..  .. .  ... .      .   .. .  .. . . ... . ... ..     ...
..   .   . .      .  ... ... . .   ... .   . .   . ...   . . . .   .    ..  . . . .   .    ..   . .  .. .  ...
..............................................................................................................
