....................................................................................................................
..        .  .   .   .            .   ..   .   .    .   .      .. .          ..  .  ..     ...    .        .      ..
. .    ..   .  .. . .      .. .           .  .            .    .X  ..     .. .     . .   . ..    . .  .... ..   . ..
... .        ..          ...  .   ..          .        . .   . . . .. .        .  .    .. .. .    ..  ..  .. .  .. .
.        . . .. .       ..  . ..   .    .. .... ..  . .  .  .    ..    . . . ...    . .. .            .  .. ..     .
....................................................................................................................
