.................................
....     . .    . . .. . .      .
..    . ....  . ...  . ..   X. ..
.  . ..  .  .    . . .      ... .
.     . . ..  ... .   .. .      .
.... ..  .  .      .   .       ..
. .... .   .  ..  .....     . . .
..    ... . ...     ...    ... ..
. ..   . .   .   .  .  . . .. ...
.................................
