.....................................
. .. . . . .. .      .. .  .    .   .
.  ..  ..  . .         .   ..  ... ..
.       ..  ..       ..     . . .. ..
. ..    . ..... .             ..... .
.. ...     .. ..  ....   .  ...  .  .
.. .  . .   ...  . .  ...      ..   .
... .     ...  ..  .. ..  .. .      .
.....   .. ..   .  ..  .      .. .  .
.  .  .. . .. . . .  .   .. . ..  . .
.....   .... . ...   .       .      .
. .   ... . ....  . . . .. .      ...
... .  ..   .  ....  ... ..     .  ..
.. ....  . . .  ..  .   . .. .. .. ..
...  .  .. ...  .. . . .     . .    .
...     .  .    ...  .. ...   ..    .
...  ...     .   ..    . .. . .  . ..
.  ...  .    .....  .. .  .. .. .   .
... .  . ...  ... . . ..      .  .  .
.     .  .  .    . ......   .. ..   .
....    .  . .  .    .         .  ...
...      .  .     .. ..  . ....  .. .
.X.  .   .   . .   .   . . . ..  . ..
...    .   .   . ..  ..   .         .
. . ..  ...         . ..  . .. .    .
.....................................
