....................................................................................................................
.....    . . .    .               .  . ..  ..          ...        .  .. .  .   ..  ....        . . ..   . .   .    .
. ..   .. .      .   .  .  .                     .. .       .    .   .     ....   .    ... ..   ....   .     .  . ..
....      .    .    .  ..      .               .  .   .   ...   .  .           . .  . . .  .   . ....       ..   . .
.       ...   . ...  ..  ....               . . .   ...    ..    . .... ...  .    .      .   .     .     .    . .  .
. ..   .   . .    ..                .    .  ..  . ....        .    .  . .  ...  ..       .    .  ..  ..  . .  .    .
.. ..    . .   . . .    .  ..     .  ..    .  .   .  . .      .....  .  .     .. .    .  .. .X.. .. ..       .  .. .
.  .    .       .  ..  . ..  .      ..        .   .     . . ..  .         .          ..  .   . .   .  .   ..       .
.  .  . .          .. .   .     ....  . .  . ..    ...   .       .. .    ..  ..     ..  .        .. . ... . .  .. ..
.  . . .       . . .   .     . . .  .     . . .   . .. . .      .     .  .    . .  .     .        ..     .      .. .
..     .        ...   .         ... .   .  . ..       .       ....   .     .  ....    .....      . .   .     .   ...
.     ..       ....       .     ...          .    .  ..   .   .      .     .   ....    .  ..  . . ...    ..    ..  .
..   .  ..    .     .     ....    ..     .   .      ..   .  .  ..  .    .   .    ...     ...          .     .      .
... ..   ...  .. .    ..     ..    .. .     ...    .   ....         . ..      .  .      .....   ..    .  .    ..   .
.         ...   ..  ..     . ..     ...    .  .   ... ...  .     .      .   .     ..   ..     .  ...  .        ..  .
.  .    .   .                    . ..  .  . .     . . . .   .  ..     .   ..   .     .  ....  ..    ....  . .    . .
.     . .  .  .  .  .     ..       .    ....         .   ....      .  . .   .    ....   .. .         .  .     ..   .
..    . . .   ..  ....        . .   .   . .      .   ..      . ..  .    .. . .    .  ..         . . .. . .. .  ..  .
.           ...          ...  .   .       .           .   ..     . ..  .   .         .           .  ...  .        ..
..   .   . .   . .  ...     . .  .  . .. .. .. . ..        ..   . .      .. ...   .. .        ..   .        .    . .
. ..  .       . .  ...            .         .  .       . . ....     ...    . ... . . . .       .  .. ..  ..  .  .  .
...   .  .   .  ... ....    . .     .   .    .     . . .. .  ....       ..  ..   .  ... . .  .  .. .. ..  .  .     .
....................................................................................................................
