...........................................................................................
.              .   .   .       .             .                        .                .  .
.                                       .                    .     .  .      .       .    .
.     .                         .      .                         .                        .
.                                 ..                       .     .                        .
.                                                        .           .    .          .    .
.  .      .        .                           .                            .      .      .
..        .  . .     .                                           .               .        .
.                         .    .                                                          .
.                 .   .                  .   .           .                .      .     .  .
.                        .                        .                                       .
.                   .    .          .                    ...   .                          .
.  .      . .  .      .       .                                        .       .          .
.         .                     .     .                    .                              .
.  .              .  .                      .                                             .
.  .                                       .                                      .       .
. .                     X                . .                         .     .              .
.    .                   .              .                                                 .
.  .  .       .        ..       .                                 .                       .
.   .        .  ..              .       .                         .                       .
.        .  .              . .                     .                  . .              .  .
.       .                                           .                                 .   .
.              .            .          .                    ..       .                    .
.  .                             .                                            .           .
.  .        ..   .       .    . .         .                .    .         .         .   . .
...........................................................................................
