..........................................
...... ..     ..  . .. .    .. ..   .   ..
. .....     .   .. .. .  .... ...  . .....
. . ..   .. .  . ....  .  .   .  .. ...  .
.  .     . .  .  .       . .. . ..  .    .
.   .  ..     ..     .   . .. .        ...
. ..  ..  ..    ....  . .       .. ...  ..
. . . .   . . .    ..  ..  ... .. .  . . .
. . . ..    .     .    .... . .   .   .  .
.   ..  ... .   .  . . . .    ..  ..   . .
....  .X  ..  .  .       . . . .. ...  . .
..     .. ..   ..      .   .  .     ..   .
..        . . . .   .. .     ..  . .    ..
.    ..  .....          . .. .    . .    .
. .  . .   ..... ...  ..   . ....  ..    .
.  .....  ....    .   ..   .  . .. .. .. .
..  .  ...  ..  ....   ...      . . .  . .
...           . .      .  .. ...    ..   .
.. .  ..    .... .    . . .. .     . .   .
. .  .  . .   ... .... .    . .    . ..  .
..........................................
