.....................................................................................................................................
.. .  ..    . .         .  ...     .. .    ...    ...   . ..... ..   . . . .. . .      .    .... .     .   . .     . ...  .    .. . .
.    ..  .  .        .    . . . .. ....  .    .....   .      .   .  . ...     ....  . .   .    .  ..  . ... . .  .....   ..  ..  .  .
..  .   .  . . .        .. . .  ...... .     .  .. .     .    .  .   .  . . . ... . ....  . .   .   .   . .. .. ..  . . .      . ....
.. .   .. . . .    .  .   ..  .   . .     .   ....... .   .         .     . .  . ..    ...  .        .   .   .        ..  .    . . ..
.   .      ..      .  . ..  ...   .       ... .. ..    ... .    .  ..    . ... .     .    . ..    .... . .   . . .  .    .  . .. . ..
. . . ..  . . . .. .. . ..  .   .      .    ... .  .  ..  . . .   .  . .. .. . .     .    ... .   .      .      .. ...  . .    ..  ..
. ..      .     . .     ... ..   . .. . ..       ..   .. .  .. ..    .  ..   .. ..  .     . ...  .. .    .  ... .  .   ..  .. ..    .
.  . .  .   .        ..     . .   .   ..  .     .  ..   .  .     . .. . ....   .    ...    .   ...  . ... . .  .      . . .  .      .
.      .   ..  .         . . ...  .   ...   ..           ...      ..    . ....    . .. . ..  ....       ..  .  ... .              ...
.  .   .   . .  ..    .   .   . .              .  .      ..  .  ..     ..  .. .   ... . .... ..   . .. . .    .  ..  . ..... .     ..
. .  ..  .  . ..     . . .  .  .. . .  .. .....  .      .       ....  .  ..   .  ..    . .  ...  .  . .  ... .  .      .   .. ... ...
... . .  ..     . .  .....  . .  . . .   .     .....  .. .....  .       .  .. . . . .  .... .. ...  .. ... .. ......     .    ..    .
..     .  .       .  ..    . ..    .   ... ... .  .   .     ... .  .       ...  ..  ...     .    .... .   . . .  ..   .    ..   . ...
.. .   .... ...     . ..  .... ..      ..  . . .    . .   ... .         .   .   .       .    .  .  .. ..   ... .   ..    .  .   .. ..
. ...       . .   ..   . .  .  .  .   . .   .. .. ... ... .            .  ... ..  . .       . ... .   .   ... .    ..  .  . ....  . .
.           . .... .. ..    .    . . .....     ..              .. ... ... .  ..    . . . . . ...       .       . . .   .. .   ..... .
.     .  .  .  .    . . .. ..   ....  ..  .  ......... ..   .  ... . .....  ..... .  ..  ...  ..     .  . .  .    .  .    .         .
.... .  .     . .  . ...  .. . .   ..  . ..     .    .. ...   .       ..  .  . .. . .  .. ..        .  .  ...  .   ...  . .  . ... ..
. . .. .. . .  . ...  .. . ... . ..   ...  .  .  .     ..  . . . ..  . ..  .        . .  . ...    ... .   ...    ..   . . . . .  .  .
..     . .   . ..   .....  .  .   . . .. . ...     .. ..  .      .. .   .. . . .  .  .  .   . ... . .   .. ...  . .... .  ...  . .. .
.   . ..  .  ..    .    .   . .... .     . .. .........        .    . ..          .         .. .  .       .. ... .           . . . ..
.        .    .. ..    ..   ..       .   ...     .. . . ...  ...      .    ..  .      .  .. . ..   ..        .. . . . . ..  .....   .
. ...      ...  . .   . .. ..    . . ..     .  . ..    . ...      . .           .. .  . .    .       .. . ..  .. ... .. ..  . . .  ..
.. .     ..   . .  ..  .   ...    ...  .   .   .   .     ..... ....      ..X .. . ... .   .   .    .    .   .. ..   ..  .   . .. .  .
. .. . .    ..   ...  .. ...  .. ..  . . ......     .  ....  . .   .      ..    . . .  .      ...... .  .    ..  ...  .  . .   ...  .
..  . .     ..       . . . .       ...  ..... .   ..   ..    .  .   .  ..  . . . . .  .       . .   .  . .  ...... ..      ..  ... ..
.    . .  ... .    . . ..   .    .    ..    ... .   .  ..  . ...  ..    ..  .    ...   . .  ... .  .  .       . .  .  ....  .  ..  ..
.  ..  .....               .    ....  ..  . .. .  .. ..   .  ..  .  . .     ...   .  ..  ...      .  .. .   ....   .. .....      .. .
.....................................................................................................................................
