.........................................................................................................
...    .. .    ..  . . .  .    .      .    ..     ...       . ..               .              . .       .
.      .     ..  ... . .    . ..         .  .     .  . .   .   .    . . .    .     .  .. .     .    .   .
.    .  .       .   ..  .   ..        ..      ......      . ....   .    .    . ..    .     .      . .. ..
.          ... ...   ..  . .      . . .     .   X.  . .            . .    . .  .  .   .  .   .  .   .  ..
. .   . .    . .    . ...  .  .  ..   .  ... . ..     .  ..    .    ..      . .   .     .. .   .    . ...
..       ..         . ... . .   .   .    .          .        . . . .   .    .          .   .  .       ...
.. . .  .. .   . ..             .  . .. .    .       .       .  .   .    ..     . . . .   .  .  ...    ..
. ..     .   . . .  ..  ..   . . .   . .     . .     .      .    ..       ..  .   .. ..  .  ..          .
. .     . . .. .....  .         .      . .. .   ..  ..      ..  ...  . . .      .   .   . .        ...  .
...  . .    .. .   . .  . ..    .  .  .  .  ..   ..   .   .    .  ..  .. . .   .. .    ..  .       .  . .
..        .  . .    .    ...    ..   .    ...                       ..  ..... .              .          .
. .      . .  . .          ...   . .   . .   .            .    .. . . .           .   . . ... .     ... .
.    .   .   ..   .      ..    .   ...      ..         .. ..           ..     .     .     .  .        . .
.. .                 .       .  . ..       ..     .  .       ..       .      .   .    .  ..   .        ..
.     .      .    .           .          ... .   . . . ...   ... . .              .   ..        .   .   .
.........................................................................................................
