............................................................................
....     . . .  ....  .   .  .. ... .         .  . .  .   . .    ..    .   .
. .  ...   .   . .            .  . .   ..     .    ...       .  ..     .   .
.    .                     .    .   ...   .  .       .     .  ..   . ..    .
...  .     .  .        . .   .   .   . .               .            .    . .
. .   .. .        .   .       . .             .  .     .      .           ..
.      ..       .       ..    .. .             .. . . .    . .     . ....  .
.  .     .   .   .      .      .     .         .  .  .     .     . .      ..
. .     . .    .     ..   .  .. .  .    .  .   .         .          .  .   .
.  .    .     .  .  .       .          .  .   .   . . . ..      . .      . .
.    X  .       .       . .  ..  .   .     ...         . . .            . ..
.  .   .        . ..     ..   .                 .    . .        ..   .  .  .
. .  ..            ..     .   ..    .       .     ...    .  . .      .    ..
. .. .    .  . .  . .    ..       . ..  .   ...   .      .    .    . ...   .
.   .. .      .   .  .                    .. .       .   .                 .
. . . . . .. .    .   .     ..    .  .  .  . ..    . ....   . .      .  .  .
............................................................................
