..............................................................................
. ..  ...  .   ...    ..  ..  ..... .   .       ..  .  . . ..  . ..    .. .. .
..   . ... .    ... . .        ..    ...    .. .     . ..   .. .   .    .  . .
.. ..... .  ..  ...   .  .. ..  . .. .......  .... ....   ...  . . . . .. .  .
.  .. ..    ...... .. .... .          ... .. ..   ..   .     .    .   . . .. .
. .. ..  . .  . ..  .... .....   . ... .. . .   . .  ... . .    .. ..   . ....
.. .   .. .....        ... ...X     .. .    .   ..  .   ...     .    .  ......
.     . ...   .   .    .    ......  .. ..  .. ...  ..    .   .. ..  ....     .
.. .  ...  ..  ..   . .. . ..  . . ...  . . .. ..  .. ....    .  . .   .. ....
..  .    .. .      ..  .  .  . ...  ...  .... . ....   .  . . ..   .   ..... .
..       .. . . .   . . . ..  ..  . ....     . .  ..  ... ....  .. ..  ..   ..
. ... .    . ...  ..   ...  .  ... . ..   ... .   ... ...  ..  .  .       . ..
..............................................................................
