........................................................................................................
...   . .. .     .... ..    ..   . .    ..   .      ..   .   .  ..       ..  .       . ....        .  ..
.    .  . .  ...  ...  .    .. .. ..     ...    .   ..   .  .   .    .    .   ..    . .      .  ...   ..
.   .  ... ..  .  .    .. .  . ..  .     .  .  .   .   ...  .    ... . .. .  ..  ..   .  .   .   ..... .
.        .      .         . ..     . . .  . ..    .          ..  . .  .  .   .  . . ...   .         .  .
..   ..      .     . .     . .  .. . .  .  .. ...    ...     ..     ..     . ..      ..       . . . . ..
.. .      . . .  .      . .. . . .... . .. .. ... .    .   ..    .        . .   .  .. ....... . . . .. .
.    ...... . ...  .. ...   ...  .       ..     . .          .       .. .   .....     .          ..    .
..  X .    .       . .     ......        . .   .. .    .. ... .  ... .    .     . . ...     ..   . . ...
..        ...  ..   .        ...  . ..  .     .     .   . .  . . .      . .    ..  . ..    .    .. . ...
.     . ..   . ..     .....  .. ...       . . .     .  . .   .. .. .. .    .       . . .    .. ..   .  .
.  .    .   .    .  .. ..   . ... ..  . ..             ... . ..   . .   .     .   .        . ..    . . .
.. .   .       . .      ..  . . ... . .  ..   .  .  ...   .   ..  .    .  .      ..  .    .   . .   . ..
........................................................................................................
