......................................................................................................
.   ..  .     . .. .    .. .   ..   .       . .  ...       .. .. ...  .      . ...   ...  . ..  . ....
. ..  .  ..   . .   ....... .   .. . .. ...  . X. .     ..   .. ... . ... ...... .  .. . .   . .    ..
.. . ....    . .. .    .    .. . .  .      . ....   . ... ..... ..    ..  .   .  . .. .. ..      .   .
. ..  .    ..     ....  ....       ..   . ..       .    . .      ..  ..  . ......    .  .... . ..  . .
. .. .           . .  . ... .   ...  ..   ..  ... .. . ...  .   .    .       .   . ....  ......    ...
. . . .  . . .  . . ..  .  .. ..  .. . ..  .     . .. .  .  .. . . .. .  .  .  ....   . ... .. .. ....
..       .. .  .  .   . .   . .... . ....   ..  . .  .  ....  ..    ... ....    .     . .   ....     .
.. .. .  .. . ..   ... . .    . . ..  .   . ....  .. . .   . . .           .. ..  . .     .     . . ..
.... ..   . ....    .. ..  ..  ..... .   ..   .. .. .    . ... . .....  .     .    . .  .       .    .
. ... .  .. .. .  .  .... ..  ..  . .  .     .. ... .    ....... .  .. . ..... ..  .. .     .. . . . .
.         ..      .  .. . . .   .       ....    .           ..   ..    . ...    ..    .. . .  . .  . .
..              ..     ... .    .    ....   ...      .. ..    .        . .  .  .      ..   .. ...  ...
......................................................................................................
