................................................................
. .  ...  . ....   . . . ...... .. ...  ..  ... ....... .     ..
.   . .   . . ..... .   ... .  .       . ....  .  .... .   .. ..
. .. .... .   ..  .    ..  ..  ... . . ...... ..... ... ...    .
... .. ...  ..    ..... . . ... ...  .. ...  .  .  ..   ... .. .
.  .. . ..   .. .  .. ...  .... .     ..  . .... .  .  .    . ..
.. ..  ...  ... . .    .  . ..   .....  .     .. . .... .  .. ..
.. ...  ..  .. .     .  .. .  .. ... ..... . .... ... ....  .. .
. . ...   . ..  .  . .. . . . .   .. ....  .   . .. ..   ...   .
..    .. . .  ..    ..  ..  . ..   . ... .  .. ...  .... .. .. .
. . ...  ..   ..      . .... .. .  ..... . ...   .  ...  ... . .
.......  . ....  . .   . ..    ... ..    ..  . ...  ..    ..  ..
.   ..... . .  .. ......    ..     . ... .. .. .  ..   ....  . .
.. . .. . .. ..  . . . .. .. .  ....  ...  ... ... .. .. .  .  .
. . .. .  .....  .. . .. ..  ........ ... . ..    .. . .    . ..
..... . ..... . .. ....   .   .. . ... .. .. .... ..  ...     ..
........ .   .. . .  .. . .   .   .  . .. ....... . . ....  .  .
..   ... .... .  .   ..  .... .    ..   .  .  . .. ..   . ......
.  ..  . .. .... ..    .  . .  . ...   . .            ... ... ..
.. . ....  ..  .   .. ..... ......  . . .  ..   .  . ... . ... .
. . . ..  ..  .     . ... ..  .. .  X.. ..   . . .  .  . .. . ..
................................................................
