..................................
.. ...   .  .   .    .  .. . .   .
... . .   .       ...  .      ....
.     .  . ..  .  ...  . .. . .  .
.   ..   . ...  .  .... .   . .  .
.  . . . .....   .  . ..  .  .. ..
.   ...   .. .      ...    . .  ..
.    .    .  ..  ...  .       .. .
.. ..  .. .   .... . . .  ..    ..
.......     ..   ..    . ... .....
. ..... .... . .    .   ... ... ..
.         .  .  ..... .....      .
. ... .. .. .   ...  .. . . ..  ..
...X . ..   ..      .  .. . ...  .
....  . ...  .    .  . .  ... . ..
....   . .   . ...  ... ......  ..
. . .  ..    ........     . .   ..
..................................
