.....................................................................................................................................................
.. . .        . ...  . . .  .  . .    . ....   .      .  ....   . ...     . ..  ... . .. .   .    . ..   ....    .  ... .   . ....    ... .   .   ...
... ... ..     .....  ....    ...   . . .. .. . ... ...  .. ...... . .. .   .  ..     .  ...  . ...    ... ...     .  ...  . . .    . . .      .. . .
.  .   ..  .... . ....  .            ..  .... .  ...  .     ..    ..         . .  ..   .   . .  ...  . .  ...    ....     .   ..  ... .    .   .    .
.. .. ..  . .   .   .  ..  .   . .  .. . .    . ...  . ... ....   ...     . .. .... . .  ...  ..... . ...  . .    .  .   ....  .. . ..   ..    .  ...
.   .   ....    ... ..    .         .. .  . . .   ..  .  ..   .    .   . ..  ..     ......  ..  .....     .      .  .  .. .  .  . .  .  . .  .     ..
... ..  .. ....   ...     ..    .    ... . ... ....      . ...     . .   . .   .    . .   .     .        . .. ..   .    .      ...... .. .. . ..  ...
....  ...... . . .  ......  .  ..     .      ... ..    ..   ..   ....    ....   .  .  ... .       . .      . .   .  .  .  .  .  ....  .. ...  ...   .
. .     ... .    . .  .. ...  . . .    .         ... ....  .....  . .   . .  . . . .  . .           . .  ..  .. . . . .....  . .        .. . .. . . .
.. ...  .  ... ..  .. . ........   .   ...  . .   . . .  .. ...    .. ... ..   .    . . ...   .  .. .  .     . .... .. . . ..  ...   .. . .  . .   ..
.  . .....   ..      ....  . ....      .           .   ...     .... .  ......     .     ..   .  ...   .  . . .  . .  ...  . .. ..  ... .. ..  . . ...
.  ...   ...   ....    ...    .  .. .  .... .   .... .   .. . ...  ... .... . ....   ..   ..   . . ... ...... . ..    .  .  ..   ....      . ... . ..
...   ..... ..  ..  . .  . . ...... .. ...  ..  .  . . . .  . ...  .. ...  . . . ...    . .   .  . ... .  . .  ...            .   . .   . .. ....   .
.  ..  . ..   . . .  . .  .  .. . .....      .. . .. . . .... . . .....  ...   .. .    .... .    ...   . .   .. ... .. .    ...     .  ....  .... ...
.. . . .....  ..  .. ..  . ... ..     .    ...   .  .  . ....   .      ...  .. ..  .  ...  .  ...   .  .    ..    .   .  .. . . ... .  ...   .  . . .
.....    ..     ..     .  . ...  .        . ..   ... .. .. .   .  .      .  .. ..  .. .    .  ..... .        ...... .. .    .   . . ... .. .... . . .
.. ..     .        .. .. .. .  .. .    .. .  ..  .  . ..  .  ..  ..              . .. .   .    . . .... ..  .  . .   .       ..  ....      .....    .
.  .   ..   . .... ..    . .   . ..    . ..... . .   . .     ..     . ...  .            ....... .  ...     . ......   . .    . ..      ... . .  .....
.   .. . .. .  .    ..  .     . ..   ..  . .  . ..   .  .... . . .  ..... .     .   . .   ..          .... .. ..  ...  .    . .    .  .    .. . .  ..
..  . .. . .  ...  .. .. ... ....      . .. .     .  .. .. ....  ... . ...   .  .   .    . ..  . ..       .  X   . . ... .   .    ....    ..   ......
.. . .  ...  ... . . ....            ...    .     . . .  .  .. .    . . .. . . .. .  .... ..  .       .    ...  . ..  .. . . ..... . . ... .  . .....
.... . .. ... .    .   .   . .       .   . . .     .    ... ... .. . ...... .        ..   ..    . ..     ... ..  .    . .   .... . .    ....   .  ...
.    .    ..     . . .  .     .... .   .  . . .  ...  ...        . .  ....  ... .... ...    ..    .   ...  .    .        ..... . . .. . .   ..    ...
. .       .   ....  .  .   .......      ...  . ...    .. . .  .  ...... .   .... .      .  . .  .     .   . ... . ..   .  . ...   ...   ...   .... ..
.....................................................................................................................................................
