............
. .        .
.  .....   .
.      ..  .
..  ..  .. .
.      .   .
.   .  .....
.  . X  .  .
. .. ..... .
.. ..   .. .
.      . . .
.  .  .. . .
.      .   .
.  .. .    .
...    . . .
.  ..  .. ..
....    ....
. ..  . .. .
.     .    .
...  ..  . .
..... .    .
.......  ...
...    . ...
.    ... . .
............
