................................................
.   ..  ....     .. ... . . .... . ...   .    ..
....   .  . ... .. ..... ....  .    . .  .    ..
. .    .       .      ... ...     .... . . ..  .
. .  .   .      ...   . .... .   ....       .  .
..   .  .  . ..    .   . .   .    .. . ..  .   .
... . ..  . .. . X . .   . .   .      . .. . ...
.   .. .    ...    .     .. ..    .   .   ..   .
. .   ...  .    .. . .. .. .... .  ..   . ......
.    . . . ..    . ... ..  ..  ..  . .. . . ....
..... . . ...  .     .  ... ... . . .. . . . . .
.... . . ...   . .. .     .  .  .  .   . . .  ..
. ..  .. .  . ......  .  ..  . .. .  .  . ..  ..
... . .   .. ..... ..      ..     .... .  ...  .
.   .   ...... . ..  .... .... ..         ..  ..
.           .  ...  . ... .        . .....  .. .
................................................
