............................
.      .       ..        . .
. .    ...       ..        .
.      .   .             ...
.    .          ..   .    ..
.       ..       .     .   .
.     .              .     .
..                         .
.                .  X      .
. .      .    .   .     .  .
..           .    .        .
. .                        .
............................
