.........................................................................................................................
.      .   .      ..     .  . . . .   .      .           ..     .  .          .      ....  ..  .  .      .         .    .
.             .     ..         .    .   .  .    .       . .    . .        ...  . .     ..   .     ....   .       ..   ...
....   .   . . .      .  .  .   . .     . ..     .. .      .     .  ...  .  . .   .   . . ..      .            ..       .
.      . ..    .    .  ..    .     .    . .    .            . .  .             .... . .  .  .  .    . .     . .  .    . .
.             . ..      .      .       . .  .        .     .     .. . ..     .    ...         . . .    . .   .    .   . .
... .    .     .   . ..      .     ... .     .      .    .     . .  .. .                              .      .    . ..  .
.           .      .  .    . .           .. . ..             .     .      . .   .      .  .   . .     . ...    ..   .. ..
.   ..    .    ..           ..          . .. . . .         .  ..        . ..  .         .        .   .  .           .   .
..                   .      .    .     ........  .    . .          .  .  ..    . . .        .         .    .   ..  . .  .
.   ..               .  .  .             .  .      ..  .       . .  .   ..  .   .          . .       ..   . ..      .   .
. .        .              .     .      .  ..      .       . . .        .    . . .     .      ..        .  .   .. .   .  .
.         .  .   .   .    . . .  .  .       .   .. . .  .  .    ...         .   ..  .    . .    .   .   .. ..    ...  . .
.          .   .      .         .      .     .  .  ...  .         .    .     .  . .     . . ...  . .     .    . .  .    .
.             .....      . . .      ..            .      ...    ..   . .          .    . .  ...   .  .    .. ..      .  .
.    .  .       ..   .       .   .        . ..         .           . . .          .     . ..   . .      .         .    ..
. .  .   ..      .. .    .....  .  .. .  .. .... .  ...  ... .     .  .    .              .  ..       .      .   ..  .  .
..                     .   .    .     . .     .   ..      .    ..     .       .      .          ...  . .          . .   .
.    . ..                   ..          .    .  .            .  .   .  .    .  . .       .    .      ..  .    .      .  .
.   .  ..            .. . .  .        .  . .     .. .  .             ..      .      .    . ..              .          . .
.       .          .     . .  .    .         ..        .         .          .                   .    .. ..  ..    .  .  .
.  .    .        .. .   .. ...  .     .         ... ..         . .   .  .          .                        ..       .. .
.      .   .       . . .  . .       .     .   . . .    . . . .  .   .           .   .              .                    .
.         . .               .     ..               ..     .      .         ..  ..     .   ..   ..  .    . .             .
.    .   .    .   . .        .          ...      .      ...    .     .    .  .         ..  .   .    .   . .       .     .
.      . . .       .. .   . . . .  . .      . . ..   . ..   .      .       . .         . .. .     ..      .           X .
. ..    .    .        . ..  .       .     .    . .      ..      .      .               ..     ..              .. . .   ..
. ..    . .     ..        .    .   .    .   . ..     .    . .   .  .    .      .   .  .        .       . .   . ..    .  .
.     . .  ..          .        ..      ..      .     .        .   .    .  .      .     ..                  .        .. .
.........................................................................................................................
