............................................................................................................................................
. ...   .....    .. .    ...   ..  ... .  .... .   . ...    . .  .. .    ..   . ... ..   . ...    ... .... .. .  .   .  ..   ..   .   .. ...
.      ..... . .  ...  . ...  . .   . ... . .        . .    . .. ..    ...   ...   .. ..  . ..  .  ....     . ..  .   . . .. .....  .      .
.   .  .. .  . . . ..  .....     .  .    ...... ...   .. .    ...   .  ..   . ...  ..     ..  ..  ..    .  .... ..   ...   .. ..    .. .   .
. .  . ..   .   ..    . .. . ...   .... .   . .. . .  . .....       . .  . .  ..     . ..  .. .  . . . .  .   . . .       ..     .  .  . . .
.   ....  .   . . .     ..  .. .... ... . . .  . . . ..  . ... .....  .. . .  .. .    . .  .  . .   .. ... .  . ...     .   .    ..     .. .
.  .... . .. .. ...   ....      . . ..... . ... ... ..    . .  .... ...  . ......     .... ..   .  .  . .  .. .   ....      . .  .  . . .  .
...   ... . .  .  .  ... ...  ..  . . . .. .... ... ... ... .   .   . ..  ... .     . ..  .. .   ..  ..... ... .  .. .  . .   . .. ....  . .
.  . .. ... .... ..  .    .. ..   . .  . ..  . .  . ...    .. ...   ...    .  .....  . .  ....   ... ..  . .. . ...     . ... .  .  .....  .
.    .. . .   ..   . ...... .   ..  . .... .. .. .   ...   .... .... . . . ..  .    ..    .  ..    ... ...  .  ...  .  ... .   .    . .  . .
. .... .. . ..      . .   ..       ..       . .... .     ...     .  .  ... . .. ..    ..  . .    .... .   . . .. .. ..X .  ..     .  ....  .
.   .       .    ..  .  .  .   .   .  ....    ..... .  ..  ... .     .   .  .  .. . . ..    ... .. . .  ..     . ..    . .. ...  ..    .  ..
.... . .    . ..  ..    ..     ... . .     .. . ..  .   ....   .. .. ..  .  ....  .   . . .. ....   . ... .     ... . .. .... . .    .  .  .
.... .  ... .   ....... . . ..  .. .... . .    ..  ..  . .  ...  . . ... .   . .    . ..   ..  . ....... .... .   ..  .   .... ...   . . ...
.  . ....  . ..    ..      ...     .  .. ...   .   ..  .  .. ... .  .   . .    ... ... .   . ...   ..    . .....   ..   .    . ..    ... . .
.    . ...   .. .      .... ..  . ....... . . . . . . .    .. ...    ...     .  ......    . . ... .   ... . . ..   . . ....  . .  .... . . .
. . ..     ...   .  .. ..  . . ..   ..    .. .........    ..         .. .  .  . .  . . . .. . .  .. ...  ... .. . .   . ..   .. . .        .
.. ... .  .. .   ... ....    .   .. .  ....... . . .... ..   ... . . .  . .  .....  ....   . . .. .  . . . . . .. ..... . ...  . .....    ..
.. . .. .  . ..  .  ....  ..   . . .  .....  .  ...  . ... .     .. ..... .  . ....   .. .  .   . . .       ... .  . . .. .  . .  .. .  .  .
. ..  . . .  .     .... ... . .... .  ..    .   ..    .....  .  .  .  .  .    ..    ... .   . ..   .. . .     .  ..... .     ..   . . .. ...
..... .  ..  . .  ......    ... . .. . .  .  ... ..... ..  ..  . .   .. .   .. ...   ....   ...    ....   .   .. ..   .     .   . ......   .
.  . .     ... . .  .   ...... .    ... .      .       .  .  .   .. ..        ...  .  . . ..  .  .    .     .  ... ..  ..       . .....  ...
. ..   .  ..  .. . ...... .         . ....  .        .  . ..  . .. ..    .  . ....... ..  .    ...     . ....  .   .  ..   ... . ...     ...
..  .... .. . ..  .     . .  .  ....  . . ..   ...   .... ...   . ..    .   ...    ... ...  . ...  ..    ...  . . .   .    ..  .. ......  ..
..  .. ...  . . . .   . .. . ... .  ..   ..    .....     .    .  .  . ..  ..  .. .   .. . .   .  ....   ...     . .. . .......   ..   .   ..
..  ...      .  ..   .. ..  ..  ...    . ..  ..  .. . ..   ..  ..  .. .    ..      . ...    .............  .  .  .. .. ..  . .    .. ..    .
.      .. .    ..   .  ..... .   ..        .  ..      . ....   .. ... .. ..   .     .  ..   .   .. .   ..   .  ..    ..... .. .  . ....... .
............................................................................................................................................
