........................................................................................................
..  .     . .         .  .....      . ..    . . .   ..   .  . .       ... .  ..    .. .  . ...  .      .
. .  .     .  .  ..   ..  . .       .. ....  .  . .   .  . . ..  ....  . .  .   ....    . ...  ..    . .
.  . .   ..  .. . .... ..  . ... ..      .. . .   .  ...  .. .. .    .  . ..  ..  .    .....    ....  ..
.. .  ..  . . .  ..    .  ..     ....   .      ...    . .   . .  . ..  .  .. ...   .      .  ... .. ....
. ...      .    .  ... .    . ... ..  .  . ..  ... ..    .     . ..  .    .  . . . .    ..      . .  . .
..    ... .. .. .  .   ..    . .    . ...  . .  .      ..    .   . .  .  . . ...  ....    . ..  ..   . .
. .  .    .      .      . .   .  . .  ..          .  .  ..  . .      . . .. .    ... . .      ..     . .
...    ...   .   .. ... ... ..      ...    .       .. .   . ..  .  . .. . ..... .   . .     ... .    . .
.     ..   .      ..   ...    .    .. ..        .  .. .  . .. ....    . .  .   . .. .   .... .     .. ..
..        .   ..   ..              . ... ..  . . .  ..   ..          .   . .... .. ..   ...      ..   ..
.   .   .    ..   ..   .     .       ..  ..  ... .. .  . ......     .   . .   .  ..   . ..   . ..   ....
...      .          .   .  .      ....     .   .     .       .. .. .   ..           .. . ..  . .     . .
. ..  ..  .  .. ..  . . ..    . ... .  ..... .. .  . . .     . . ..          ... .  ...       . .  .. ..
..   . ... ..   .   .  ..      . . .    .. .       .  .    . .. .  . .. .       .  . .   .. ..    .   ..
... .  ....  ..  .       .   ..  .    . .  .....   .   ..    .. .  . .. . .      ..   .   . .. .....   .
.. . . ..        ...   . .  .. .   ...... .  .   . . .. .   . .  ..            ..    .  ...  ..   .. . .
.        . .. ..     . .    ... .   .  .   .. .. ..  .        . . .       ..   .       ...       . . . .
... ..  ..       .  .  . .     . ..  .            ...   .  .    .    .    ..    .  ..  .. .. . ... .   .
. ..    .     . ...  . ..  ..    ....    ....   . .. . .   ..  .     .      .  . .. .. .  .... .. .. . .
.     ..   .  .  ..  .. .  ... .          .   .   ..   .... ..... .....   . .   . .  ...  .     . ...  .
. .     ....    . .     .  .  .. X...    ..     .  .    ...            .        .     ... ..  .    . ...
.  .   .. .     .    .. . . . .     .    .   .  . .  .  .     ..     . ... .  .   .. . .     ... .  ....
...   .. .   . ..  .       . . ..   . . ...    ... .. ......  .    . .   .... .. ....    ..  . ...  ....
.  .      ...   .          ..     .  .    . ..  .    .. . .  .. .    .     . . .....    ..       . .. ..
.    .... .    . .   .. .. .        . .     .  ..  ...            .   .   ...   . .      . ....  ... . .
. ..  .. . . .. . ...    . .  .    ..       .  .  . ...  ..  .. .   .      . . .  . .     ... .       ..
. ..... .         . .        .      .. .  ...          ... ... . .    ......   .    . . .    . .  .    .
. .   ..  . . .  ...          .. . .  ..   ... .  .   ...   ..  ..     ..     ..       . ... ..       ..
........................................................................................................
