....................................................................................................................
.. .   ...  ... ..  .     .. .   . .   .  ....      ..    .   .    ... ..  ...  ..    . . .. ..... .....     ..  ...
. .          .......... . .    .. .   ....    ...  .. ..  ...  .  ..   . ...  .... ...  . .     .  . .  .. ...   ...
.  .....  . ...   . .. .  ....    . .  ... ..   .. . ....   ... .     ......  ..  .  . .. .      .  . .  .. . .... .
......    ... .   .... .   .  ........ .. .  ....  ..   ..    . .   ...  ...        . .  .  ..... ...... .  .. . ...
.  . .... .... ..... ...  . ... . ... ..  ... .   .  .. ....... .. ..         .  . .. ....     ..   . ..     ...  ..
... ..  ... . . .    ... ...  ..... .     . .  . .  ...... ... . . .....  .. ...   .   . . .. ....... .  . . . ... .
.   . .  ...  .     ..    ....    .. ...  .  .............  . ... . . . ...  ... .  ... ... . .  ..   .    . ... ...
.. ....  ..      ..   .....   . . . ....   .   .  .. .... ... ...          . ..  .. . . .... . .  ..... .  . .. .. .
.. .  . ..      ... ....   .. .   ....  ... . ..  . .  .  .  ........ .....  .... ...... ... . .  ..    ..  . ......
.. ..   . ..  . .    . ... ... .. .. ...     .   .. .   .  . ..   .... . . ... . ... .... ..   ...  ..   ..  ...  ..
.   . ..X  . . . .    .  . ..... ...... ..... . ..  ... ... . .. ..    .....  .....  ...  .       . ...  . . ... . .
.   . . ..   . . ..... ........  .     .  . .  .......... ........ . .  .   . ...   . ...  . ..  ..   . ..   ..  ...
...  ...    ......  ... ...     ...   ...  .     .  ... . ....  .... .  . ..  .     .. ...    .. . .....  .  .. .. .
..  .  .   ..   . ... ..........  . .... .. . .. . ... ....  . .... . . ..      .....   .... .. .   . . .  .  ..  ..
....  ..  .. . . . . .    ....  . ... . .  .. .. ..        .    ..   . . .   .  . . .    .....  ..     ... ..   . ..
.. . .  . ..  ... ...... .  . ..  ..  .........  ...... ..  .  . ... ....  ..   .   ..... . ..   .. .... . .. .. ...
.. ..... .. .. .. .  ...  ...  .. ............ .......  .. . .   ....   .. .. . .... .. . .. ......   ... ... .... .
...  . ...  .. ... .. ..  .  .  .. . .  .. ....... .   .  ..  ..  .  .     . .. .   .  . .......... .........  . ...
. . ...  ... .   ... . . .. ...    .. . .. . . . ... .. . .. .. ..   .   .   ..   .. .. .... . .......  .. .. ..  ..
.... .  ...  ..... ....... .. .    ... ....  . .  ........  . . ..   ... .    . .  . .    .  .  .  .  ...... . .   .
..... ..  ... .. ....   .  . .... .  .. .  .... ..  . .. . ... ... .  ....    . ... ... . .. .... .... .  .. ... . .
.... .. ..  .    . ...     ..  .. . ..  .. . .. ... ..  ..  .  ..   ... ... .. .  . ......    ..  .... .. . .    ...
... .....  ....  ... .    . ..  ....  . ... . ..  .    ... ... .   .  .   .  . ..... ..  . . ............  .. . . ..
....  .. .  . ...     . ..  . . .    .....   . ..  .. . ...      .. . . .. . . .. . .... ...     .    ..   .  ... ..
.  .    .... . ..   .... ...... .    . ..... . ... . . .   .. .......... . .    . ..  ... .  ..  ....    . . .......
. .... .   ... .. ... . . . . ....   .. .. ..      ...  ...     . . . ... ...    ...   .     .. .    ...   .. ..   .
. . ..  ..   .   ...  . ..  .   . . . .....  .   .. . .... ........ ....... .. .    .... .. .   .. ... .     .......
....................................................................................................................
