.....................................................
.. . .     .  . .     .  ..... .             .     ..
.       .  .   . .       ..      . .   .   .   .   ..
.  .. .       .              .           ...    . ...
.     .... .  .    ...   .  .           .           .
.      .   ..  ..    .. . .  ...   . .  .  .... .  ..
.   ..    .       . . . . .  .  . .     .   .     . .
.      .   .              ..       . . .  ..  .     .
.. .     ..  .     .    ..           . .   .        .
... .    ..   . . ..   .       ..    .         ..  ..
.   .   . .        . . ..     .   .  .    . . ...   .
... .         . .      .... .  . ..         .      ..
. .     .         . .        .     .    ..        . .
.. .       .                  . . ..  .    ..  ..   .
.     .... .       .                       .  . . . .
.     .. .   .       . . .             ...        . .
..      . ...    ..         .   . .   .  .       .. .
. .. ... .        .     ..  ..    ..  . .  .     . ..
.        ..          . ..   .   .   ..  ..   .. .. ..
.  .     X.   .          .      .   .  .  .  .   .  .
.  ..  .     .       .                   .    .... ..
. .  .   ..     .  .   ..         .     .. .. ..    .
..   . . . . ..  .     . .     .  ..   .. . .       .
.       .     ...    ..   .       ..      .      . ..
.   .   .   .. .            . ..  . .  . .    .. . ..
.   .  .    . .   .    .         .. .              ..
.        .   .  . . .  . .  ...    .      . .    .  .
.     ..        ..         . . ..                 ...
.....................................................
