..........................................................................
. .      .   .    ..                      .   .         .  . ..    .     .
.   .     .    .   . .            . ..        .  . .           ...     . .
.      ..        .    . .        ...    .  .   ..  .  . .             .  .
..      .            .  .   . . ..       ..   ..  ..     ..         . .  .
.  .. ...         .    .    .         .  .. .    . .  .        .    ..   .
.  . ..  .             .        . . .. .      ... .    ..   .. .. .  ... .
.. ....   .    .  .   .           .      .        .  .    ..    . .    . .
... . .                    .  ..     .         ... ..    ..    . .  ..   .
.    ..        . . . .   .    .    .  . .    .  .             .  . ..    .
.    .          ..  .      .   X.  ..  . ..        .      .     .  .     .
.       . . .   ...   .          . . .   .  ..        . .    .        ....
.    ...         ..         ...  . .      .           .     ...          .
.  ...          ..    .  ..  .    .    .      .     . .. .  . .. ...     .
.  .       .   .   .          ...         .   .   . .  ..       .  .  . ..
..........................................................................
