.........................................................................................................................
.  . .   . .       ..   ..   .   ..  ..     ..      . .. .   . ..  .        .  ... . . .    ...   . .     . .  ..  ..   .
.       .    .....      .   ..   .. .  .  .         .  . .    . .. .               ...  .   .    ....      ..   .    ....
.         ..     . ..        .  .   .... .  .. ...        .     .  .         .  . .       . ..    ..        .    .  .   .
..    . .. .. . ..     .  . .    .. ...  . ..  .  . . .. ..    .   .           . .   . .         .X       ..  . . ..    .
..      . . .    . ..   .  .  . . ..  ..        .    .   .        .          .     .    .  ..        .  .      .  ..  . .
. .  ..  ...         ..  . .    . .    ..  . . .        . .  ..      ..      .       . . .    . .  .                 .  .
.........................................................................................................................
