..................................................................................
.    ..        . ...    ..        ....    .    .   .   . .    . .     ..   .   . .
..   .   .  .            .   . ... .      .     . .   .   .  .     .  .  . ..    .
.  .    .      .           . ..       .     .  . ..   . .         .        .  .  .
.. ...            .    . .      .      . .  . .   ...   .    ...  ...       .    .
.       .  .     .. .  .      ..  .      ..   . .         .     .   .            .
...   . .          .             . .... .     .      ...      .   .          .   .
.        .      . .    .    .      .        .  .  .   . .            .           .
.         .        .. . .  .    .        .       .          . .  .  .      . .   .
.   ...   . .X   .        .        . .        ..     .  .                       ..
..     . ..      . ... . .  ..   .  . . .  .     ..  .      . ..  .  . .  .      .
.           .   .    .         .  .   ..  ... .   .          ..    . . .       ...
..  .   .          .     ...          ..     .      . . . .          . .       . .
. . . .         .            ..     ..        .  ....  .  .   .    .       .     .
.            .              .       .     .              ..  .   .  .      .     .
. ..       .        .    ..       ..  .  . .. .       ... .                      .
.   . .   .         .   .   .             .    .         .                  . . ..
..................................................................................
