...........................................
.. .. ...   .    ..   ......  ..  ..   .. .
..  ... .  . ..... ..  . ....  .  .     . .
. ... .. . . ... .  ...  ..      ...      .
.   .   . .... ..........  . . ...     .  .
.  .      .X. . . . ..   ..    ... . ... ..
... .   .... .  .   .  ..  ...   ..  ......
...........................................
