..............................................................................................................................
..                 .      . .                     .            .   .                               .   ...   .             . .
.. . .          .     .     .         .        .           . .    .      .                              .      .             .
. .      .  . ..       ..          .     .      .              . .  .          .  .  .                  .     .           .  .
.  .      .                                                   . ..       ..     . . . . ..      .   .  .            ..   .   .
.                         .    .          .            .  .           . .  . .   . .                                         .
.   .        .             .. .         .X    .           .   .         .       .             . .   .  ..   .   .         .  .
.  . .        .   .       .      .      .                   .        .              .     .                . .   . .  ..    ..
.   .                                  .   .           .                    .            .                                   .
.  .        .     .           ..  .  ..                          .     .       .                .     ..          .      .   .
.             .              ...                   . .           .      .       .    .        .          . .      .   .   .  .
.        .    .   .           .     .                 . .     .                  . .                 . .           .  .      .
..  .   .               .                                          . ..                                                      .
.    . .                .                             .     .  .     ..               .     .       .     .      .       .   .
.       .  .   . .  .         .                         .   .                                    .                           .
.      .     .    .   .       .       .             . .           .            ..   ..   .                    ..             .
..   . .                 .  .       .      .     .      .                  .      .             .                            .
.           .  ..     .                  .      .    .   .     .     ..                .                .                    .
.          .                        .                      ..                  .     .              .                  ..    .
..   .         .   .                            .                 .   .           .                   .     .        .       .
..     .     .  .   ..                        .                   .          .   .               . .                         .
..  .               .     .            .     .      .       ..           .                              .              .     .
.  .  .     ..  .                       .     .                .  .                 .. .        .   .                . .     .
.       .    .          .       ..               ..           . .        .  .     .        ..    .. .   .             .      .
.       ..                 ..    .        ..         .                                          .   .                 .      .
.      .   .      .              .         .       .  .     .        .          .       .           .    . . ..    .    .    .
..............................................................................................................................
