.....................................................................................
. ..  .. ....  .  . . .          ..  ..    ...... .. . ... . ...   . . ... ....   . .
.... ..  ..      .. .. ..   . .... .. .      ..    ...   ...  . .  .   . ..... . .  .
..  ...   ..  .  ..  . .    . . . .   . .     .......          X. ... ..        .   .
....  .. ...   .  . .. .  . ..  .    .   ...     ..   .   ......   . .  ..  .. .. ...
.  .   ..  .    .   .. ..   .  ....    . ...   .      .  . ..  .    ..  .. . ... .. .
.. .     . .  ...   .  . ...  .    .       . .    .  .   . .   . ... .......  .   . .
.....................................................................................
