...........................
. ...  ....   . .. .. . . .
. ..  .. ..  . ...  .   . .
.. .  .  .     . .. .  .  .
. ...  . ....  ... .      .
...   ... .   ....  .. . ..
..  .  ..  ..   ..  .  ....
....  ..... ... ..  .    ..
. .     ... .  .. ..... X .
.. .. .  .  ..  .... .... .
.  ..... . ...  .  ....   .
.... .    . ... . .  ... ..
. .   . ...  .. ..... .   .
. . .   ..     .    .. . ..
. . ...   . ..... .. . ....
. .  . ..   . .. .  .... ..
..    ...   .  . . ..   ...
. .  .. ....   .  ..   .  .
...........................
