......................................................................
.  .    .            .     ..        .      .  .    .        .       .
.     . .    X.. .   ..    .  .   .....  .       .  .        . . . ...
.                .. .    .   .  ..         . ..   .    .          .  .
..        ..          .  . .  ...      .  .     ...   .         . .  .
.         . ...  . .     . .. ..      ... ...          .. .  .  .   ..
. .  ..     .     . .  .      .    . .    ...   . .  . . .   .       .
.  .  .....  ..                  .. ..   .      . .    .. .      .   .
.   . .   .....  ..    . ..       . .. ..  ...   .    . ..  .. . .   .
...         ..                 ..    .          . .    . ... .   ..  .
.  .  .    .  .      . .  .       . .    .  .  . ...  . .     . .    .
......................................................................
