...........................................................................................................................
.     .        .    .. .    .  .           .        .  .          .     .               .          .    . .   .           .
.   .            .        .  .          .      .    .. ...            .       .      .        .   .          .  .  .  .. ..
.. .        .      .            .           . .  . ..  .  ..   . .      . .   .   .    . ...         .       .     ...    .
.                  ..     .     . .                  .     .   ..                  ..  .. .        .  .      .    .   ..  .
....    .       .   ..          .   ..    .       .         .       ..    ..    . .     .   .     .  .      .       .   ...
.  . ..  .   .      ... . .      .                ...    ...         X      .    .   .    .        . . .       .          .
..      ..         .  .    .        . ..       . .              .             ...  ... .      .           .    .....      .
...........................................................................................................................
