.............................................................................................................................
.    . .... ..... .  ..... ... .  .    ..  ...  .. ....      .      ..   .   . ... . . . .. . . ..  ...     . ...    .. ... .
. .  ... ..  .      .. .   .  ..   ....   ...    .  . .. .  . ... .... .  ..     .      ............  .. ..... X. .  .  .  ..
..      .   ........  ... .  ...    ...    . . . ....    .. .  .. ..  .  .      .. ..   .. . ...  . .. ..    .  .  . . .  . .
.............................................................................................................................
