........................................................................................................
.  .   .. .   .  ..    .  ... ..   . . . .     ..     .. ... . ..  . .        .   ...  . . ..  .  .    .
......... . .       ... . ..      ..  .. .. .     ..   ... . .. .. .    .. .  ..    . ...    ... . .   .
.    ....    .. .... .   .. . ..  ..    .  ....  .....   .  .   .   .   .     .   . . .  ..   .. ... . .
.  .. .    ... . .. .   . .   ... ..  ..  .....   .  . ..   .  . .. .  ..   .   .... ..  ... ..   . .  .
.   .. .  ...  .  ..   . .. ..    .. . .. .  ..   .   . .        . .    . ..  .    .  . ....       ... .
. .  . ..   ..  . .      . . X  . .         .   .. .  .   .   . ......     .  ..      ..      . ..    ..
.. . . ...    . .....   ... ...... ...  . .    .      . .    . . .... ...     .. .  .  .. .  . . . ..  .
.                 . ...       .....     .  .  .....      ...... .      ..   .     ..    . . ...      ...
. ..   .. .  ......  . .   . .  .  .   .. . .. .  . ..    . ....  .. . . ... . .   .   .       ..    ...
. . ..   .. ..   . ... .   ..  . .. ...  ...   . ...      .      .  .  .   .       ..... . .   .. .  . .
........................................................................................................
