.....................................................................................
.     ..... ..        .   .. .     . .... .  ..    .     .  .      .. ......  .  ....
....  ..         .    ...     . .. ...   .  .       . .        .  .... .    .   . . .
. ... .     .    ...... ..   ...  .... ... ... ... .    ...  .   ...     .    .   ...
.       .  .      ..  .  ...     .... .. . ..  .   ... .....  .    .    .       . ...
..  .   .. ... .        .  .  ... . .     ..  . .  .     .  . .  .   .   . ..   .   .
..   ..   ...      ..         .         ...  . .  ..     ..   .    . . ...     ..  ..
. .. ...... .   . . .. ..  . . .   . . . ...      ..  ..  .. . .    ...  ..  ..  .. .
.       ...    ...     . ......      ..... .. . . ....  .    .  .   .  .   ..    ....
..  .         ..    .   . ..   ....  .    . . ....    ....    . .  . .. . . ..    ...
... .  .....  ..  ......... .  .  .  . .. ..  ..     .  . .. .    .. .  .  . ..... ..
...  ..       ..     ..  ...   .  ...  .  .. .    ...  ..   . . . .   .......  .    .
..  ..  .. .  .  ... .    .    . .     .....    . . ..  .   . .  .   ...       .... .
.. .  .    .  . ....   .. . ..     . .    ..   ... ...   . .  ..   .. ....   ..   ...
. . ..   .   ..    .  . ... .    . .     .. . .      .  ...  .        ..   .     .. .
...  .. .   . .   . .   . . .. ..   ...... .  .  ....     ..  ..       ... .. ... . .
. .....   .. . ..  ..    ...   ..    .. ... ..  . ..  . ..      .  .  .... . ...  . .
. . ..   ... .      .   .  ....    ....  . .  . .. .     ... .  .   .    . ...   .. .
. ..  .... ... . ..  . .  ... ..       . . .....   . ..  ..    . .  . .. .... .  . ..
.   .  .. .... ..    . . .. . .    .. . .   ..   .... ... . .  .  .  .. .       X   .
.   .   .  .  .  . .  .  . .  .        ...   . . . .    .  ... ..  ....    .    . ...
. .  .  . . .. ..   ..  ......  .... . ... .. .. .   .. ..  ...      . . ..     .. ..
.. ....  .. .     .   .. .  .  ...  .. . ..  .      .  ..  . .. .    .  .  ...    ...
.....................................................................................
