.............................................................................................................................................
.  . . ..    .... .   . ...  .. .  ..... . . . ...  .... ...   ....   . .  .  .... . .... . ... . .  . .. ..   .   .. .   .  .......        .
. .     ... ..    ..........     ...  .........  .. . ...   .  ..   . .. .. ....        .  .  ...   .  .    ... .. ..       ....   . .   .  .
.. ..   ..    ...  .  ..  ... . ...  .  .   .. . .  ...  ..  . .  ... . ...  . .      ..  . . ..  .... ..     .  .   .. .  .... . ... .  .  .
.   ...   .   .  .     .   . ..  . ......  ..  . .. .. ......  . .... .   .. . ....  .. .  .. ... .  .  ...  .   . .. .  .......... ....... .
. ..  .   .. .. .  ..    ... ..    .  . . . .. .. ....     .  ....  ..     .. ..  . .... .      ....   ...  .. ... ..     . .. ..  . . . . ..
. .      .. .. . ...      .   .  .   . ...  .  . ..  .    ..  .      ..    .   ..  .   .  .......  . . .. ..  .. . .  .     .   .   . ..   ..
. . .  ...  ..........   .. ......    .. .   . .. . .... .  .. .. ...   . ....  ..  ..  . .        .  ....      . .. .......  .   .  . .   ..
.       ..   . .  .  . . ....     ..  ....   . ... . ...  ..   ..   .  . .     . .   .      . ....  ..  .      .. ... ...  . ....... .   . ..
.....  ....     ......   . ..  ....  ...... ....   . .. .  .     .... .......    ....  .........  . ..  . .. . .... . . . .     . .. ........
... . ......  .. ..... . . ..    . . ... ... .  .... .. ...  .. .. ... .     .  .....  ..  .   ... ..  .   .  . . .... .   . ..   . ....... .
....  ..    ..   ... .....  .. . ..... . ..  . .  .. ... ..  ....... ..   ..    .   . . ...    .   .  . . ..  . . ..  X. . .. ..    ... .. ..
.............................................................................................................................................
