.....................................................................................
..  ...     . . . . . .... .....    . . .  ...  . ..  ...    .. ...    .. .    .   ..
....     . ...  .           . ..  ....    ... .    . ...  .  ..   .     .. .... . . .
..  . .. .  . .  .     ... .         ..    .  ..  .....    .     ...  ..  .      .. .
..      .   ...   .  .   ...        ...  .  .. .  .    .      . .  ....  .   .  . . .
..    ...     .  .  ...  . ..    .. .   ... .   . .. ..  ...  .  .    ....   .. . ...
.  .  ... ..   .      . .     ..     .. ... . . ....  . .  ..    .. .... . .   ..  ..
.     .  .       . .  ..  . . .  . .    .   .  .  . .   . .. . ...   .  .    ..   . .
..  ...  .   .      .  ..    . .   .   . .        . ..  . .  .          .  ... .  . .
.. ..  . ..  .  .. . . ..          ..    .  .   ..  .     .    .   .  .     . . .....
. . ..    .. . . ...  ..  .   .... .   ... .    .  .. ..  .. .....    .   .    ...  .
..  .    .             .. .    ...  ..   . .. . .X    .    .    .  . .    ......  . .
.....................................................................................
