.................................................................................................................
.. ... .. . . .. . .   ..  ... ..  .  ...... . .. .. ... .   .. .........  .. .  .. .  ..   .      ..  ..      ..
...     . .    ..  . ....   .  . .....   ............ ..  ..    .       .  .  ... .. .. .  .  .. ..  .........  .
.  . .   .     .. . ...  .  .. .    . .  . .    .  .  ...  ..  . .... .... . ..    .  ....    ......  . .  ......
...........  .   . . ... ..   . . . .    .. .. ... .  . .... ...... ...  .  .. .       ...    .     .. .     ....
..   .   ....    ...  . .. . ... . ..  . . . ... .... ... .. . . .    . . ... . ..    .. .. . ....  .. .... .....
..... . .  . . . .  .......  .. ........ .   . ..... ..   . ...... . ......  . . ..... ... . .. ... . . .  . .  .
...... .  . ...  ..    ..    ...  .. .. ..  . ..  ....  .. . .. ............  ..  . .... ... .  .   . . .  .... .
.   . ....    ..  ..  ..  .          .   .     ..  . ..  ..   . ........  .......  ... . .. .....  ...   . .  . .
.  ..  . .   .   .      . . .    . . .  ... ....   .... .   .   .. . .....  .  . ... ..  ...  .       .. . ...  .
......   . .   . .. ..  ........ . ....  .. ... ..  . .  .  ..   .... ..  .   ... . .   ... .    . ....  .  .....
.... ...   . . ..   ..  . ...   ... ...   . .. ...       ... .....    .. ..  .. .    ..  .. ..  ....    .  ..   .
..  ..    .... .   ... .. . .   ... .. ... ..  ... .... .. . . ..  .....  . . .  .  .. .   ..  .  .  ..   .......
... ..     .   .. ... . . .  . . . . ..   . . .. ............. .    . .    ..... . . . ....     .. ..  . .. . ...
. .   .  ..    .    .... ..  ... . . ........X... .. ... .  ..   . .   .   ....... . ..  ...... .  ...... . ... .
.  ....        .. . ..    ..       . . . . . .    .. .  ..   . ..... ..   ... ...      . .   . .. ..  ..    . ...
..  . ...... .. .....    ..  . ........  ..   . . .. .   ..... .  . .. .. ...   ... . ..   . ... ... . . ..  ....
.   .   ..... .    . ....  .   .      .... ..   .. .. .. . . .   . ... . ... .....   . . ...... ..  ... .  .  ...
..  .. ... .   ..  . .   .... .  . .  ..    ..  ......  . ..  . ..   ... .  ..  .... .. .  ..  .  ... .....    ..
.................................................................................................................
