................................................................................................................
..               .       .  . .   .      ...  . .       .   .  .  .    ..   .         .      ..     .        . .
.         .   .   . . .               . .    .  . .   ..     .     .   .           ..            .. ..      .  .
.  .. .            ..     . .    . .          . ..     . . .           .      ... .    .  .   ..       .. .  . .
.   X          . .        . .   ..    . .  .    .  . .       .    .     .  .       .  ..  ..   .      .        .
..  .. .      .         . .      ...      . ..      .      . .              .  .     .              .       .  .
.           .              .     .     . . .          ..  . ..  .      .  .  .    .     .           ..  .    . .
................................................................................................................
