...................................................................................................................................
.      .   .                     .                                                  .         .                   .               .
.                                .                    ..     .                                                                    .
.                            .    .      . ..                                                 .          .                        .
.    .      .    .  .                          .          .                         .       . . .                             .   .
.    ..       .          .. .   .                       .            ..          .     . . .            .                         .
.   .                 .             .                    .                             .                    .                     .
.            .       . .           .                                            X                                                 .
.                                                                                                          .       .              .
.      .                                     .  .                                .                             .                  .
.      .    .                              .  .            .                                  .                    . .            .
.    .       .  . .                                            .            .                        .            .        .      .
.                                              .     .   .     .         ..           .            .      .                .  . . .
.      .                ..                 .                     .              .           .      .  .          ..               .
.                                                  .   .          .     .        .       .                .               .       .
. .             .     .         .                                                        ..    .                    .       .     .
.         .         .         .       .            ..                         .                                         .         .
..                             .                                 .    .                 .     .      .  .                   .     .
.                           .                                  .                                 .                                .
.        .         .            .                              .          .            .           .           .  .               .
.          .               .                  .                                       . .                   .                     .
.                                               .      .                                     ..                        .        ...
. .                                                     .       .                ..      .                     .                  .
..     .    .             .                     .                                    .               .                .        .  .
.                              .      . .           .                           .          .    .       .           .      ..     .
.     .             .              .     .      .       .    .       .                         .                                  .
.                           . .                                              .                    .         .                   . .
.               .                  .         .                                                                 .            .     .
.           .                    .                                       .         .           .                                  .
...................................................................................................................................
