..................................................................................................................................
.   .   ..       .  ..                 .            ..  .              .  ..      ...   .            .              . .   .      .
..    .                     .      .  .        . ..      ..  .       ...  .   .      . .   .      .    .   .     .            .  .
.                   .    .           ..     ...               .                   .   .          .      .       .                .
.. ..  .       .    ..           .                 . . .      ..      .         .     . .         .                     .   .    .
..       . .   .    .    .            .    ..    . .    .      .                 .   . ..   .                 .  .   .      .    .
.  .      . .     .    .        .                 .  .                 .           .               .   .     .            .    . .
.          ...                   .   .    . ..  ..                      .       .   .    .     .   .         .                   .
..      ..          ..     . .... .    . . .  .  .  .    .       .  .           . ..        ..         .   .      ..  .          .
.       .     ..  .  .        .                            .         .                    .  .      .       .. ..   . ..         .
.   .         . .....     ..  .   .    .     .    .          .     .. .     .  .. .  .                    .       .  .           .
.                 .      .       ..        .    ...   .      .       .   .  .                   .X    .              .  .    ..  .
. ..     .         .         .  .       .  .   . .  .      .   .           .      .            .             . .                ..
.     .          .          . .   .  .              .  .          . .             .         .  . .                .  ..      .  ..
.                   .             ..   .  .            .. .              .. .  .   .               ..                 .  . .     .
.  .      .      .      .  .     .   .    .    . . . . .            .     .   . .   .       ..   . .          .           .  .  ..
.          .     ..            .  . .  . .              .    .    .    .                   .  .       .         .   .    .       .
.       . ..                   .          . . .    .    .      . .    ..    . .   ..       . .     ..        .       .           .
..................................................................................................................................
