...............................................................
.   .       . .  .. .      .     .   ..      .   .      .    ..
.             .  ..    ..  .        . .    .   .    .  .   .  .
... .     .. ...  .   . ...  .     .  .  ..  .  .       .   . .
.   .  .     .    .. . .   . .    .. .       . .   .   . ..   .
. . .         .    .    .     . . .  .. . .    .        . .  ..
..   ..   .     .. .     .  .. .    .     .      .....  .    ..
.    .    ...  .   .   .  .  . ..    .   .                    .
.....   .. .   . .   .   .X ..   ..    .   ....     ...   .   .
. .   ....  . ...  .   ....    . . .  ..      .....    . . .. .
. . .     . ..    ..   .    .      .          . ...        .  .
. . .   ..      . .. ..       .    .     ..    ...   ..       .
. .   ...   .  .   .  .     . ..  ..       ..     ...   . .  ..
.  .  .  ... . .  . . .         ..        .. ...    . ...   ...
..   .  . .   .  .      .  .  . . . .  .. .. .  . .         . .
.    . ..    . .  ...     ..    .   .     ...   .  .  .    .. .
.. .   .       .   .  .    .  . .  ..   .. ..   .  ..     .   .
...............................................................
