.........................................................................................
. . .. . . ..  ..  . . ...  .. ..  ...   .   .    . .  . .     ..   .. . .    ...  .    .
.....       . . .. . .  ..       ...  .. .    . ..   . .. .... .. . . .  .  . . .   . . .
...  .. . ... . . .   . ....      ...   ..... ..  ....  .. ...... . .  .  .. .. .  .. ...
...        ......  .   . . X ...      .. .    .  .. . .    ......      . . . .  .    .. .
. . . .    .   ..   ..      .. . .  .  .  .. . .  .. ...      ..... . . .. . .       .  .
.     ..    . ... .  .     .. .... ..  .   ....... . .   ..   ..  .  .    . .    ...  . .
.. .. ..    . .....  . ...  .. .  .   .   ..     .  .   ...   ..  ..  ..  .. ..  .  .  ..
..    . . ..........   .      .  ..  .....  . ..  ..  .  . .. .  .  .. ....   .    . .  .
.. ..  ..   ......   ..   .   ..   ..      . ... .         ........ ....  .    . .... ...
....      . ......  .   .     . . . ....   .. . .... . ....  .       .   .  .. .. .    ..
. .  . ...             . ....        ..  . .. .. .... ...   .. ..  . .  ....   .     . ..
..  . .   .  . .   .  . .    . ......   .    ....  .   .  . ... .   ...  ..    ... . . ..
..   . .. .  ..  .  .      ... .. ....   ... . ..  .  .. ..       . . . . ...    . . . ..
. . . ... .  . . . ...  ....   .  .  .    ..   .. . .   .   .  . . .    .  ...          .
..   ... ..   ... .  ..... ......    .      . .. ..  .. ...  ..       .... .   . .     ..
..    . .... . ....    ..   ... .  ... ... .. ...   ..   ..    .. .   . ....    . .   . .
.....  .    .   .... . .. ..  . ....     .. ... .    .   ..     ...  . . .... ..    .  ..
... ..  .   .     .. .  . .....  . .. .  . .... .  . ... .. .  .. ..  . . ..   . . .   ..
...   . .     ....      .  .    ...  ..  ... ..   .... .. .    ...... ........  . .  ....
. .. ..  . ..   .  . . ... . ..  .  .     .  .. . .. ...  .   ... ... .. .  . . .  . .  .
.........................................................................................
