.............................................................................................................................................
.     .  ...  ..     .... .  .  .    .  .  .   .    . . .  ..   .. .   .   .  ..         .  .  .       .        . .  . ..      . .. ..  . ...
..    .  . ..    .   ..   .  .     . . ..     .  .  ...        .    .   . . .    .  .. . .  . .. . .   .  .   . .    . ..       .  .   . . ..
.      .   ..  .  . .    .. . .   . .      ..  ...    ... .   . .  .  .  ....             . .         ..   .   ..  . .    ..        . .  .. .
. ..     . .    ..      . .  .  .    .    ...       ..    .  .      .     .. .......    . . .       .  .     ..  .     .    .  . . .   ..   .
.. . ...       ....          . . .       . .  .      .. ...   .  .     ..       . .. ..  ...   . .     ...   .  . .    .  .        .   .. . .
..      ..       ..  . ...   ..  .  .     .    .    . ... .... .  .         . ..    ....     .... .    .  . .      .     .  . . .. .       ..
.. ..  .   .  .     .   . .    . ....    .   .... .    ..   ..   .  .. . . .   .. ..   .     ... .    . .. .. .  ... ..   . . ... ..   .   ..
. .   . .  .. .  . . .        . .     ..     ..   . . .         .  .. .      .....   .    .....  . . .   .  .   ..  .. ..     . .   . .     .
.      .... .   ...          ..      .... ... .     .    .  ..   . ..        . . . .. ...        ..    .. . . . .. .  .  . .      .    ...  .
. .. X  ....  ..  .. . ....    .      . ... . . .  .              . . . .. .     ..   . .  ..      .    .    . .   . ...  . .   .       .  ..
.    . .     . . ..    .   .                     .   ..   ..      .  ....    ..   .  .             .  .  .      . ...           .  .       ..
.............................................................................................................................................
