........................................................................................................
..  .                . ..  . .  ...    .... ..    . . .     .          ..  . .    ..     .  .  .       .
..             ...     ..       .X  ..       .       .       .. .       . . .. .  ..     ..    . .  ....
.        .   .              ..      .  .      .   .     ..    ...    .....        .  .   . ...   .  .. .
..   . .   .. .     .. .   .   ..  .  ..       .  .     .  .  . ..  .    ..   .     .    .        .    .
. ...  ..   .   ..     . .  . .  .   ..  .  .  . .      .           .  ...     ..    . .        . .  ...
.  .        . .   . .. .  .. ...  ..     . ..  . . .  .  ..          ..  .  .      ..  . .     . .     .
.               .       ...    ....    .. .   . .   .  .. .     .    .     . .      .   .    ... ..    .
..    ... .    ....      .....        . .   .  ..    ..  . . .. . .....   ..       . .  .   ... . .  . .
... .  .. ..       ... . .     .    .. ..    .   .. . ...         .  .      ..... . .. .      ..     ...
... .       .  . ..    .       .  .. ...     .  ..   . .  . ...    .     .    . . ..  .      .   .. .  .
.... . .  .       ..          .  .        .  .     .          .  .. ..   .   ..   . .   .. . . . .  .  .
.   .     ......   . .  .  .  . . .  ...  ... . . ...    .   .. ..    .  . . .      .     . ..   ..  . .
.     . . .    .      .. .....    .      . .       .     .     . . .. .   . .   .  ..  .  . .  .      ..
. ...        .    .. .    ...... .    ... .. .. .      .  .  .   . .. ..   .   .    ...  .  .  .   .  ..
..   ...  .     . . .  . .   . . .     .  ...... ..    .       .. .  .  .  .   .. ..      .  .  .  . . .
. . .   .   . .      .      .. .  . . ..    .. .    . ...  ...      . .. . . .      .          .    .  .
. . .  .   . .. .. . .     .. . ..  . .   .     .  . .. .     .  . .  ..  . .  . . ...    ...    ..    .
.   .   .    .      .                 .  ..  . . .   . .   . ...  . ..  .         ...    ..     ..     .
........................................................................................................
