............................................................................................................................................
..  .  ..        .  ...  . . .    ....  .   . . .   .    .   .  .. ..   .. .   .  .. .   .   ..    ...... .   ..      ...  ... .   . . . . .
.    ..  ..  .      ..     ...    . .. ..   . ...       . .     .    .   .. .. .. .  ... .  .  .  ..    ..   . . ..     ..  .     ..   .. ..
..   .. .... .               . . .      . .    ...  .  .  . .. . .....   ... .   ..         . .  ..... ..  ..   ... .  ...   ... .   ..    .
.   . .    ...  . .  . .   . . . .. ... .  ...   .  . ...   ...   . .      ..  .  .  .   . . ..    ... . .      .  .. ... .. .       .... ..
.... ..  . .  ..  .          . ... .  .. .. ...  . ..   . .     . ..  ..   X    .. ..   .. .  . .. .  .... .. .      .      . . ..   ..  . .
... ...  .  ..     .... .  .  ..    .  .   . .   .  ....     ... .  . .   .... ...    .    .   .. .      .  ... ..  ......... .... ...  ....
. . .. .   .... .   ....    . .        .     ..    .  .. . . .. .. . .. ..   .. . ... . ......  ..   . . .  . . .     ..      ...   .    ...
.  . .....    .   . .    ...     ..        . ..     . ..  . .. .  .    ..  ...  .   ....     . .  ..  .... ... . . . .   ...  .   .  . .. ..
. .  ..    .. . . .   .  .   . ... ..   . .   ..  ... . ..  ....    .. ..  ..    ...  ..  ...    . .    ....   . . .   .     .. .    . .   .
. .     .   . .  . . .     . .. .. .  ... ..  . ..    .      .... .     . .   .   ....        . .    ...   ...     ..  .        ....... .. .
.         .. .  ... ..   ... .  .  . .  ..  . .. .   .   . ... ...  ...          . ... ..    ..   ...... . ...  . . .. . .    .   .  .. .  .
...  .   ....   .       ...  ..  . ..    ... .. ... . .........  ..  ..... ...   .. .. .. ....  .       .. . .     ... .    .  ...       . .
..  ..  .. .. .   ..    .     .....  . .  ... .   .. ....   .   .. .  . ..  .  .    ....   ..   .  ..   . . .  . ..   .  .. .     ..    .. .
..  .......   .              .  . ... ..  . ..   ..... . .  .. .        . .  .  ..  . .      ..  ..   .. .  . .... . .. . .. ... .   .  . ..
..      ..     .  . .....         ..          .. .. .  . .   .   ..  ....  .   . . .. ....   .... .. . ..      .. ..  . .. ...  .... .. . ..
.       ..  ..     ... ..  ..    .     ... .   .... .. . ...   . ....   . .   .  ....  ..          .. .   ..   ..  . .       ...  . .  ..  .
.    .       .   ... .. .  . . ...   .... ... . .  . .... .      ..  . ...   ..   .  .    .  .. .......   . .. .  . ..  ...   .   .. ..    .
.  .  ... ......  ...     .. . . .. .. ... .. ....  . . . .   . ..  ...   . . ..   .  ..... . .... .  .       .     .. . . .    .  ... ..  .
. . .  . ..    ....   . .  ...   . ..  .  .. . .       .  ..    .    . .   ....    .  ....   . .       .            .. . . ..    ..    .. ..
.....     . ..  . .   .  . .     .   .   . ...     .      .          .   ..   .. .  ..   .. .   .. . .  .  . .... ....    .... .   .   .  ..
............................................................................................................................................
