...................................................
...  ..  .       .       . ..    .    .    .   .  .
.     ..     .     .. .  .   .      .  .  .       .
. .       .     .       .     .               .   .
.         . .     .  .  ...       ..       .      .
.  .   .   .         .  .  .     ...       .   ....
.      .     X..     ..               ...   . .   .
...................................................
