.............................
.X ..      .    .  .     .. .
..   ..     .     . ...    ..
...  .   .            . ..  .
... .   ..  ......  .  .    .
.       .         . .       .
..     .    ...   .. .. .  ..
.   . ..  .. ... .  . .  .  .
.  . . .   .       ..   .   .
.      . . ... .    .  .    .
.. .. . .   .     . ..  .  ..
. . .  . .    . ..      .  ..
. .      ....   .       . ...
..    . .  . ... .   . ..   .
..  . . .. ....  . ... .    .
. ...        .  .  .. ..    .
. ...  .    ... .       ..  .
.............................
