..............................................................................................................................
. . .    .. . .....   . .. .  ..  ..    . .  .. ..  .....  .....  ... .  .  ...      ...  . .    ....  ... . .    .. .  .. . .
...        .   .    ... .  .  ....  ..   . .   . .... .. . . . . . . .   ..    ..... .  ...  ...... .. ..  .  .......   . .  .
.. .  ..  ...  ...  .  ..  .... .   .     .  ..... .  ..  .  X... ..  ..   .    .....  . .  .  ... ........ ..   .      ... ..
.. .  .   . . ....  .. .......    .  ..    .   . .. .. . .. ...  .... .. .    .....  .  .. ... ....... ...   .        .. .....
. ..... . .  ...    ...    ..   . ..  ..  . . .    ........  .. . ....  .    ... .. . .... .   ...... .           ...   ..  ..
...  .. ......  .    . .. ... . . ... . ...  . . .  ...  . . .  . . ........ ..  .. .      ....... . .   .  ... .     .  ... .
. . . ... . .. ....... . .... . ...    . .   ....  .  ..  .. . ..    .  ...    .    .. .. ... . .  . ..  .   .. ... ... ... ..
. . .    ..   .   ...  ...  .... ...  ...   .. ..  .    .. . .  .........  .. ...    ..     ..  .    ....  .. .. .. .     .. .
..... ... . . ......  .     .  . .   . .. .. .   ...   .  . . .. ...     .       .   .... .   ..  .   . ......  ..   .........
.    ...   . . .. . ..  ..   . . ...   ....  ..  .    ..  .. ..    .  .. ....... ... ......  ..... .....   ..  .   ..   .. ...
.   . . ..   ..  .  . ..  ... ...  . . . . ...   ..  ...     .. .  .  ..  . .   . ........    . . .   ....  .... ....  ..   ..
.. ..  . .... . .  . .. . ..    .......... . ..  ..   .    .. .  ... .. .. .  ....... ...   .    . .  ..     .  ...  ....   ..
....... ..  .  .. ... . . ..  ....  . . .  ..  .. .  .. ...  ...   . ..  . . . .  . . ... .  ..   .  ...  .... .. .  .. . . ..
... ...... ... .... .... ..... ..   ... ..  .. ...... . . . .. .  ... .. . ....   . . . .     ..  ...  .    . ...     . ......
..............................................................................................................................
