...............
..            .
.       .     .
.         .   .
. .  .    .  ..
.   .      .  .
.   . .       .
..   .    .X  .
. . .  .      .
.    .  .     .
.       .     .
. . .       . .
. . ..   . .  .
.        .    .
.   ..        .
.         .   .
. .     . .   .
. .     .     .
.    .        .
...............
