.............................................
. .  .. . ..  ..   ..      . .    ..   ......
...  .. ..... . ..     .... .......   .   ...
. ......   .    .. .      . ... ...  . .  . .
.. ...   .  .. ..    ...   .  .  . .  . .   .
. ..   .   .  .X . .... .  .. .. ...  .  .  .
.  .     ..   ... .  . . .. . ..... . .   ...
... .  . .   .. ...    .   .  .  .  ..   .. .
. . ..   .....  ... . .  ....  ....  .  . ...
. .. ..    ..      . .   . .  . .. . .  .. ..
...  ....   ..     . .. ......   . .  ... . .
.. .   ..   .   .    .......... . . .     ...
.............................................
