.........................
........  . ..... ....  .
.   . . .. . ... .  ..  .
.   .  ... . .. .  .. ...
.....  ... . . ....... ..
.  .  . ..      .... .  .
.........  .   . ....   .
.           ..  .. ......
..  .. ..       ....    .
....   .. ...  X  . .   .
... . ... .   .. .   ....
.. .  . ..   ..... ... ..
.........................
