.............................................................................................................................
.... .. .. .   .   .  .   . .  ..   . . ...  .  ..     .   .  .  .... .    .. ....   .     .   .   .    .. .. . .....   .  ..
.  .       ....        . .   .      .. . .   .    ...  . . .  . . ....    .   .   . ..  . .      .  .    .     . .     . .  .
...         .        .. ..       .  .  .    .. .   . .            .   . .. .  . .     .. ..  .    . . .   . . .. ..    .    .
..  . ..   .    ....  ..  . .  .....   . ...       ... ... .  . . .  ..  .     .       ... ..  .  .    ...  ... .  .    .   .
..     ...  .    .    . ....   .   .  .  . ..... ..       ..       .    .   .. .. .. ... .   . .. .      . .. .. .         ..
.  ..  . .   . ......    .        .. .     . . ..   ...   .......  . . . .  . ...   .   .. ... . .. .    ..  . ..  . .      .
.. . . . . . .     . ... .   .    ..   . .  .. . .. ..     .   ...   . .  .     .      .   ......   ... . ..    . .        ..
.  .  .      . . .......  ....  .  . .  .. . .   . ..   .  .. .. ..    ...   .   . ..  . .     .... .   .      .  . .   ..  .
. . . ..... ...  ..    .  . .  .  ...    ..        ....  . .. ..  .  ...  .  . .      ... . .  ..       . .. .....   . .. . .
. . .       ..   .  ... .       . ..   . ..  .   .. ..    ...   ...  ..    . .. ..  .     . .     .      .... ..  ......  ...
...  . .     . .. .   ...  .    .. ..  ..    .    .. .. .. .  .. ..  . ....    . . . . ..  ... ... ...    ..    .    . .. ...
.. .  . .. .. ... ..... ....  .  .  . ... . .   .     .. .    ..  .. ..  ...  ..       .     .  .     . .....      .     ....
. .. .   ....... . ..     .    ...... .    .. ..      . .. .. . .. .  ..  . . .. .  .   . ....  ..        .  .   ...     .. .
.. . . ..      .  .  . ...   ..  . ...    .  ..       .   ..  .  . . ..  .  .  .  .  ....   .  .. .  ... ...   .  .    .   ..
.. .         .    .... X  . ... .   ..    ..   .  .   .  .   ..  .. .. . . . ..  .  .    ..   .. . ...      .  .. ... .... ..
.............................................................................................................................
