....................................................
.. .  ......... . ... .   . .X..   ..   ....... ....
.. .   .. .. .    .  . . . .. . ...  .     .   .. ..
...   .....   .    ..   ...  .  ...  ..... .  . . ..
.. ....  ....     .   ...  ....  ...... ..   . . ...
. ... .... . . ... .   .. ....  . .  .  . .  . .....
...... .      ... .. .  .   .  . ..   .. .    ... ..
.      ... . . .. .  .. . .. ..  .    . .. . ..  ...
.. . .      . .  ..... .   .. .   .  .....   .. . ..
... . . .   ...  ...  .   ....   ... . ..  .. ......
.   ..   .. ..     .. .. ... ........ ..    ...   ..
. ...   .. . . ... .  .   ..  .. .  ... .........  .
.... .. ......   ... .  ...... ...   .. ..  ... .. .
.    .....   .. .  .   ..      . . ..  ..    ... ...
.....  ...   ...... .  .....    ...      . .........
....................................................
