...............................................................................................
.              .   .  .    ..  .      . .     .  . .     .    .     . . .  .      .  .. ..    .
. .      .   . .     .   .   ..  .  .     . ..     .  .. . .   .. .  . ....          ....     .
.  .     .      .       .   .      ....  .        .         .  .... ... ..    ... . .  .      .
.      .  .         . . .. ...    ...   ..    .       .              . .        ..            .
.. .     .          . ...    .   .     .      .    .    . .   .       .   .. .    .   .    ....
. .  ..   ... ....        .     .        . .     .   .          .      .  .. ..   ..    .   . .
.      ..    .         ...  .....       . ..  .               . .    .     .      .   ..     ..
...   ..   ...  .  .    . ..  .   ...   .   ..  .  .          .            . . .   ..  .      .
..     . .   ..        .      ..     ..     ..  .     .   .    .   . . . .   .    .   .   . . .
.     .           . . ..   . .        .    .    .    .    .  .        .        .      .  ..  ..
..      . .  .   .     .           . ...       .    X .     ... ...   .   ..   ..        ... ..
.    . .    ..  ..    .  ..  .      . ..         .     .. .  .      . .       . .   ..  .   . .
..      ..       .       .        .   .    .  ..  . . . .   .      . ..    .   . .        .   .
.  .  . ..   .   .  .   .  .   .    .        .              .     .       . . ..  .   . .... ..
... .       . .       .  .          .        . . .  . .   .        . ...        .  .  . . .   .
..       . . .      .      ..  .        .   ..       .   .   .     .      ..      .   .   ..  .
.     . .   .   .   ..    . .         ..  .  .   . .  ... .   ..  . .. . ... . .         .  ...
.   ..   .          .    .. .    ..   ..      .   ..      . .   .                 .    ..    ..
..   .         .    ..  .    ..       .      .   .  . .  .  .   . ..   ..     . . ..    .    ..
. .   ..   ..     .    .    .  .  . ..  .  .               . .  .  ... ..              ...    .
.       .   .   ..  .    .   . .      . .... .      . .  .. .   ...    .       ..    .  .   . .
...    . ...    .  .. .  .    . . .    .... ..     .      ....     .. ..   .        .. .  ..  .
.  .  .        . ..  .         . ..  .  . .  . .          ..   .    ..  .. .       .     .    .
.   ..          .   .   .      . .. .   .            . .  .      .  .  .. . .  .    . .  ..   .
. .  ...  . .   . .   ..         .       .   .      .    .       . .            .     .    .. .
...............................................................................................
