.................................
.    . .  .    . .  ..   ..  . ..
....   . .   .. ....   .  .   ...
.  .  .   . .    .  .        . ..
.. .    . ...       .  .   . . ..
.  .        ...     .    .   .. .
.        . ....        . .  .   .
.   ..     .  .    .    .   .. ..
.  .. .             ..     .  . .
.   . .. .  .  .. .  ..   .     .
..   ..   .  ..  . .   ...  ... .
.    .  .         .. ..      .. .
. .. ..  . . . .   .        ... .
.     . ... . .. .  ....    . . .
..         . .. .     .     ..  .
..   . .   ... .    . .  .   . ..
.  .  .  .  .  .     .. .   .. ..
... . ..   .     .. .      .  . .
....          X ... ..    .   . .
.       . ..   ...      . .. .  .
.  .  .   ... ..     .    ..  ...
..... . . . . .  .  ....     .  .
. .  . . ....    .    . .   .....
..  .. . .  .   .. .  ..   .  ...
. ..      .    .    ....   ..   .
.................................
