..................................
..  ...  ..  .X ...    . ..    . .
....      .   .   .. . .  .   .. .
.  . .      ..   .  .   ....  .  .
.  .   . . ..  .... .   ... .  . .
.    . ..      .  .  .  .  .  .  .
.  .. .  ..    . .  ....     ... .
. . . .   ..     .  ...  ..  .. ..
. ...   ..  .. .  .. .  .   ..  ..
..  . . ..     . .  .  .  ..  .  .
. .  .   .   .  . .    . .. .  ...
.  . . . ..  . . . . ....  ..    .
.  . . ..   .  .   .  ....      ..
.   .      . ..      .. .  .  .  .
. ..     . ..  .. .          .   .
. .   . .      .... .  ...  ..   .
.    .    ..  ..  ..    . ...    .
..  .   .. .. . .. ..   . . . .. .
.   .. .  ... ..  ...    ...  .  .
.  .    .  . ... .  ....  .  .....
.   .    ....       ....    . . ..
..................................
