...............................................................................................
.    . .   . .  ...  .  . . .  ... .      .....    ... .  ..  .  .   .    ..  .   .   .  ...  .
.      .    . ....   . ..  .   ... .  . .   ..       .    .. .  ..  . . .    ....   . .   ..  .
.  . .....  ..     .. .           . ..   .  .   . ......     . .          ..  .    . .. . ..  .
.    . ... ... .    .. . .  .              ..         . .. . . . ..   ....   ...       .     ..
. .     . .. ...  .    .  . .   ...  ... ... .. .       .  . .  ... .    .     .  ... . ..   ..
. . .        .  ..  .  .  .. ... .  ..... .    .    .        ....  .. .. .     ... .     .   ..
..   .      . .... ..   . .  . .. .. ..... ..   . .   .      .   .  .     .  . . .    .   .  ..
... .  . ..  ...  ... .    . . ....  . . . .  .    ...  . . . .... .   . .. . .. ...   ..    ..
. .  .  .... . ..... .....      .  ... .  .    .     .. .  . .   ...   . ... . ..     .   ..  .
.X    .  .   . .     .  .  . .....  .  . .    .   ..  . .  ..      .. .. . ..    . ..   .. ....
.. .. .  ..   . .   .  . .      ..  .   .    ... ..  ....   .     . ..  .      .    ... .     .
...............................................................................................
