......................................................................
.      ..   .    .        .  .          X     .        . .        .  .
.     .    .     ..          .         .   .          .    . ..      .
. .   .                    .             . .        . .              .
..  .        ..       .     .   ..     .  .   .         .     .      .
.       .  .    .             .                .         .           .
.              .    .    .                .   . .      .          .. .
.            .  .    .     ..        ..       .  .         . .      ..
.      .                   .    .                             . .    .
.   . .       .              .                          .          ...
. .                  .    .  .   . .      .        .    . ...  . . . .
..     .    ..       .  .                  . .    .  .    .     . .  .
..           .  . .  .    .    ..  . ..           . . .         . .  .
.          .               .       .                .      .        ..
. .      .       .        .   .     .    ....             .  .   .   .
......................................................................
