.......................................................................................................................................
.         . ..     .  . . .  .    ..                 .               .   .      . .       . . .  .  .        ..  . .  . .. .       .  .
.   .  . .  .                 .  .                  . .  . ..       .  ..       ..   ..                 . .    . .       .   . . ..   .
. .       ..  .  . .        .   .    .           . ..... .   .     .         ..   .     ..                 ..           .. .      .   .
.           ..      .      .   . ..       .   . .          .     .                 .         .  . .   .  ..       .   .         .  .  .
.   .  ..   ..    .            ..   . ..     .   ...  .     ...           .          . .  .   .        .   .    .       X..  .        .
.    .   .. .  .    .    . .      .                ..    .   .       .   .  .                   .  .  ..   ..                ..       .
.      ..             .    .. .   .   .      .       .  ...  .      .      ..       . . . .. . ..    . .                 .          ...
.. .  ..  .. .. .          .   .     .  ..   ...          .    .        .   .     . .   .. .    .   .    ..       ..  .   ..       . ..
.          . .. .    .     ..  . .              ..   ..           .    ..     .      .   ..      .     .     .        ..        . .  ..
. . .     .     .     .        .   .    .   .     .                .     ... ..      . . .      .... ..  .         ..   . .  ..  .  . .
.   ...    . ..          .         .    .      .  .         .   .   .   . .      .      .          .           . .  ..        .       .
.     .       .       .     .         .   ..      . .         .                      .   .       .    .  ...              .           .
.    .             .   .            .  .   . .    .   .           .     .. .             ..                 .  .     .   .  .         .
.......................................................................................................................................
