...................................................................................................
.   . . .         .         . .  .   ..     . .. . .   .      .         .  . . . ... ...     .   ..
... .         ..  .      . . ....    . ..       . .  .   .          . .            ..  .... .......
.  .    .  .     . .   .    .  .    .    .  .  . . ..  .    ..      .. .    .     .         .   . .
.. .. .  . ...  .   .   ..   ....   .    ..           .    ..   .         ...      .    .  .      .
.  .   .  . .. .. .... .  .....   .. .   . .  ..  . .. ..  .  .     . .. ..   .. ..     .    .. . .
.        .   .. .     .   .        ... .. ...        .  ..     .    ...  .   . .     .         .. .
. .   . . . .    .  .  .  .     ....       . .   . .. .    .  . . .         ..   .  ... .  .      .
.            ... . . .  . ..  .   .  . .   . . .  .    .... .    .             .       ..  ..   . .
. ..    .. .. .   . ..    . .  ..... .       .     .  ... . . ..    ... .  ...     . ..  .    ..  .
.. .  .   . ..  .             ..      .  .    ..  .           ..      .  .    ..... .       ... . .
. ..  .. .  ..  ..     . . .       .  ..      . ..  .   . .    .       ..   ..  ... ..   .  .. .  .
.  . ....   .           .        .   ..    .  ..    .. .  .    .   ..     . . .   .     .   .     .
.  .  .   .   ..   ..     . . .  .   ..  . . .    ...  . .     .  ..      .. .    .  .  .    .    .
. .  . . . ..     .     .         .           .  .  . ... . ..  ..   .  . .   . ...         ..   ..
.                  .  .  .....   .. . . .       . .  ...  .   ...  .   .    . . .     .  .   .... .
.  .  ..  .  .   ..  .    . . .   .   .  ..  .   ...   .. ......   ... .    .  ...    . ....    ...
.   ..   ....    .   .        ..     . .     .    .       . ..  . .  ..   . .  ... .   . . .   .. .
.   .    . .   ..     ...     .    .. .. .   .. . .  .. .   .         .   .  ...    .. . .   .    .
..   .  . .    .     .       . ..       ..  ..     ..  .  .. . ....   .. .    .  .  .     .  . .  .
.. .        . ... ... . .. .  .  .  .    .  .  .    .. . . ... ..   ..  . .  .    .       .  ..   .
. ..  ...   ..  . .....  .  .  .  . . . ... .  .           ..    .....   .  . . ... . ..   .     ..
...    .  .  .  .  . . .. ...      .  . .   .  ..   . .     ..   .. ....    . . . . .   .  ..     .
.      .. . ..  . .  . .   .  . .    ..  ...       .. .  . .  .  ...  .   .. . . . .  . .   .   . .
.   .    .   .. .    X  . .. . .            ...  .   ... .  .  .    .   ...   . .. .   . ..  ...  .
...................................................................................................
