.........
.. ... ..
. . .....
..... . .
.. .  . .
.  . .  .
.   .....
. .  . ..
.   . . .
.  .. ...
..  .....
. ... . .
.    . ..
.   .....
.. ......
. ... .X.
... ..  .
.........
