....................................................................................
.     ..                    .       .        .      .      .    .      ..   . .    .
.  . .  .       .   .     .      .             .  .    .    .      ...   . ..  . . .
..   .              .          ..  .  . .            .   ... ..        ..      .   .
..  .    .    ..   .  .   .    .  .      ... . .  . .   .    ..     .    .   .     .
..          .   .          .      .  .    .   .   ..    .                      .   .
. .    .   ..X   . .  .       .          ...      .         .      .. .  .   .    ..
. .           ..             ..                       .        .    . ..           .
. .      . . . .            .    .         .  . .  .                . .  .     .   .
.        .                      .         .  ..          .           .      . .    .
....................................................................................
