.............................................................
.... .. .....  .. .  .    ...    . ..   .   ..   ... .    ...
...   .   . . ..... .. .  .  . ..  . .   .  .  ..  . .  . ...
... . .     . .  .  . .     ...    . ..  .    .       .   . .
. .    ..   .  .     ....      . .. .     .   .  ... .. ..  .
..   .   . .. .  .   . .      .   ... .  .    . . . .. . .. .
..      ..        .  ..  ...   ...... .. .   .  .      .   ..
. . . . ...   .   ....    .    .    ...  . .. .   . .X . .. .
....... .. .. .. . .. . . .  ..   ..  ..    . .    .  .    ..
.  ..     .  .     ..... ..  .. .....  .  . ..  .....       .
.. ... .   .....  ... . .      .     . ..  ...   .. ..   . ..
..   .    ...     .    . .    .. .      ..   ...  . .. ..   .
. . .   .   ....  . ...  ..  . . .. .. ...   .  .     .. .  .
...      .   .  . . ...    .. ..  .    ......   . ..... ... .
. ....   .    ... .     .  ....  .    ..  ....   .  . .   . .
.  . .....  .   . ..   ... .  ...   .    .   .  .  .    . . .
..      .. . . .  .......    ...   ......    . .  . . .. .  .
.............................................................
