.........................................
.    ...  .   .     .  .. .   .  . .   ..
.    .. .. .   .     . ... ...       . ..
. .    .. ..  .... .. .    . .. .. ... ..
. .   . . .. .           ..   .    . . ..
.. .. . . .   ..  ..  ..   .  .... .  ...
.  . .... .. .. ..      . .   .. .  .. ..
..     . .   X.  .        . . ..   .. . .
. . .   .  .    .  . ..  .  . .  ..   ...
. . . ..     .. .  ..  . . ... .  ...  ..
.........................................
