..................................................................................................................................................
.    . .          ..      ..   ..   .    .          .        . .. . . .     .. .  .   .   .      .    .. .    .     .  .  .           .       . ..
.        .     .  .    .    .   ..   ..  .           .                .     .. ..   . . .         .     ..   . ..              .   ..       .    .
.    .   .   . .    . ...         ..  .     .  .    .      .. .   .              ..  .        .   .  .        .           .          .  .   .    .
...    .     .         ..   .           .      . ..                  .  .  .     . .      .                .  ..     .    .  .     .             .
.  .  . .    .. .               . ..                   .    .      . .             .          . .    .      .  .    .   .   .  .        .. ..  . .
. . .                ..  . . .     .  .  .  ..     .    . . .  .       .  .   .       .. .   .                   .   .   .  .    .       . .     .
.. . .  .                     . ..        ...      .          . . .       ..          ..   .      .     .    ..   .     .   .   .     . .        .
.       .    .  .                   ..                        .        .            ..    .         .  ..  ..             . .             ..    ..
....   .        .   ..             .     ..      .    ..   .    .   .       .      .           . ..      ..      .            .     .       .   ..
.  .             .                            .   . .            .              ..  .    . .. . . ..   .                   .  .      .. .      . .
.  .   . .  .       .  .                   .    .        . .        .       . . .  .       ...  . .  ..     . ..  .   .                ..        .
.    .    . .  ..  .. . .      .     . .  .  .             .        .     . .  .                ...       ..   .     ..     . X.   . .        .. .
.              . .             .      .    ..  .  ..     .     .               .  .      .                 ..      ..      . .         .  .. .   .
.   .           .. ..  .    .    .    .       .           .  .         .. .       .     .. ...        .       . .    .    .      .     .        ..
.      .                   ..                  . . .      ...      .     .  ... . .      .    .   . .. .  .    .        . . .     ....          ..
..................................................................................................................................................
