...................................
.  . ..    .                 ..   .
.   .       .            .        .
.  .  .                      .. . .
.    .       .       ..  .        .
..     . .  .  .           .      .
..              X      ..         .
...................................
