...............................................................................................................................................
.     .     .           .   .        .    . . .   . .        .     .. . .    ..   . .   .  .     .  . ..    .   .     . .. .      . .      .  .
.        ..  .                  ..  .    . ..   ...         .      .  .  .        .    . . .  ..    . .  . ..  . .  ..      .  .  . .   .     .
.   ...          . ...   .        ..           . .   . .  .      .   .     .   .       . . .      . .     .   .          .   .  .      .   .. .
... .      .   X.    ..       .  .  .          .   ..     . . .    . ..      .    . .        .      ..    .  .      ..    .         ....  . . .
...............................................................................................................................................
