...........................................
...     .   . ..      ... .....   ....  . .
. ...      .. ..   .   ... ..  . . .  .. ..
. .. .    .. . ......     . . .  .  . ..  .
.. ..... .  .  .  .. . . ...  ..  ..   ....
..... . . .  ..   .. .  .     .   ... .  ..
... .      ... .  .  ... .  .  .  .. ..   .
..  .   .. . . .. ...  .    . .   . .   ...
...     .  .    X    . ...     ...  ....  .
...........................................
