.......................................................................................................................................
... .  ...     .. .   ... .. . . ..   ... . .   ..  . .   .. .    .    ..   . ....... . .. ..    . . .. .... .... .. .. ... .. ..    ..
....  .  .  ... ...  ..   . .  ...  . . . .... .. .  .  . .   ..   .  ..   ...... .. . .. ... .    ...    .  .....  . ... ...   .... ..
.  .. .... .     .. . .... .    . . .    ..  . . .X   ...  .....     . .    ..   . .... ..  . . .. ..   .. ..... .  .. ..    .. ..... .
. . ...   .....    . ....  ...  .... .. .  ..  . . .  .. ..    .   .    ...  .  .. .. ..    .  .. .  ........ . . ... .... ...... .....
.. ... . .     ....  ..      .  . ....     ... . .... .  . . . .. ..    .   . .....  . .... .  .. .. ... .. ..     ....  ..  .. . . . .
.....   . .    .   .   ..  ....    .  .  . . .   ....  . .  . .. . . ... .  . .... ....  .... .. .. . ..  .....  .    .  .   ..     ...
.......................................................................................................................................
