.........................................................................................................
. .. . .   . .          .. .    . .  ...   . .  . ... .  .   ...  . .   .. . .     ..   .  .     . ..   .
. ..   .    .  .     .  . .. .    .   .   .... . .     . ..   . .      .    .  .. ..   ..... ..  ...   ..
..   .. .       .  ... . ..    ..   . .       ..   .  .         ... .. .   . .   . ..     .     .. . .  .
.   . .  . ..      .  . .   .   .  .   ..   ...        .  .  . .   .....           .     . .  .        ..
..   . . X.. .  .. .     ..        . . .      ...  .        .  ..        . . .   .  .     .    .. .. . ..
.  .  ...        .   .    . . .  .  . .   .    . ..     .     ... .            ..     .  .      .. .. . .
.........................................................................................................
