............................
.     . .         . .      .
..      .   .  ..      .  ..
.   . ..  . .          ..  .
.                  .    .  .
. ...          .    . .    .
. .   . .    ..   .   .   ..
.  .       .        .      .
.    .   . .               .
.  .. ..    .              .
.         .     .    .     .
.  .    . .               ..
... .    .  .     .   ..   .
..        . .        .     .
.      . .   .   ..  . ... .
..    .    .   .     X.. . .
. ..   . . .         ..... .
............................
