.............................................................
.... .       ..     .      ..      ..  ... .      .  . .   ..
...    ..  .. .      .  ....     .      . .  .... ...    . ..
......   .... .  .       ..    .  .      ..    . X   .    . .
.............................................................
