....................................................
.     .  ..  .  .....    . . .     . .   .  .      .
...   . .  .  ...   .. . .. .. .  ..  ....   ..  . .
.. .  .  . ..   X    . .    ..    .            .  ..
. .. . .   . ..      .. ..    ..   .   ...         .
.   .  ....   ..  ..  ..   . ..    ....  ...       .
. ... .       .. ..  .  ...   .   .   .  .  .  .   .
.. .                 . ..          .... .. ...  ....
..  . . . ..     .    .     .   . . .....     . .. .
. .....  ..   .    .     . ..    .   .  ..... ..   .
.   .  .  .  . .             ...      .    . .  .  .
....................................................
