...........................................................................................
.  .. . ...... . .  . ..    . ...  . ..  ... .. ..  .... . ....   ...... .. .   . .........
.   .  . .  . . ... ....  .. .... ...  .. ...  .  ..  ...... ... .... .    .    ..  . .....
. .. . .  . ... . . ....   .. . . .    .. .... ... .... ..    .  . ........... ......  . ..
.  . .   ... . ..   .. ...... .  .  .... ..  ....   ..   ........ .....  .. .  .. . ..  . .
.    .. .. .  .      . .. .. . .... ..  ......   .   .  .   .. ..  .   . .    ..  ..     ..
. .  . .   . ...  . .. ..   . .    . .  ...  ...... . ...   ...  .. ..    .   .    .. . ...
. .  ... .  ... .      .... .. . ....    ..  ..  ...  ..  .          . .. ..  .... X.......
. . .....  . .  .... .  ..... ...  ..    . .. . .  ..    .... ..  .  ...   . ..  ... ...  .
.. .. .  .  .... . .   . ...        .  . ..... .. . .... ... ..      .. .  .. .  ..      ..
..  .   ...   . .   . ...  .   .....    . . .  ... .. . ..   . .  . ..  ... .      ..... ..
.. . . . ..   ..... .   . .  . .    ..  .... . ...  .. .    ..     .     ... . .        ...
.. . ... ....    ... . .   . .. . .. .  ..   ... . . ..  ....  ..   ..  ..  ...   .. ..  ..
...........................................................................................
