.....................................................................
... .  .                .  .           ..    X             .  .   . .
.                     .          .         .        .       .       .
. .     .          . .      .                ..    .      .    .    .
.    .        .      .                .    .            .  .     .  .
.. .        .          . .        .        .   .       . . .  .    ..
. ...  .          .      .       . .                              . .
.   .      ...        .   .  . . .          .   .  .                .
.                        .       ..           .   .   . .  .  .     .
.   .  .   .      . .                      .           .            .
.. .   . .   .                        .           .  . .   ..   .   .
.....................................................................
