.................................................................................................
...    .      ..    . .   .  .. ..    .      .  . .        ...          .     .      . .  ..  ...
.      .   .            .   .   .  .                  . .  .. .      ..   ..    ..        .  . ..
.         . .             .  . .      .    ..            .  .. ..    . .    .   .  . ..   . .   .
.....     .    .      .        .   . .        .    . .    . .         .                      ....
..             .  .  .         .         . . .  .     .  X   .. ..      .  .  .  ..  ..         .
.   . .            . . .       ...  . .              ..    ..   .                   .      ..   .
...         . .             .  .  .    .        . .   ...                                .    . .
.   ...   .    .. .       .  .   .... .   .   .       .  . ...... .  ....       .  .  .. .      .
.    .             . .. . .  .. .      .      .      . .   .              .  .    .. .     . .. .
.                   ... .   ..      .   ...    ... .     .          .           .      .  .  .  .
.   . .  .        .        .. .   ..   .             .  ...  .     ..     .      .  ..          .
.    .  . ..        .  .   .    .      .    .   . .  .      .. . . . .             .  ..  ..    .
...            .   .     . .   . .   . .    .   ..    .    .. .         .. ..   ....   . ...    .
.   .   ..       .         .  .      ..    .        .   .. . . ..               .    . .. . .   .
..     .       .         .      .  ..  .     .   .   . .  .                . .    .      . .. . .
...  ..  . .. . . .         .  .   .                   .  .    .  .     .           .   .. .  ...
.   .          .       ..                        .    . .        ..        .   ...   .     .. . .
... .      .           .    . . . ..     .     .      .   ..     .        . . .  .   .     .   ..
.               .         . .  .             .  .      .   .      .    . .        .     . .     .
.          .       .  ..  .     .   .  ..    .  .            .. .   .   . .  .    .  . .   .  ...
.................................................................................................
