.................................................
.  .                ..    X .    ..  ..    ..  ..
. .....     .... .  .  ...  ..... ..  .      .  .
. .   .      .  ...     .    .... .  . .        .
.................................................
