.......................................................................
. ..       .  .   .  ..   . . . . ...  .   .  .....  .....  . ..   . ..
..    .....    ..   . ... . .... .     ....   .   ...     .     . .   .
..... .. ..    .. .  ..   .  .. . .  .        .  .  .  ..    .. ... . .
. ..  .. .....   .           ..  .. ...  ....  .      .. ..  . .. .. ..
...  . .. .. ...  .. . ..  .   . ... .   . .   . ..  .   .     .. .....
.  .....  . ..... ..   . ... .  .    ..  . .  .  .    .. .  ..    . . .
.... . .  . .. .. . . ..  ... . ... ... . .  .  .. ...         ... ....
.    .  .  .        .. .       . ..  .  ...   . .  ..  .. ..        . .
.. . ..    ... ..     ..    . .    . .  .  ..  ...  .        .  ..  ...
.. ..     .      ..    .. . ..    . .     .... .. .   .. ...       .  .
... .. ... . .   . ..  . ... .  .  .. . . . ...    ..   .. ... .. .  ..
.   .  ..... . .. .. .. ..      . . .  .       . .           .     . ..
.. . .  .    . .  .   . ... .   .. ...    .  .   .  ...  .. ... ..    .
.     . .   .  . ... . .. ..    . . ..    . .........      . ....    ..
.  . .  ..  ......    .   ...   .  .. ....  .  ... .. ... .. ..  .. ...
.. .. ... . ..  .... ..   .  ...  ..... .. .   .   ...   ..   ...   ...
....    .   ...  .  .  . . ..     .. ... .X .. ..   .   .  ...   .... .
. .  ..  .... .. .  . .  .  .. .. .     .. . ... . ... .  .   ..  .   .
.   .  .. ....  . .  . .            .   .  ..      . .. . ..   .   .  .
...  .. . . .. . .   . ..  .  .   ...  .   ...  ...   . .  .  .  .... .
.   .   . . .. ..   .  ...   .     . .. .. ... .. . .  .. .  .  .. .. .
.  . . .  .. ...  . ...    .  . ..               . . .   ........ ..  .
.......................................................................
