............................................................................................................................................
...  ..    .   ..   . .    .  .    ...  .. .. ..    ...      ..  .     . . . ..    . . ...     .           .  ..... . ...    . ...  . .... .
.   ... . .    ..          .. .... .   . . .  .    .      . ..  .    . ... . .    . .  .    . .     ....        ....    .    .. ..    ..  ..
... .    ..  .  .    ..    .      ..  ..   .. .... .  .        .   . .  .  .  . ..    ......  .  .  .. .   .         .  ..   . .   .  . .. .
...  .  . ...  ...     .   .  .  .  .    . ...    ... .   ..      . .   ... . ....  . .   ...  ... .  .  . .  ..     .  . ..         . .  ..
.   .. .. .  .    ..    ..  .  .  . .  ....... .     .     .. .....     . . .  ... . .  .. .      ..    .  .    .......  . ...     . ..    .
... . ..    ..  ...   . .   .  . . .       . .  ...   ..  . . .    ... .   ..   ..  .  ..... ...          ... .. . .   .   ..  . .... .  . .
.  ... . . ..  .  .  .  .    .  ....   .  . . .... .. . . .  .     ...   .. .    .   ..  ..    ... .  .  .  .   .    . .... .  .       . . .
..    .....  ...      ..      .     ...   . ..  .  .  .      .. . ..... . ..    .   .  .      .  . .. .   . ... .   .   ..     .      . ....
.   .     . .   .  .....      .    . ..  . . .      . . .  .     .  . ... ..  ..  . . ..    ... .. . .  .  . . . . .  .  .  ..    . ..   . .
.      .. .. ..... .    .... ...     . .        .    . ..  .    . ...    ......   .. .   . ..   ..  . .   .  ..  .  .  .     . .   .  . .  .
.    . .   .. ..    .  .. ... ...... ..     . .. .  ... .         .    .   . ..   ...   .   .    ..  ..  . . . .  ..  . .... .    ...  .   .
. ...  .  .  .......    ..  ..  .... . . . . .   .  ..   . .. .... .  . ..  ..     .. ....   .. ..     .  .        .   .  . .. .  .. ... ...
. . ... .  ..  . .  . .    . .. . .   ..     ..   .   . .  .   . ....  .. . .. .  .    X.. . .....  .. .   .. ...  ... .. . .  . . .. . .. .
. .. ..  .  .  . . . .         .  .. ....... . . .   . .. .....        .  ...    . .     ... .. ..      .. ..      . . ....  ....  . . ..  .
. .   ....  .    .  ......   ..   .   .. . .  . ..     .. ...      ... ... ....  .    .         ..        ..        .  ..   ..   .    .  . .
.   .  .. .         ...     .  . ...  .    .    .      ..   .. . .  . . .      . .... .. .   ..... ...  . ....  .    .   .     ...   .. . ..
.    ...  . . ..      ..  .. ...      ....  .  .. ..    .     .  .   .  .   ...     . ...  . ...   .   ..    ..  .....     . . .  ..  ..   .
.....  ..   .   . ..  . .  ...  .    . .      ....   ...    . ..     ...  .... ...      .       .    ... .    .    . .  ... . ... .    . ...
.. .  ..      ....   . ..    .      ...    .... .. .   .    . . .  ....  .   . .     ...  .. . .   .. .. ...  ..     . ....    ..    . . . .
............................................................................................................................................
