..................................................
..   .     . . .. . . ... . .  . . . . .    .... .
.      . .......... ...  .   ....  ..  . .... . ..
..  .  .  ..  . ... .. . X.  . .  ..     .   . . .
..  .  . . .....  .   ........ . . . . .  .  .....
. .   ..  ..... ...  . .  . ... .   . .. .   . . .
. .       ..   . .   .. . . .  . ..     . .. . . .
... .   .  . . .   ...... .   . .. .     . ..   ..
.. .....     ..       .  .    ......          .  .
.. .   .. .   . . ...  .   .  .  .   .        . ..
. .  ..   .............  ... . .  .  . .   ....  .
..................................................
