.....................
. . . .   . .    .. .
.. .  .      .    ...
.    X ..   ..      .
..  ..         . .  .
.  .   . .  .   .  ..
. ..     .  .. . . ..
. ..  . .           .
.. .    ...  .  .. ..
.....................
