....................................................
.....   .. .. .....   ... . ...    .. ..   .  . ....
.     ..   .    .. . ..  .   ...... ...  . .. ..   .
.. . .. .. . ..... ... . ..     ..    ....  .. ..  .
... .  .  ..  ..   ..   ...  ..   ... ....... ...  .
.....  . . .......... ..   . . .   . .. . .... .....
.....    ..  .. .. ........ .....  ...  .   . .. . .
.  ....  ....  ...      . .. .. ..   ........ X.....
. .. .. ...... . .    .......  .. . ..  ......    ..
.  . .. .. ..  . .. ..  ... .  ...... ..  .. . .  ..
. .. .           . . .. . . .. ..  .  .    .       .
.    .. ... .   ..   . .  .  .. ..   . ... . ..  ...
.   .  . ..  .    .   ..  ...    ...    . . ...... .
.. . ..  ... .  .  . .  .... . .. ... ....  ...  ...
. .. .  .  .  ... . . ..  .  ..  ...   . ........ ..
.. .  ... .  ..... ... ..... ..... ... ..... . .....
.  .. ....  ... . .  ..... .... .. ..  .... . ... ..
..  .. ...    ... .  .   .. . .... ..     . ..   ...
.. .. . .     . .    .   ...  .    ..  .  ..  .. . .
..   . ..  .  .. ..     ..  ..  .. . ....       . ..
.  .  . ... .. . . .. . ..  .      .  . .. .  .   ..
. . ..  . .    .   .   . ... ..   . .. ..   ..  ....
....................................................
