..........................................
.   ....   .             ...  .  . . .   .
.        .    . ..              .... .   .
... . . . .  ..... .  . ...   .  .  .    .
...     .        . .  .    ..        .   .
. .. ... ...    ..  ..  .      . ...     .
.       ... . . .    .. .. .. .. .      ..
...  ... ...   . .      .    .   .. .   ..
..  . ...  ...  . . . .   ...  . . ... . .
. ..    . .  ..     ..   ..  .  .      . .
.... .   . ... .. ..    . .  .. .....    .
.   .. .. . . ..   .. ...         .      .
.     . .      .  ..    .    ..     ...  .
.      . .. ...   .   .......   . . ......
.....   .  .. .     .  ....... . ..    ...
.          ..  .. ..      .       .   .  .
.  . .  . .. . . .  ......   . ....  .  ..
... ..  ..  . . .     ..  . .. .    . . ..
.    ......    . . .  .      ...   . . ...
. .  . .  . .. ....   . . .       .     ..
.     .     .  .  . . .    X.    . .. ....
. . .  . .   .         ... . .       .   .
..........................................
