.........................
. ... . ..  . .. . .. . .
..... ......  .. .X. ....
... .  ...   ..  .  .  ..
.....    ...   ... . ....
.. .. . ........  .... ..
... ......     .. . .. ..
. ...    . .. ...     . .
.  .  .  .  ...   . .   .
.........................
