................................
.             .                .
.     .     .                  .
.          .    .          .   .
.      .  . .           .      .
.         .    .   .           .
.     .        .       X       .
................................
