.....................
.   .     .     .   .
.   .      .. .     .
. .  .        .     .
. .  ..   .      .  .
.. ..         . .  ..
...             ..  .
. .   .    .      . .
.  .      .       ...
.    .  . .  .   .. .
..    ..  .       ...
.  . ..  .          .
.   .  .     .     ..
.. ...   .  ..   . ..
. .      . ..... X  .
..             .    .
.....................
