..............................................................................................................................................
..  .   .  .   ..     .... ..       ..   .  ... . . .... ..  .  .  .. ..   .    .       . . ..   .  ...... .   ..... .   ..  .. .. .. ..     .
... .      .. ...  . ..    ... ...  .... .  .. ..  .       ..     ... ......       ......  . ...      .. . . ....    ......... .. ..  .  ... .
.   ..  .    . . .  .  .     ...    .     ....  . .    .       .  .   ..   ...   . ..  .. .. .       . . .    .... .   ... .  ...  ..     .. .
... .  . ....        . .    .  .... . .. .. . .   .  . .. .. . ........  . . ........ . . ..    . .    ..   .. .... .. ....   ... . ... ..  ..
.. ...... .   ... ... . .    ... .    . ..  .. ...     . .  ... .     .   ....  .. .  .. .    . . ........  ..   . . ..  . . ..     ....   ...
.  ..     . ..  .  ..  . .. ...  . ..   .  .  . .........   . . . . ..    .. .. ...  . .. .  . ..  ... . ........ ..  .      .  ... .    .....
..    ..    .  ...   .  .. ..  . ...   .       ..     .    .    .  ....   ..  ...  .  .  . ....  .    ...  ... ...... ..    . .. .. . . .. . .
.  . ... ..    . ..  ..     ...  .  . .... ..   . ...    .    ..    ..... . .. .   .  .  ...... .. ....   ... .  .   .  .  .....   .. . . . ..
.. .  . .      ..     .....  X.    ..      .  ..  .. .     . . .   ...  .  .   .. .     ..  .... . ... ...  . . .  ...  . ......  . .   ..   .
..  . .   ..    . . . .    .  ..   ..   .. ..    .... .....           .   .. ....    .  .      ....   .    .    ..   . . ...... .. .. .. .. ..
..............................................................................................................................................
