..................
. . .  ..     ....
. ..  .. .  X    .
... ..... .  . ...
..    .. ...  .. .
.     .      .   .
.   .   . .     ..
.  ....   . .   ..
..................
