.......................................................
.  . .  . .. . .        .  .     . .     .    . .  .  .
...   .         .   .   . .     .   .         .. .  . .
..                         .      .      . .     . .  .
. . .   ... ..  .  .    . ..     . ..  .  .. .        .
. .. .  .   . .   X    .     .   .      . . .. ..   . .
.    .  .   ..    . ..  ..  ..   .    .      .    .. ..
.      .   .   .        .  ..           .       .     .
.     .            .    . .   .            . .  .     .
..  .  .   .             ..  .     ... .     .    .   .
.......................................................
