....................................................................
.   ...  .. .. ..... .  .. .       ...  . .X  ...   . ...    .  ....
.  ..  ...    .    ..   .    .......        . .. ..    .   .       .
...   ..  ..... . . .. .. .. .  ....  .... ..   ..  ... ....   . . .
. . ...        ....   ... .  .    . ..  ..   .  .  ........ .  .   .
...  .. . ...  .  . . . . .... ......    ..    . . ....  .. .  . . .
.   . .... .  .... .. . ........  .. . ... ...  . .. . .   .   . . .
.   ..   .  .   ....  .  . ..... ... . . .      . .. .... ..   ..  .
.. .  .   .   ..  ..  .. ...  . ..   ...  .  ..  .. .. ..  . ..   ..
.  ... .      .  ...    .    . . . ...  ..  .    .    ....... .. . .
.... ....  . ...... ..  ...  ..... .  . .     ..  .  . .    . ..   .
....................................................................
