................................................................................
. . ..        ... .  . .. ..    . . .      .     .      ..  .     . .  .  .    .
. ....    .. ....  . .     .  .    . .  .  .. .   . . .   . .   .... .  .  .   .
. .             .     .  ..  ..            .                  .  . .  .. .......
...  .   .  .  .   .   ..    . .. ..     .  ..   ..     ...        .  .        .
.         .  .. .. .  . .     .     .. .       .  . .... .    . .    .   .   . .
.  . ..     .     .  ..   .  .  ..      .  . ..    .    ..     .. X  .  ...    .
.              .  .  ...  ..          .... . ..   .     . ..  . . .. ...   .. ..
..     .   .   .   ..  . .    ...     .  ..   .          .  ..  . .       .    .
. .  .           .. .    ..  .  .    .    .. .         .  ...    .. .   ..     .
................................................................................
