..........................................................................................................................
..  ...... . ..  . . . .. .. ..  . . .   .   . ..  . .  . ...  . . .  .. ... ..   .   . . ..  . .     . ... .      ..  ...
.....  .  .. .       .. .. . .. .  .. . .... . .... .  .. ..  ..  .. .... .. .. ..  . ... .. ... . . .. .    . .   . . . .
. .  ... ..  . .. . ..  ....  .. .  .....      .   . . ..    .....    . .. .  .  ..      .. . . ... .. . ....  ......... .
. .. ..... ......        . ..  . . .. .. .     ...  . .   .. ... .......         ..   ....  . .. .     .. .   ... .. . ...
.  .. ... .. ..   ....  ..         ....... ... .  .        .  .  .. ..  . .  ...  . . ......  . ..........     .   . ... .
...... ..   .  .. .. .......  .  ..   .  . .  ..  . ...  . ..... ..  .  ..  ...  . ..... . .      .  . .......   ... .   .
..  .. .    ..   . ..  ..      ..    .  .     ...   .. ..  .  .. ..... . .... . .. ..   .   .  . . . .. ........ ..... ...
. ......... .......  .. ... .   ..... .     .  .   .. ..  .. .  ......    ...  . .  .....    . .  .....  .. ...  .. . .  .
.... .. ... .   .  . .  .. .   .... ...  ......... . .. .... . ..... . ... .....  ..   .  . . ..     ....  ..   .... ... .
.  .. .. . .....  .  .. ..... .. . ....  .   .    .   .....   ..  . ... . ..  .....   . ......         ..... .  .. ....  .
. .... ...  . ...  . .  .....      . . .  ...   .     . .     . .  .... ..  .  .       .........    .. ... ..    .. ... ..
..    ... . .  ......     . . ... ..... .... . ..     ...  .... ... .........  . .   .. .  ..  .. ..   . ..... ... . .. ..
...  .... ..   .. ...... ..   ... . ... ... .  ..  . ..   . .. . . .  .. . ..   ... .. . .... ...... .. .   .  .  ...    .
. . ....... ..    .  ...  . .. .. .. .. ...     . .  ... . . .  ..     ...   ........ . . ....    ..  .... ..  ..     .  .
.. ... ..  ...  .  .... ...    . . .   ...    ... .     ....  ... . .   .  .    ... .  .  ....... . .. . .... ...   ...  .
.. . . .... .... .  .   . . .    . ..... ... . ... .  .    ...X...     .....  .  ...   . . ...     . .  .    .......  . ..
. . ... ..  . .. ... ..... . ..         .    ....  .. . .   . .  .... ....  .  ..     ... .. ..  .. ... ... ...     .. . .
..  .  .  . ... .  ... ... . . .   ..     ... .. ....   .. ..  ..     ......  . .  .   ... . ... ..   . .. ....    ..  . .
.. . . .  .. ..   .  . . .... ...   .     .  .   .. ...  .   .   ....  ... ...........    ..... .... . ...... .  .. . . ..
. .  .  ...  .  .. . .  ..  .  ...  . . ...   .  . .   ....... ..       . . .     ...  ... ..  .. . ... .. .     ...  .. .
. . ... .     .   ..   ...  ....... .   . ...      . . . .    . ...     ..  .  ..  .... .... . . .  ...    . .   ..   .  .
. . . ....  ... ... .  . ...     .   . . ..  .. ..... .. .. .......  . ...  .  . . . .   ... .....   .. .  ..   .  . ..  .
......  ....    ... . .. .. .     ... .. .          ... .    ..... .......... . .   ...... .  .. .   .. ... .. . .   .  ..
..........................................................................................................................
