................
.  .  ..   .. ..
.    .         .
. .       ..  ..
.   .   . ...  .
. . .       .  .
. .   . ..  .. .
.   ..  .   .  .
. . .    ...  ..
.   . .      . .
.         .   ..
.  .  ..       .
.   X.       . .
.  .       .   .
...     .   .. .
..   ....      .
..  .  .  . .. .
................
