................................................................................................
.                                                            . .                        .      .
.     ...      .             .                   . .       .                    ..      .      .
.  .                     .                  .                      .                        .  .
. .   .         .      .  ..  .                        .            .   .                      .
. .                    .                                                   .             .    X.
..             .     ..       .                   .       ..     .           .         .      ..
. .      .            .        .                    ..     .    .            .             .   .
.                ..                        .           .        . .                 .          .
.  ..              .  .                 .         .             ..   .   .    .                .
................................................................................................
