............................................................................
.     .   .                                                                .
.         .                          . .  .            .            .      .
.  .                      .          .             ...    .  .        .    .
.           .      .         .     .                         .             .
.       . .    ..     .                  .             .               .   .
.    .           .                                  .     .                .
.                .          .       .      .            .          .      ..
.            .       .                         . X                         .
.    .  .   .    .    .     .                       .                .     .
.                 .                                                     .  .
.            .        .             .  .  .             .                  .
.       .      . .                                 .               ..      .
.              .     .    .         .                                      .
.  .               .   .         .       .   . .          .      ..        .
.            .          ..                .                          .     .
............................................................................
