................................................................................
..   ..   ..                     . .          .   ..                  ...      .
.              .         . .              .   .       ..            . .     .  .
.                   .                       .          .     .           .     .
.    .   .     .   .       .  .   .         .    .       . .           .. .  . .
. .                                           .                 ..        .    .
.      .        .      .            .  .             .                 ..      .
. .. . .                     .    ..  ..   . .  .      .  .   .     ..      .  .
.        ..                   .  .         .                        ... .  .   .
.        . ..  .                     .  ..    .    .   . .          .          .
. .    ..  .         .     .  .               . .                              .
.               .   . .       ..         . .      .                            .
.   .           .   .             ..   . ...                    .              .
.             .     .  .            ..          .         ..            .    . .
.    X                             . .  .                                      .
.  .            .      .               . .      .   .                      .  ..
. .             .    .    .  .      .                   .              .       .
...          .  .           .                    . .                     .  .  .
.          .          .    .                        .     .     .              .
................................................................................
