..............................................................
. ..     . .   . . . ....  ..  .    .. ..  .   . .  ... .. . .
.   . .   ... . . ......  ...   .. .  . .              ... . .
. . ..  .    .    .. .     ....    .   ... .  . .  .. .. .  ..
..        . . . . ... ..... ... .  ...   ..     .. ..  . .  ..
. . .     X .       .. .     . .. . .     . .. ...  ..... .  .
.   ..... .  .  . ..   ... .   . . .    .. .   .....  . ...  .
.          ..     .    .    .  ..      ....  .         ...   .
.. .  . .. . . ..  ..        .  .. . .. .    ..  ..    .  ....
. ...  .. . ..  .  .   . ..... .       ..  ...  . ..   . .....
. ...... . ..  .  .  .. ....    ... ..  . . .    . ..   . . ..
.  . . . .    ... . .  ..   .   . .   .... .   . . ...  .   ..
. .. .  . .... .       . .  .   ..         .. .   .  ....    .
.. ..   ..  .      . .   .   ... ..  . .. .    ..  ...       .
..  ..     ...  ..  .  ..     .     .....  ... . . . .. . . ..
..............................................................
