............................................................
.                      .    ...  .   ..                    .
.   .             .           .                .   X   .   .
.               .             .               .            .
.    .                .               .                    .
.      .                                                   .
.                                    .               ..    .
.   .       .     .         .     .         .              .
.                       .       .                   .      .
.           .  .        .                .                 .
.                    .     .                               .
. . .                     .     .                   .    . .
.   .              ..          ... .              .      . .
.               .  .              . .                      .
.                     .      .  .      .  .  .     .     . .
............................................................
