...............................................................
.         ..  .   .       .      .. .  .         .            .
.  .      .           .    .     . .                         ..
.   ..      .   ..                     .                   .  .
.   .  .      .   .  .      .   . .. .              ..      .X.
.         .               ..                          .  .  . .
.               .                                  .       .. .
.  .         .      .                .       . ..    .  .     .
...............................................................
