..........................................................................................................
.         ..    .. .  ..     ...   .  ... . .... .  ..  . .      .    ..... ..  . . ..  ..... . . ..     .
. .  .  .. . . ...  .. .. .     .. ... .  ....... ..   .. .. .  .  . .. .. . .   .. .  ..... ...  .     ..
.. . . . . ...  ..  .. .. .    ........  .. . . ....  ..  . .  ....   ... .. .   .. ... .    .   . ..   ..
.. .. . ....  .... ....  . .. .    ......   .    .  ...    . . ..  .. .. . .     . ..   .. .      .  ... .
.     . .... .. ...... ....   .. .... .. . ..  .. ....  .     .... . .. ..  .....   .   ..  ...  .   ..  .
.. .   . ...  .   .      .    .. .   . X.. ..     ..      . .  .   . .. .  . ...  .  ...     .. . ... .. .
.  ...  . ..... . ..   ..... .... ... .   ... .    ..... .   .     . .. .    ... .   . .  .  . .   ..... .
..  .   .      .   . .. .   ..... . .   .......  ..  . . . . . .. ..  .    ...   ..   ..    . . . ..    ..
...   . ..  ..  ..    .... .. . ..  .. ....  ... ....     .   ..  ..  . . ....   . . .   .. ..   ..      .
.... . ..    . .     .  . .  .  ..  .......  ...   .. .. .. .. .       .   .  ..   .  .   ..  . ..  .  ...
..........................................................................................................
