..............................................
... .   .  ..        . .  .    .       .     .
. .            . . .    .  .            .    .
.           .  .  ..   .    ..               .
.   .    ..  .      ..              ..  .    .
...         .    .     .    .      ...    ....
. .    .                .. . .    ...  .     .
.. ..  .            .    . .    .  .   .     .
. .  . .    .  .            ...        ..  . .
.  .      .  .  .  .         .   .     .   . .
. .     .         . . ..   ..    .. X .      .
.     .     .           .. . .      ..   .   .
. .                .    .   .  ..   .. ..  . .
.   .  .          ..         .   .       .   .
.             .       .       .       .      .
.      .      .  .   ...    .     .. ....    .
.  ..  .   ..      . .  .. . . .  ..  .. .   .
..      .    .           . .  .. . .   .  .  .
.        .        . .  .   .     . .        ..
..............................................
