.....................................................................................................................
.   ...         .               .        .. .           .    .    ...  .        .            . ..    .  ...         .
.   .   ..         .  .    . .. .        .      .  .    . . .     .   ...     . .  ..   . .    .               .    .
.   .    .           .  . .  .      . .     .  ..    .  .   .  .           . .    .     . .             ..   ..     .
.     .             ..        .                  .   ..              ... .      .          .  .          .          .
.               .   .           . . .    .    .. . .. .    .  .  .  . .  .      ..      .     ..   .   .     .  .   .
.      .   .     . . . .  .         . ...  .     .    .         .       ..  .      .              .  . . .  . .     .
....    . .  .        .      .     . .          .  .        .        . .    . .               . .         . ..    . .
.       .         . ..       .           . .            .      .  .             .    .                 ..       .   .
.  ..    . .            .             . . .      .. .  .   .  . .. .     .       .  .    .    .  .    .  ...     .  .
.          .  .  .     .         .                    .  .  .   . .  .  ..     . ..     .    ...        .  .        .
.    .               . .   .  .    .        .   .   .    .                 .      .      ..  ..    .   .  .      .  .
.  . .     .     .                 X          .    ..    .    . ..    .         .    ..     .            .    ..    .
. .. . .. .      ..            .   .   ..      .                 .               .    .      .. .  .  .      .      .
.....................................................................................................................
