........................................................................................
.  .   .                  .       .                      .   .              .       .  .
. . .   .                         .  .      .    .  .                .  .     ..      ..
..   .           .              .    .  .                    ..      .  .. .   .      ..
.           . .       .  X                      ..   .              .  .    .    .  .  .
.             .  .  ..       .  .     .  ..   .. .                   .               ...
.      .       .    .              .               .    .    .     .         .   ..    .
........................................................................................
