.............................................................................................................................................
.    ..   .  ...   . ..  .     ... .             .  .   ..    ...   . . .. .    .    .  .            .        ...     . ..       .         ..
.     .  .  .   ..  .  ..   .       .  ..    .     ..          .   ..           .       . .  ..        ..  . . ....       .  . ..  .        .
..       .  .      .   .  ..    .. .. .       .  ....           .  .   . .         ....    .. . ..        .    ..   .     . . .        .  ...
.. ..... .. .. . ..      .     ..     .  ... . .   .. .. ..  .  .     ..  . ..    . .   .  ..  ..  .. .          .                .  . .    .
..   .  ..    .   . . . ..      .      .   ..        . .  ......  .     . . .  ..         .   ..   .    .     . .   . .    ..    .... .. ....
. . . .     .     . .   .  ..   .  ..     ....     . .      .. .. .   . ...             ...    . .   . . .       ..   .  .  ...  .  .     . .
. ..  . .....   ..          .    .    ..  .  . .      .    ..     .    .          ..     .  .   . .  .  . .   . .         .. .  ...  ..  .  .
.  ..  ..       ..      .      ..   .  ..  .. . . .        ..   .    .    .       .         .   .         .    ..  . .    .. .   .       .  .
.. .  .         .          .  .   .    .  .    .  .    ..      ...     ...    .  .          ...   ....     .   .   ....  . .. .    ..  . .  .
. .....         .    .. . ..      . ..       .           . .. . ..    .      .  ..    .  .    . .                   . .      ..    .X.     ..
. .     .. .  .   .  .   .  . .     ..    .  ...   . .. .  .. ..  . .   .   . .  .        .  ..  .  .      .  .. .   .  .   .      .. ... ...
.       .    ..  .       .  .    .      .   .. .         ...           .  .. ... .             .  .  . . .    .  ..    .     ..       .. .. .
...  . ..         .   .    .   .   .       ....  ..  ..   .      .     ..         .       .  .  .. .   .          ..        .   .      .  . .
.    ..           ..       . .. .      ...       .      .. ..  .  .  .    .. .. ..  .  . .   .         .  .     .  .   . .  ..   .         ..
.. ...  ..   .  .      . .                 ..          .       .   .     ..     .     . .     .  .  ..  . ...   .  .  . ..     .  . . .  . ..
.    .. . .         .  .  . .     ....  .     .. .   .    ... .     .   .    . ...     .  .    .       .  .   .   .  .   .          .   . . .
...  .  . .  .   . .        .      .. . ..    .  ..     .      .   ..         .. .  ..           .     .  . ...    . .   .   ... ...  .     .
...   . .         ..            .         ..   ... . .     . .  . ....  .       .         ..      ..   .    ... .      .   . ...        .  ..
.     .  .  ... ..                    ..   . ..     . ...   .  .      .  .    .       ..  .   .   . .                  .    .  ..   ... . . .
. . .      . ...    .     .     ...      .   .   ..   ..    . .  .  . .  .....           . .    ...... .  . .   .  .   .  . .      . . .   ..
.    . .       ..      .        . .    . .  .  .  .    ..            .     .        .    .           .. .    . ..  .. .  . .          . . ...
.        ..       .    .   ..  . ..           .   .. . .. .   ..  .    . .   . .      .    ..    ...      .....      .    . .     .   . .   .
... . .        . ...  .  .  .   .  . .  ...  ..   .    ...   .  .  ..       ..  . .. .  . ..  .     . .  ..      .  .            .          .
.............................................................................................................................................
