........................................................................................................
.     . . .    .     ...   . .  .       ..    .        .               .  .        .  .     . . ..     .
.      .       .  ..    .  .        .       . .   .    .    . ..  .   .     .  . .      .   .      .   .
.  .    .     .  .       .         .   ... . . .     .    .  .               . .   .      ... .  .   . .
.    ..  .    .    .            .    .   ..    ....  .     ..                   .     .  .    ..  .   ..
.       ..             .  . .   .     .        .          .   .      . .    .    .  . .       ...    . .
..          . ...     .   .       .  ..     .  .  . .  .    ..   ..  .                .                .
..         .    .  . .... .    . .  ..      .  .    . ..     .               . ..   . . ... ...  .     .
.       .  ..    ..    .   .     .         .  ..         .            .    ..   .    .  . .       .. . .
.    .  .   .  .   .      . .     .  .   .    ..   .  .         .       .     .  . .      .        .   .
. .  .. .     .      .  ..  ..  . . .   .  ..  . .  .   . . .  . .     ...              .       .     ..
.    ..                 .          . .      .  . .              . .              ..              .   . .
. .         .                  .  .  .               .  .. .       .        .      . ..           .  ...
.   .    . .  . ..  . ..  .           ...       .         .         .         .     . .         .  .. ..
.    ..     .                   X .    .    .      .    .                    .. .    ..    .   .  ..   .
.                .             .          .   ..   .  .   .  .    . .   ...  .        ... .    .  .   ..
. . . . .       ..         . .    .    .      .            .  .  .. .     .         .     .   . . . .  .
.  .   .   ..       ..  .             . . .  . . .  .     .  .   .   .         .   .    .       ..     .
. ..  . .           .           .    ..    .   .   .     ... .  .       .          .          .  . .  ..
.     .   .                  ..    .   .     .                         .   .      .      ..    .  .   ..
.    .      . .  .                  . ..  . .         ..    . .    .   .   .     .        .      .     .
........................................................................................................
