....................................................................................................................................
. .           .  .           ..  .    . .     . .     .    .          .        . .  .        .        .             .  .  .        .
.               ..     .. .        .        .                               .    .   .      .     . . .    .         .             .
.   ..    ..            .    .      .   .      .   .  .   .   .    .   .       .   . .  . . . .             .       . .    .    .  .
.   .      .   .                ...   .      .            .   .      .  .      .   .  . .    ..    .            .           .      .
.. .   .     .  .  .       .  .   .  .           .  .            .            .          .  .  .         ..   .  ..  .            ..
. .              .  .        .     ..  .        .     . .       .                        . .  .     .  .  ..         .             .
..             .          .       . .       . ..  .           .   ..   .    .              .     ...     .                   . . . .
.   .           ..  .         . .    .                   .           ..                           . .     .   .     .      ..  ..  .
.      .   .            .  ..    . .  .     ...            .        .     .      .     ..  .       .                        .  .   .
.   .      .    .   ..      .  ..       .        .     .   . .   .     . .  ..  .                    .    . .  ..    .     .       .
.   ..      .          .  ....             . ..  ..     . . .   ..   .   . .                .. .       . .. .    .    .            .
.    .    .  ..  .    .              . . .                 .        ..           .          .              .   .    ..    .        .
.      .   . .      .   .         .   . .     .         .                .    ...  . .    .  .     ...      .            .      ....
.   .         ..   .    ..   .  .    ...                  .      .. .       ..                 . .   .   ..      ..     .          .
.      .   .   .  ... .            .    . .. .           .      .      .       .     .      .   .      . .    .   .                .
. .  ..      ..   .  .     . .         .       .          .    . .  .         .   .    .    .  .  .  .          .   .    .        ..
.           . .    ...     ...  ..       . . .   .  .             .  ......                 ..  . .         .        . .    .    . .
.   .    .    ...   .                              .     .  .  .    .   .   . . .   .  .  .            .             .       .     .
.  . .        .      .    .  .. .. X.   .   ..   .    .     .  ...   . .   .    ..        ..    .   .  .  .  .    .    .   .  . .  .
.     .      .   .  .   .   . .  . .  ..           .             ..        ..   . ..  .    .            .          .    ..    .   ..
. ... .     .  .    .   .   .  ...                     .  .   .    . ..   ..  .  ..             .    .       .        .          . .
.             .                   .           . .     . .        .           .     .            .                           . .  . .
....................................................................................................................................
