......................................................................................
.     . .. . .  ..... ..   . .. . .. .. ... . .. . . .. . ...       ... . .  .   ... .
.. ........ . ... .   .   . .   ..  ...  .    . .  . ... . .   . .... ...   .. . ... .
... . .  . .. ..... .. .  ... .. . .  . . .. .. . .   .   .  ...     ... .  ... ......
..     . .    . .     .  ..  . .. . ..   .     ..   ...  .... ....  .... ... .. .  ...
.. .  .  .....   ..  . ... .  .     . . ...   .....   .  ...   ....   ..   .    ......
.. . ..   . . ...   . . . ..........  .... .  .  ..   ...  ..    . ....   .. . ..   ..
.. ...      ..  .. .  .   .... . .... ..  . ..  . ...  ..   ..... .  .    ......    ..
... ....  ..  ... . .   .     ..........   ... . . ..  ... . . . .......... . X..   ..
.  . ... ..... ..  ... ...  .....   .. ... ..   .   . ....... .  .....    . .. .. . ..
... . . . .  . .  . ...  ..  .    .. . .. .   .   .   . . ..   . ....    . ... ..    .
.. ...... . . . .....  .   . . .  ..  ...  . .  ..  .  . ......  . .  .     .    ..  .
. . .... .... .. . . . .  .    . .  . .....  .   ........... . .. ..... ..   .........
... . .    .   .... ...   . ...  ..... ....   .....   .   ...... . ....  .  ....     .
.  ..  . ...   ...     .. .  ... .  ..   .  . .. . ....  . . ....  ...  . .   . ... ..
.   ...  .. .  .. . ...      ..  .. ..  .  .. .  .... . . .   . . .....  .    .  .. ..
...  .... .....  ..  ... . . .  .      . ......... .. . . ...   .. . . ....     ...  .
......  .. .... .   .  . .... . ...  .   .. ...  ....   .. .  .. . .    .  .. .   . ..
. . .... ..  . ... .   .  . ..  ..    .....    ... ....   ... . . ..   .. . .   .. ...
. .  ... .  . .   . . ...  ..  ..    . ....  .     . . .. .  .. .. .  .. .  ..   .....
.    ...   . . ......   ..  ...   .....     .. . . . ..  ... .........     .. . . . ..
. ...... ... . ...  ....  .....  .....   ....... .  .  . .... ...      ..... . . .. ..
......................................................................................
