..............................................................................................................................................
..          ..    ...      . .   .  . .     .   .  .  ..         ..  .. ... .  ..  . .   .      . . . . ..       . ..      . ..   .  .   .   .
.  .     .    ...     .         .    .   ..  .....   .       ..    ..  .         .  .          .     .     .  .... . .    .    .  . ..     ...
..    . . . ... .   .....   ..   . . ....  .   ... ....   .         .       .    ..   .....    ..        . . .  ..   ..  .. .    .  .     .. .
.  . .       . .  ..      ..    .. .    .  .    .    .  .   ..  ..   ..  ....      . . .       ..  . . . .  . . .. .  . .. ..        .  . .  .
.  .         .  ..  .      .    .     . .    ...  . ..   ..  .  ..    . .     . .  ....      . .  ..   .         ..   .  .. .. .   .  ...    .
..     .  ...       ..   .. . . ..   .  ..  . ..   .   . . .  .   ..  . .. . .     .    . .... ..     .  .  .      .. .. .  .   ... .   .... .
. .  .. . ..    .    .          .   . ..  ..  .   ..   ..    .. ..    .  ..   .. ..   .  .     . . .          .  ...    .  . ....     ..  .. .
.. .   .    .. .  . .. ...   .. ....   . . ..  ..  ..    . .  ..     .          ..  . . .    . .  .        . ..    ..  .   .           .  ....
.     .     .. .  .   . ..  ..     ..   ... . .     ....   .  .    .  .         .....  . . .   .  . .    .... .      .   . .   . ...     ..  .
.  . ..  . . . .  ..  .   ..  .      ... . .     .     ...  .    .   ..         .. ... .      . . .   . . ...      . ..  .     . ...  .     ..
.    . ... .   .    . .  .    .  . . .  .     ..    .  . .. ...  .  . .  .      .  .  .             ..      .     ..     .  .  .  ... .  .  ..
...    ..  .   ...        .  .   .   . . ....   .    .     .    .          .  .. ...           .  . .. .     .  ..         .       .         .
..  .  .         . .          .         .   ...     . ..   .  . .    ...   .. .   .     .     ..          .  .. ...   .  . .  .  .  ... . .  .
.   ..... . . .  .. ..          .  .   .  .   .. ..... ... . .. ..       .. ..    .. .... .  .   .           ..  .  .  .   . .  ....   .    ..
..   .  ..     .. . .. . . .  ... ..     . . .  .  ......       . . . ..    .      .      . . . .   .   .   ..  .. .     . .  .. .   .   . . .
.. .. ..  .    . .. ..      .  . .  .       .   ...   ....  ...    ...   . .   .       ..     ...    ..  .  ..    .. ..    .    .    ... .  ..
.       ..    ..  .  .  ..     .   .  ..     .    .. .   .    ..  .    . . . .. .... .. .    ..  .                .  ...       .   .       . .
.. .        . .     ..  ..    .    ..    .  .  ..    ..  ..        .      ..    . .. . .. ...   .    .  .    .   .        .. ... . .. .    . .
.  . .    .  .  .     . .  ....             .  . . ..            . . . .  . ..           . .       . . . .   ...    ..   . . ..  .  .  ....  .
.   .. . . .      .  ..  .  .   . .     .  .   .. .   ..     ..  .  ..  .    .  .  .    .  . ....   ..              . .     ..       .       .
.      .     . . ... . .  .  . . ..  .   .. .  .  .  . .  ..      ..  .       .   ..    ...  .  .     .      . .     .    .. ...   .... .   ..
..       ..        .. ... .       ..    .      . .   .   .  .    ..       . .  . .. ..  .  . .      ..          .  .       ....  .    .  . . .
.  .      .   . ..  ......  .     . . .     ..  .  .    .  . .. .          ...   .   .  . .    .....     . .    .      ..  .     ..   . .  . .
.. ...   .. .  X. . . . .   .        .      ..   ..     .. ..  .  . .   .      .      ..   . .     .   ...      . ..    . ..  . . ...    .   .
.    . .... .  .. .  .   . .   .   .  .      . . .    . .   .  ....        .  . . .  .         . . .. .  .       ...   . .   .   .     . ... .
..       . .    . . . .   ..   . ..    . ...  .. .  . ... . ..  .  ...        .  .  .  .  .  .. . ...   .. . .   .  .  .  .   . ..  .        .
..............................................................................................................................................
