.........................................................................................................
.       .     .                                     .             .    .                .  .  .   .     .
.  .      .             .  .                  .           .   .      .             ..                  ..
.   .                 .                   .                .             .           ..              .  .
.                              .                 .           .         .          .                    ..
..                 .      .                          .     .   .     .          .          .            .
.           .                                        . ..         .                X.      .            .
.           .  .      .                               .                   .            .                .
..         .        .                          .       .                      .                         .
..                                             .       .       .              .     .             .     .
.  .                                          .                                                         .
.     .   .       .   .                              ..                        .       .            ..  .
.        .               .    .   .    .                                    .   .            .      . . .
.         .  . .    .       .        .   .     .               .                                        .
.                .     .  .       .               .     .                       .                    .  .
.                  .                       . . .            .      .                      .             .
.     .        .        .  .     .                         ..                                    .  .   .
.  .      .             .             . .                                       .            .          .
.             .    .     .                .  .    .. .                         .                .       .
.  .     .    .                                       .                                    .         .. .
.........................................................................................................
