...................................................................................................
..    ...      ..    .  . .. .      ..   .  ....  .. ..... . .       ..  .    ...     .   ..    . .
..     .. .  .  .    . .... .     ..   .. .   . ....  ..   .      .  .        .   ... .   ..    ...
..     .  ..  . .        ..    .  .  ..   ... ..  .  ..  .   .    .       .  .   . .     ..  .    .
... .  .  .   ..    .  ..      ..     . . .   .  .      .. .   .. .. .     ..     . .   .         .
..    ..... .   .  . . .  ..  . . .    .  ..   . .. .  ..    .    .       . . . .X. ..       .    .
..     .... .   .  .    . ..   . .   . . ....     .   . .    .    ..   . ..  ...           ........
.  . .. .    . ...  ..  ...  .  .      ... ..  ..  ...     .     .  .    . .         . . .... .   .
.  ..  .. .. . .. .   . ..   . ...     .         ... ...  .   ..    .....      .   . ..   .  ... ..
.     .       . .  ..  . ... . .  . . .  . . .     .. .             ...     .    .    .  .   ..   .
. .      . . . .. .   .  .  .   . ..   .  .     . .      . .  ... .       .   .. .  . . .       . .
.    .    .  .  .  .  .    .  ..     . ..  .    .   .     .      .     .    ..      .. ..    . .  .
. . .   .. .    . ..      ..  .      .  ..   .      .        . .... ....  ...  . . .     ..   . . .
.....  .  .  .. . .    .    .  .  . ..  .  .    .      .. . .    .  .         ..  . .     .   .   .
.   ..    .       . .        .   ...    . .  .  .           .   .        .           .   .   . .  .
...................................................................................................
