...............................................................................................
. .              . . . .      .   .  ..             .. .          .  .  .              .     ..
.. .. ... ..  .     . .        ..      .    .           .       .   .      .   .. .. .        .
. ..   .      .               . .       ...    . ..     .               .  . .  .   . .   .. ..
.         .          .     .  .      .    .   .                 .         ..  .   ..   .      .
.  .. .           ..   .     .               .   . ...    .X .   .   .   .    .. .    ..   .  .
.    .     ..     .  .     .    . .      . .  . .   . . .   ..    ..  .     . .      ..      ..
.      ..  .         . . .    .  .     . ..  ..   .     .   . .          ....  . .    .       .
.      . . ..  .  .    . ..       .  ..       .    .   .      .. .  ..  .     ..  . . .      ..
...............................................................................................
