...............................
.                .  .  .      .
.  ..    .       ..           .
.           .  .    . .      ..
.    .    .     .  .    . .   .
.       ...  .  . .          ..
.. .   .  ..    .       . .   .
..     .  . .            .    .
. .        .      .   .       .
.     .      ..  .      .     .
.    .   .        ..          .
.     .  ..   . ..  .  .   . ..
. .   .       .        .      .
. .           .  .  .  .  .   .
.       .   . .      .     . ..
.               .  .  ..     ..
.           .                 .
.      .           .        . .
..  .. ..       .   ..        .
.    ..    .    .X . .      . .
.    ...    .      ..  . . .  .
.               .    .     ....
...............................
