....................................................................
.     .     .. .                 .       .        .  . X .         .
.     ...           .             ..    .     .          .        ..
.   . .         .              .                                   .
.     .        .        .     .  . .           .       .     .   . .
. .   ...              .   .    .  .  ..         . .        .      .
..    .  .        ..                  .   .        .               .
.            . . .              .   .        . .  .. .             .
.         .  .    .          ..      .             .   .    .      .
.    .. .        .    .    .                 .     ..  .    .      .
.        ..    .                  .       .     .  .               .
.           .      .     .            .    .             .   .     .
..             .                          ..   .      . .    ..  ...
.                  .     .       .. .                              .
..                 ..    .         .             .        ..       .
.         .                   .                                    .
.     . . .           .         ..         .                      ..
.   . . .            .    .  ..          .         .               .
....................................................................
