...............................................
.     X    .      .    .  . ..  .      .    . .
.  .  .   .   .    .  . .  .         .    .   .
. . .    .   .  .   . .    .           .     ..
.          ..              .    ..      .   . .
.      .        .  .  .          .  ..      . .
.   .  .                   .   .             ..
.               .  . .  .    .           . .  .
. .           .    .       .             .    .
...............................................
