.......................................................................................................................................
. .  . ... . .......... .. ....    ...  .  ...  ....      . .. . . .     . ....    .....   .    . .  ... ..   ...  ...  ..       .. ...
....   ... . .  ..... ..  ....       ..  ..   .... ..     ..  . ..  ... ..... .   .  .. .. .   .. .  ... ..  .    ... .. . .   .. . ...
..  . .. .  ..  . ...  ..  ...    ....   .. .. .. . .........     ... .  . .. ... . .. ..... . ..    .   ..    .  . ...........  . . ..
. . .  ... .  . .... . .  ..  .  .  .   ... . .... .. ..    . ..  . ..  .....  .      .  ...  . . ..  ..   ..  ...    ..  .   .. . ....
.. .. .  .... ..  . . .  ........ .. .. .  .. .. .  .  .  .  ....   .  ....     .        .  . . .   ..  .. ....... ...   ....  . ...  .
.  . .   ...  ..  .   ..  ... . ...   ..... . . .   .. .    . . . .......    .. .  ..  .... . . .  .. . . ...  .  . ... ..  ..  ...   .
.... . .. .  .. .  . . .. .... .   . . .    ...  ...   ...    ... ..  ..  ... . ... ..    ..... ...  .. ... ...  .. . . .... .. ...  ..
.   . .... .  .       ....  ... . ...  .  .  ....   .. .. . .  .....   ...   . .... .  . .     .. ..  ...   .. ... . ...   ..   . .....
.  . ..  ......  .   . ..  .    ...  ... ... ...... ... .      . .   .  . . .  ...  ..  ..   .. .  .  .. ... ....  . .... .  .  ..  ...
.... .  ..  ..   .....   . .     . . .. ....  . .  .     .. .  ..  .. ... .... .... .... . .    ..  . .  . .  .. .. ..... . . .  ... ..
. .    . .. . ....    ........ .... ..  . ... ..... . ...... ...  . .. .. .  ......   .. .....  .  ..     .   ..  .... .. ...   .... ..
.  ...... . .. .... ..     . ... ...  . ..  .... . ..... .   . .... ....... .....   .... .  ..... .    .   .......... ....  .. .... ...
.....    .. . .  ..  . .  .     ...   .... . ..... . ...   .  .. .. .     ..  .. . . .. . ..  .....  .. . ....    .......    .  ...  ..
..  . .. .  . .......... . ...  ...     ..  ..    ... .  ..X... ... ..  .. .  ...... . .... ... ....   .. ...... ....   .....  ........
..     .  .  ..  ...  ..   ....  .. . .....  . .... ....   .......... . .  .. ..   ..  . .. .  .. .   . ... . ...  ... . . . .... .  ..
. .. .    .    . ... .  .   .. . ..  .  . . .. .....  .. . ....  . ....... .      ... ......  . ... .  ..  ... .......    ......   ....
.  ...... .    .   .  ... .. ...  ...   .  ...  .   ........ .  .. .    ....       ...     . . ..... ..  .. .. ...         ...  .  . ..
.......................................................................................................................................
