.................................................
. ..    . .           ...     .        .    ... .
.  .  .. .  . .      .  .....  .   ..   ..      .
.     .  . . . . . .. .     .        .   . ..   .
. .  .   ..  .. . . .     . . .   .   .    ...  .
.     ..    . .    .... .  .    ...             .
.. .    .. ..   . .     .      ..    ..       ...
. X. . .    . .       .     ..    .  .      . ...
..        .  ..  ..     .    ..  .     . ..     .
.    . .  . ..  .  . .    ... . ..      ..   . ..
. . . .       .     .    . .         .        ...
. ... .  .         . . .. ..    ..    .         .
. .   .  .  .     .. . ..   . .    .      . .   .
.      .  ..      .     .  ...       . .... . . .
. .  ..   . .       .  .   .  . .   ..   ..   . .
.    .....    .     ... . ... . .      .      . .
.    .     .  .  .    . ... . . .    ..        ..
...  .        . . .  .   . .        ..      .   .
.   ..  .. .  .  .     . .   ..  . . ..         .
.  ..       .   .  ..  .    . ..   . .. . ..    .
.    .   .   . .   .  .  .   .   . .. .. .     ..
.  .   .   .    .    .   .  .   .  .       .   ..
.     .  .  . .    .   .  ..     . . .          .
..  .   ...       .....    .  .          .  .   .
.. .  . .    .   ..      . .       .   .     . ..
.    .    .    . . .....  . ..   .     ...   . ..
.      .  .     . . .    .  . .    . .      .   .
. ..   . . .   .   .  .      ..   .   ..  ...   .
.................................................
