.......................
..  .       . . ...   .
.X             ...    .
.      .            . .
.......................
