.............................................................................................................................
. .. ..   .  ..  ... .       ...    .     . .      .    ...           ..   .    ..      .       . .  .    .  . .  .  .      .
. .. .    .....  . . ... .    .  ....     .. . .       . .   .     . ..  .  . .  .     .  .     .  .  .... .      . .. . . ..
..    .    . ... . ..      .   .    .   .  ..   . .. . .  .      . ..  .  .       .    .  ...        ..    ..    .     ...  .
. . . .   .  .   .  ..     ..  X.   ..      .. .  ..     .     ...     .   ...  . .   .  .   . .   ..  ..  . .  . .. .  .   .
.    .  . .    .  . ..           .. . . .... .  . .       ..... .   . . .              .              .     .   .  .. . .   .
.         ... . .  . .. .     .   .           .   .  . .. . .    ... . .  . .. . . .                ... .   ..   .    .  ....
.   .     .         . . ... .   .  .         ..   .    .    .. ... ..   . ..   . .  . ..  .  .  .. .           . .. .    ....
.   . .   .    .   ..             ... . ..    ... ..       .  .  ..   .. . . .  .  .  .  ...     .      .  .   . .    .  .  .
...    ...  .              ..   ..    .   .    .   .  . .      .  .      ..   ..     ....  .     .    .  . .   .   .     . ..
.   .  ...   ....       .      . . .  ..       ... ..  .        . .  .     .. .. ...      .. . ..   .  .. . ... .  ...      .
..     ..     .  . ..    .  ..       ... .....   ..  .   .  . .  .  .   ...  .     . .  .  .          .   .  .     ......   .
.. ..       .   .  .. . .      . .   . .. ....  .      ..   . ...  . ..       ..  . .  .   ..  . ..     .  . ..   . . ..   ..
.  .       .  .. ....... .         ..  ..  .. ...... ..     .   . . ..  . .. .  .  . .    .. . .   . . ..  .    .    .   .  .
. .    . .     . .....   ..   . . . ..     .  ... .. ....   ....    ..   .. .  .    .  .    ..  .    . .   . .  .       .   .
... .   ..  ..      ....     .    .      ..   ..   . . .    . ..   .  . ..    ..    .  ..  ..          .  .  . .. ......    .
..   .    ..   ...   .      .        .   .  .     .    .   .           .  .   .  .. . .         .         .         ...     .
.    .       . .  . ....  .. .. .            ...    ...    .     .    ..     .     .            ...  . .  .   .   .         .
. .  .  ..     ..   .  .   .   . .   ..  .  ..  . ..  .. ... ..   .   ..   .  . . . .  . . ...    .    .     . .. .   .   ...
.     .  .    . ..    ..  . .  .. .. ...... .       ...   .  .         .   .....  ..      .   . .   ...  .     . . . . ..   .
.............................................................................................................................
