.........................................
. . .                                   .
.          . .              .           .
.       .   .               .       .  ..
.                    ..   .  .   .      .
.   ..                 .                .
. .         ..  .        .    .      .  .
.     .          .       ..        .  . .
.                 ..             .      .
.        .                              .
.       ..     ..      .  ..  .      .  .
.                  .        . .     .   .
.    .   ..      .        . .           .
.  ..        .                 .    . . .
.. .      . .               .        .. .
.               .         .    .        .
. .           .     .    .             ..
.                .   .         .        .
..  ..    .. . . .    .                ..
...    .          .           .         .
.                .        .   .         .
..                      .           .   .
. .                          .          .
.            ...       .         .      .
.   .    .. .  ..    .      .        .. .
. .   .              . .          .     .
..     . ...       .  .  .  .     .  .  .
.    . ..     .                         .
.  .        . .       .    X            .
.........................................
