...............................................................................................
. .  .. .      ..    .      .   .  .  .  . .       . ..     .              .  .         .     .
.. . .  .            .         .. . . .   .               .        .      .       .           .
.        .       . ..   ..     ..  . ..       ..  . .    .     .             .       . .   .  .
.        ..    . ...                  ..         .       .       .      . .       .  .   ..   .
.      .     .  ..   .   .   ..     . .      .     . .  .   .  .      ....         . .  .  .  .
. ..   .   .           .       ..    . .   ..       . .  ..     .  .        .       .         .
.         .   ... .. ...     ..              .      ...        . .          .   .        .   ..
.      .      .             .   . .           .    . ..     .  ...     .       ..         .   .
.   .   ..   .             .     .   .              . .     . .     .   ..       . .   . ...  .
...  .      .   ...  .   .   ..     . .     .    .            ..    ..  .       .... .        .
. .          .   . .  . . ..    .   .  ..   ..   .            .   .         .  .   ...       ..
.        . .  .    .     . . .                          .  .       ..     .          . . .  . .
.       . .  .  .    ..      .  .  ...           .. . .            .  . .      . .      .   ...
...          ..      . . ...  ... .  . .   .    .   .  .  ..       .                       .. .
. .         .  .      ....  .     .     .    .  .    .   .        .     .        .. .   . .   .
..   . ...     . . .    .   .   .  .. . . .. . .            .     .          .. .           ...
.   .. .       .      . .    ..  .   .  . .      .           ...  .  ...      .   . . ..    . .
.           .         . X.         ..   ..       . .    .           .   .   . .   . .        ..
.     .        .             .   . ..       ..    .   .   .. .        .  .  .   . .   .     ...
...............................................................................................
