...................
.            .    .
.  ..     .       .
. .  .  .   .    ..
.     ....  .. ....
...  .         .  .
.   ..     ...    .
...    . .  .     .
.    .       .  . .
..   . .          .
.     .           .
.     .     . .  ..
.   .    .  ..    .
.  .    .  .. .   .
..  .    .   .  . .
..  .     . .   . .
.   . . .         .
.. .  ..    ..  ...
...     ..        .
.    .        ..  .
.   .         .   .
....  .       .   .
.          . . .. .
..         X.     .
.  . .  .  .    . .
.   .  .      .  ..
.   .  .  .  .   ..
...................
