..................................................................................................................
.. . . .  ....  ..  .    . .. . .    ...    ..      .. .  ..  ... .  .  .   ..       ...     ...    ...   . .   ..
..  .    . . ..... ..  . ... . . . ...... . .  .   . . .   ..... .  . .       ..   .....  . . . ...   ..     .   .
.  . .. .   .    .. ..  .  . .   .. .......   ....  ..... ..  .. . ... . . ..   .. . .... .....    ..  . .........
. ...   ..  . .. .....   ..      ... .. .    . .. .  .. .... ... .   . . .. . ... . . .. .. .   .  .....    .. ...
..     ..   ... ..   .     .  .  .. ...  ..    . .       ...     ...  .   ...  .   .. .      ... ...     . .  .  .
..    ..    .X ....  ..    ..  ....  ... .  . .   .   .. . .  .    ..  ...    .   ..   . .   ... .  . ....    . ..
..  .   .. ....  ...     . .   . .      . .... .. ... .        .     ...  .  . . .  . .. ....  ...  ..   ...  .  .
..................................................................................................................
