.....................................................................
...    .   .. .  .   . .     .. ..   . .  ..       ..     . . .. .. .
....    .  ..          . .   .   .        ...  ..    . . ....   . ...
.  ...  . . . ..  . .   .  .. .   ... .    . .    . .  .     .. . ...
..  .       .   .   .    . .    ..  .  ..        .. .   . .     ..  .
. .. ..  .    ..  .. .     .    . . ...    .          ..     .     ..
. . .     ..  .   .   . .. ...         ...... . .....  . . .     .. .
..  ..  .   ... ..  .  .     .  .   .     .  ..  .  .. . ..   .  .. .
...      .   ..  .. ..  .. ...    . ....  . .   . .....  .      ..  .
.     ..  .   ... ..     .. .    .......    .   . .      .  ... . . .
.  .        . .  .. ..          .  ... ... .   . .... .   ..  ..   ..
..    ......   ... .  .. .      . . .....   .. .  . .   .     .. .. .
..     X   . .  ..   ..   .....    ..  .   .    . . .....  .. . .  ..
.....................................................................
