................................................................................
. .  .  . . ...  ...     . .    .... .   . .. .     .     .   ..  .. .    . ....
.   .    .... .  ..   .   .. ...  .. . .     ..   .  . .  .   ..  .......  ... .
.  ... .....  .. . .  .   .    .. ...    . .. .   . . .   . .  ... . .. ....  ..
.    X.   ..   .       . ... ..   . ......  .. ..  ...   . .  . .... . .  ...  .
. ... .... ...  ..   ... .     ... .  .   .      ...   .  . .  .... .  ..   ....
. .    ..   .. ..   . ... . ... . . ..     ... . .  . .. ...    .  ... ..  .  ..
...   .... .. ... . .  ..   .  ...     .         .   . .....  .....  .. ..  . ..
..   ...  ...    .  . ..  . ... .    ... . ... . . .... . . . .  .... ...  ... .
..   .. .....   ..  . ... ..    .. ....   .  .. . .... .   .......... ... .. . .
. .. .. ..  . .    .. ..... .... .      .  . .. .. .... . ..    ..... . ....  ..
.  ..  . ..... ..  .       .   ...     . ... . .. ...   .. . ..    ..    . ..  .
.....  .. ... .  . .  . ..      ...     .  ...  ..     ...  ... ..  .. .. ... ..
.....  ..  . .   .       . ...  .. ... ...... .   . .. . .  ..   .  ....  ..  ..
.. . ..  ... ..    ... . . ..... ... .. .       .. .    .   ..  ........      ..
...  ..  .. .......   .. ..   ..  .... . .     ...  ..  ..     ....  .   ..... .
.      .. . ...  .  .  ....   .  .. ... .  . .  ..... ..  .   ...    .  . ..   .
.    .. . ..   .  ..... . . ...... ..  ....  ...   .....  . .....  .... .. .   .
.. .  .. . . ..  . .... ...     .   .. .. .  .....     ..   .   ...   . ...  ...
....    .  .. .. . ... . .... ..  .   ... ..  .. . .   .  ... ....  .  .  . .  .
.. .... . ...    ...  .... . .  .  . ....  ....   .  . .  .      ..   . . ...  .
. .  ..  .. ... . ...  .. .......    .  . ..   .    .   . .          .... ..   .
................................................................................
