...................................................................................................................................................
....   ..       .   .          .           .           ..     .    ..   ......   . . ..  .   .....  . . ... ..  .         . . .   ..       . .  ...
. .  ... ..  .      ..    ..  .   .     .  . . .   ..   . .    ..     .   .    .    ..    ...   ..  .     ... . .     . . .      .  ..   .    .....
.    .   ..     . . .     .  . .... .   .  ..    . .  ...   ...               . ..   ...           .. ..   . .   .. ..  .    ..    .... .  .  .. ..
.. .. .   .  .    .          .  .. . . .. .  .    . . .  ... .    .     . . . ..  .. ....  . . ..   . ..     .  .      .   .  .   . .   . .   . . .
. .   ..      .   ......  .. . ... . ..    .   .  .   ..    .   .. ..  . .  . ..  ..    .  .  .      ..  . .   . ...  .    . .     . ...  ..   .. .
.               .     ...  . ..  . . . .   ..    . .       ...    .  ..     ..          .    .   . .. .    .    .. . .  ... . .   ..... .    ..   .
.  .        ..    .     .  . .  ..   .     ...      . .    .. . ... . .   . . ...     ..   . . ..  .       ..  . .   ..  ..  . ..   .. .  .  .... .
.  . ..... . .  .  .. ..  .       .     ..  .   ..      .     .  .    .    . .     ..   .     .         ...   . . .       .. .   ..  . . .   .    .
.....  .        . .. ..   .  .  .  .  . . . . . .  .. . ...  .. ..  ...... .  .   ..  .. ..   .  .   .    .  . ...  .. .             .  .  ....   .
.  . ..  .     . ..  . ...   .   ....  . ... .    .    ..  .  .      . .. . ..  . .   ....  ... ..    . ..  ..         .. .   .  ..   .    .      .
.  ..     .  . .       ..... . . .  . .. ..  .   .    . .. . .. .     .   .    .     .  .    ...  ..  . .  . .       .  .  . .. .     .... . .    .
.    .. ..    .        . .. . . .  .  . ....  .    . . .  ....  .. .   ..    . . ... . . .. . .. .      .   ...    .    . .   .  .     .    ..    .
. . . .. .  .   ..   . ...  .. .      . .   .  .          .    ... . .    ....   . .     .     . .   .    ...  . ...        ...    .  ..         ..
. . .. .  .  . .. ...  .         . .      . ...  . ....        .. .  ..     . .. .  .. . ..    ..     .  .... .  .. ..      .. . .     ..         .
.. ..  . . ..    . . ...      . ...  . .. ... .       .  ..  .  ..  .   ....   . . ..   .  .      . ..   .  . .  .   .   .        .......  ...   ..
.  .       .     .     .   . .   ...  . .   .. ...     ... .. .   .   .    .   ..   .     ...      .   .... . . ..  .     .... . .    ...   .     .
.   .  ..   .. .    .  ..      . . ...  ..  .   .            ..          . ....     . ... ...   ..  ..       ...     ..  . .       .  . .    .   ..
. .    . .      . .   .  . .   .         .. .  .     . . . . .X.   .      .  .  .  ......  . . . ..        ..  .        .   . . ..      .. ..    ..
. .  .. . . .   .   . ..    .   ..  ..         .    . .       .. ..   .    .  .   ...          .... .   .   ..   .. .    .. .   .        . ..     .
. . . .. ... .   ..   .   . .   .  .. .. ...     ..   .. .    .    ..  .      .....   .    . ...  . .        ..    . . .   .  .  .   .  . .  .  ...
...................................................................................................................................................
