...............................................................
... .. ..... .  .      .  . .    ..    .       ..  ..  . . .  .
.   ...    . ..   ...  . .   .  . . ... ..    ..    . . . .  ..
. .    .. ..  ..     ........  .. .  .  ..  .       .  ..    ..
.   .    ..    ..     ..   .. .. .    .  .   ... .  ..    .. X.
.  .  ...   .  . . .  ....  . . ..    ..  .   . . ..   ...... .
. .   . . .. . . . ..   .  .. . ..    ..... .. ..   ..   ..  ..
..   . ...     . .    . .     .        ..   ..  ....  .       .
.. ....     . .    .     .. .  .. .        ..   . . . .   .   .
. .     ... ..  .  .  .  . ..  .  . .   ..  .. ..     ......  .
...............................................................
