..........
.      . .
. . ..  X.
. .  ... .
.    .   .
..  .    .
.      ...
.        .
. . .  . .
.. ..    .
. ...  . .
.  . .   .
.  .     .
..  ..   .
..  ...  .
..       .
.   .. . .
.    .  ..
.. .     .
.        .
.  .   . .
..   .   .
.        .
.       ..
..........
