.........................................................................................
..        ...   ..            .           .        . .  . . .               . .  . . ....
. ... .  .  .          .   .     .. .X..    .  .    .         .   . .. .          .     .
.        .          .      .     .      .. .          .      .    .  .. .  ..     .    ..
.    .     .    .  ..          .   ..  .     .            . . . .     .  .. . . .      ..
.   .  .  .  .  .    .      . .          ..       ...           .. .   .         .  ..  .
.........................................................................................
