................
. ..  ..       .
.   X.       . .
..    .. .     .
.        .   . .
.      .    . ..
................
