........................................................................................................................
...  . . . .. ..   . ... . .    ... .  ..  ..   ....    . .. .      .    ..  ..    .  .    ..    .. .. .      ...  .   .
.   .    . . ......  .  .  .        . . . . ... ... .    .       ..   ..  . ...  .. .. .    ... . . .. ..   .     ......
. .   .     . . .    .  ..   . . ..     . .  ..  ... ....     ......... .. .  .. . . ..  .    ... .  .  ...  ...  . . ..
.   .. .      ......  . .  . .  .. ...  . .     .   . ...  . ...... .     ... .      .     .  . . ..     ...    .      .
. ... .  .  .     .  . .  . . .. .  . .  .   ... . ..  .     ...    . . .. .   . .   .  ... .     .    .  ....... . .. .
. . .    . . .   ..    .   ..  .      ....   .    . . .  ..   .      . . ..  .  ...       .. . . .   .  . ..  .   ......
..        ...   .. .    .  . ... . .   .. .   .  . . .  .. .     .    .   .        . .   .....   ..     . ...  ..   .  .
.   . .  . .   . .       ... ....      .   ...   . .   .. ..    ...     ..    . .      .. ..    ...... . . .  .     .  .
.    .  .     .. ..  ..  ..   .  .      .. ..   ......    .   . .  . .   . .....    . .. .   . ... .  .  . .....  .. . .
..   ..  . .   .....   ...    .         . . . .   ..  ..  .   ... ..    . . . . . ..  . ... ..   . .... .. ..   ....   .
.. .  . ......  .   . ....   . ... ..    ... ..   ..     ...  .     .  .  . .  . . ..  . . .. .     .  ..    .. .. ..  .
. . .  .      . ..  ..  .. .X. ....   ..  .   ..  . .   . . . ..  .  .. .  . . ...  ..    ..  .    .   . .. .  ..  .  ..
.   .    .    ..   . . . .  .  .  . .      ...    .     . .    ... .. .....  .    . ...   ..     .       .     .. . .  .
. ... .... .... ..  ...  ..          .  .  .. .  .  .      ..    . . ....        .  .  .. .  . ...  .  .   ..    . .....
.    ...    . .... ..   . ..      .    ... . .  ...    .   ... .. ..  ...  .  .   ...  .  . . ..         . ... .     . .
. .. . .     .  .        .   . .   ..  . ....  .  .  . ..     . .  .       .  . .. .  .. .   . . ... .  . .   .       ..
..  ....    ..  ... ..   .   . .... .     .      .. .. .. .. ..   ..... .  .  ...  .   . .  ..  .    . .  . .  . ... ...
... ..    .   .... ...   ...  .  .     .. ..     .       .. . . ... .. ... .....    . .  .  .   . . ..  .. .. ..     . .
........................................................................................................................
