...................................
. .      .  .    .    ..         ..
.  .  ..             .   ..       .
.   .  .. .. .. .  .    .  .   .  .
.   .  .       . ..     .  .   .  .
.  ...   . .  .    .  . ..   .    .
...    .  .  .  .  .  ...  . ......
..     X     ..  .   .  .         .
.  .  ...     .    . .            .
.  .   .  .      . .   .      ... .
...................................
