...............
.           . .
..     .      .
.         ..  .
.      .      .
.  ..     X   .
.  .      .   .
.   .  .    ...
.    .      . .
..            .
..         .. .
. .        .  .
.          .  .
.   .. .      .
..       ...  .
...  .        .
...............
