...................................................................................................................................
.   ..         . .   .  .   .      .  . .  .             ..  .     .      ....  .    .    . .     X .    ...  . ..   .      ..   ..
.  ..      .  ..     ..    .   .. .   ..    .     ...          . .    . .   .   . .   .. .    .   .  . .   ..  .       .   .   .  .
...  .     . . . .... .       .     .  ...  .        .    . .   .    ..    .    ..   .        ..  .              .       .. .   ...
.       ..   .        .              .         .    . ..      .  .  ....  .       .. .     ... .    ... ..  ..  .. .  ..  .  ..   .
.   .     . .        . .    .   ...   .        ..  ..... ...  . .. ..  ...  .     .  ....      . . ... .  .. . . ...   .  .  ..   .
. . .     .         .  . .. .  ..   ..    ..       . ..  .     ... . . . ...    . . .   .      . . .   . .  .  .  .   .    .. . . .
.      ..      ..       .  .   .       .        .     .     . ....  .   . ... .     . .      .      . .               .  .  .     .
.    .    ...  .   ..    .    .      ...       . .   ... ..  .   .   .  .   .   ...     .        ..     ..     .       .  ...   . .
....   . .    .   ..  . .   . ..  . .             ..      ..    .. ....       ..        ..   ...  ..        .. .  . ..  ..      . .
...................................................................................................................................
