..........................
.    .     .  .          .
.    .        ..     .   .
. .           . .        .
.                    .   .
.                       ..
.            .     .     .
. .                      .
.  .                   . .
.  .  .        ..  ..  . .
.          .             .
...        .            ..
.           .            .
.                        .
.  .            .  .     .
.                      . .
.                .      ..
.      X            .    .
..   . .                 .
.                  .     .
.          .    .       ..
.            .      .    .
. .            .  .      .
.            .          ..
.                        .
..........................
