............................
..     .  .  .     ...     .
. . .  .   .     .         .
.  .  . .X     .   .   ..  .
............................
