.........................................................................................
.  . . .     . ..    . . . .. . ...    . ..    ... ... .. . ..     .. .....  .   ...   ..
.    ..  .....  .....    .. ...    .       .  . . . ....     ...  .  ....   ..   ....   .
.  . .    .....  .  .  ..  .  .   . .  . .. .  . ..  ..    ............. .... .. ... .  .
.. ...  ...   .        .... .. ....  .....    .  . . .  .. ...  ....    . .. .. .. ......
... .. ..  ..  ..  . . . .....  . ..    ..    . .    ..  . .   . ..... . ...... .. . .. .
.  .  .  ..   . ..... . .. . ..  ... . .  .. .. ... . ..  ...   ...   ...    ....  . ....
.   ..   .    .    .  . .  ..  ..     ......  . . .. ... . .. .... ...   .  .. ..  . .X .
.  .  .   .     . ..........  ..  .... ... .  . ...  ....  ...  .. .  . ... ......    ...
.  . . .  .   ..... . ... ..   .  . .  .  .  .  . .    ... ..   .. ... .. . .. .  .. ....
.    . ..   ..   .. . . .    . .. .. ...  . .  . ..  ... . .  ..   .. ....  .....     . .
. ..   ...  ...  .....    ..     ...  . .   .....  . .. ..        ..   .. .   . .    . ..
.    ...  .  .  ..   .  ..  .   .   ..... .. .     . ........  ..  .. .        ... ... ..
... ..... ... . .. .  .   .  ... ... ...    ... ... ..  .    .   . ..     . . .  .   .. .
.........................................................................................
