.........................................................................................................
. .    ....  . .    . .    ..    .    . ...... . ...   ..  . .     .... ....   .   .....  ....   .    . .
.. .     . .  . .....   .  . . ...    ..  ...  .... .   ...  .. .. . .     ...    .        ..  .    .....
.. .  . . . ... .   ... .. ...... .   .  .  ....... . .  .  .    .    . ....    ...  .   ..... ..     ...
.  .. ..  .. . .    . .. .    ..  .... .. ..  .. . .  .. .... .....   ..  . . .  .. ...  .... . .   .. ..
. ...... . .  ..... .  ...  . . .   ..... .. .    .  .  ...  . .    .. .  .. ... .. .  .. .   . .. .. . .
.    ..  .... . . . .   .. .. ..  ...  . ....   . ..  .. .....  . . ...    .   . ..   . ...   .  . . .  .
.   . ...   .    . . .   .. . . ...  .  ...    ... .     . .. ..   .   ..     .. . .. .  ..  .  .   ..  .
.  ..  . .   .  . ...... ... .  . .    . . . . .  ... . . .  . .      ..  . . ....    ..  .  . ...  .....
..     .. ..  ..  . . ..     ...... . . . . .. . . .  .  .... . . .... . . . .  . ..........  ...  .  . .
...       . .. ... ..  ...   ..  . .    . ... . ....  ....   .... . .. .  . .. . ....  .       .  ..  ...
.. .   . .. . ..   .   .. . .   .    ..   ... .   ..  .......  .  .  ..  .. .  ..  ..     . ..  .    .. .
. ..   ..   . ...  .... ..... . . . .. ....  . . ...   ..    .. . ..... . . ...  .    . .. .....   .  . .
.   . .. .. .. .. ....   . ..   . .. .      . .  .....   .  ..  .. .. .  ... ...    .. . .. . . .. ..  ..
. . .   .   ... .. . .     .. . . .... ..   ....   . .. ..    .   . .....     .....    .  .... ..  . .  .
... ... ..  .. ....      ...   ...  .  .  . . ...  . .   ... ... . . ...  . .. .    .. ... .. .   .  ....
... . .     .   . .  .  . .   ..   ..    . . ...  ..    ...    ....... ..    ....... .  ... .      . .  .
.  . .   . .    . ..  ..   .. .     ... ... ..    .    .. .. ..     . . ... .      . X   .. .. .. .   . .
...... .   ...       .. ..  ...   ..   ... .  .    . .  .  .. .. . ..      ..   .. ..     .. .  ..   ....
.. .  . ..     .  .   . ...   .  . . .. .. .    . . ...  .     ....  ...  . ... . .  . .  .......   .   .
.........................................................................................................
