................................................................................................................................................
.       .     .                               .   . .                        .    .    .    .   .                 .  .    .    . .             .
.                  .      .   ..                                   .              . .  .    .             .  .    .           .       .       ..
. .     .      ..              .                  .     .                                 .           .  .                               .     .
.  .    .                      .          ...                    .             .             .    .           .   ..                .          .
.  .   ...             .                        ..           .     .                .      .  .                 .   .                      .   .
.      ..         .     .        .           .            .          .   .   .       . .                              .     .                  .
.     . ..                   .          . .  .              .   .          .               .  .   . .           .                     .        .
.            .       .          .     .                .                            .  .     .     .   .           .      .. .                 .
.            .           .. .               .     .               .                          .  .       ..     .                 .             .
.                  .     .      .      .                 .  .         .            ..     .   .       .                                      . .
.                .    .                           .                                   .        .    .         .         . .            .    .  .
.                .            .       .   .                   .                         . .   .                 . ..   .   .  .                .
.  .                 .            .   .  .    .  .     .       .  .                 .                      .       .  ..        .       .      .
.            ...  .        .                  ...         .          .             .     .         .          .    . .                         .
.           .                       .. .    .      .                       .             ..                    .   .           .         .  .  .
.          .   .   .         X   .   .     .   .  .           .    .   .          .  .      .                                        ..        .
................................................................................................................................................
