.....................
.           . .   . .
.                   .
.   .. . .          .
.  . .      ..      .
. .               . .
..      . .      .  .
.                .. .
..         .      . .
.  .           .    .
.       . . .       .
..              .   .
.   .   .  .  .     .
.      .      .     .
..  .  .   . .      .
.      .       .    .
.           .       .
.    .              .
.            .      .
. ..       .        .
.        .     .  . .
. X    .   .    .   .
.    . ..    .      .
.     .  .          .
.   .   .     .     .
.    .       .  .   .
. . ..             ..
.      ..           .
.  .     .    .  .  .
.....................
