.........................................................
...    .  .         ....    .   .    ..  .. .   .  ..   .
.  .. .            . . .      .  .     .        .. ..   .
...     . . . . .     ...  . .   .  .    .  . ... .   . .
. ... .  ...   .  ..       .  .  .      .      . X.     .
.    .   ..     .. .  .    .     .      . .   .         .
.    . ...  .  .  .        ..   ....  ..   ..     .     .
. .      . ...    .  . .         .. . .         .      ..
.  ..  .  ..    . .         .   .       .  .  .    . .  .
.   . ..   .  . .  ...    .   .. ...    ... ...   . .   .
.  .. .      ....  . .      .      .  .  .  .  .  ... . .
..  .  .. .       . .    .           .     ..  ..    .  .
. ... .     .         .  . . . .  .    ...  .  .    . . .
..       .    . ..  . ..    .  .. ..     ..    .     . ..
.........................................................
