........
. .... .
.. .....
.  ..  .
.   ..X.
.  .....
........
