..................................................................................................................................
...    . . . . .. . .  .. . .. .  ...   ...  . . .  ..........  .   .   .. .   .  ..  .....   . .. ... ....  . . ....... .  . . ..
.... .. .. . .. .. .   .  .  . .    .  .   . .   .. .... .  .   . ...... . . . .. . .   ...    . .. .. .  . ..   ...  .  .  .  . .
..   ...      .   .....       ... .. .     ..   . .  . .   .   .. ........ ..  . .. . .  .. ........ .  ..  . ..... ... .. . . . .
.... ..  .   . ... . ... . .  . .. ..... ....        .    .  .     . .  . .  ..    ...  .......  ...  .. ... .   ...  . ... .  ...
. ... ... . .....   . . ..  ...   . .   .......  ..  ...  ......  .  .... .      ... .........     . . .  . ... . .   .. .   ... .
.   .......  . ..  . .....   ..  .. .   . ...  .  .  ..  .. .. ..  .........  ..  .  . . . . ...  ... ... .    . . ..  ...  . .. .
..    . . .    . .... .  . ..           .....        .    . .... . ... . . .      . .. ........   ..   .. .     .  .. .. .   .....
. . ....... . .     . .  ..  . . . . ...  .   .  . .    ..  .  . .  ... ..    . ... ..... . .     . ..   .     ..   ..  . ... .. .
....  . . .    . .... .. . .. ...       .  . .. . .. . .      .. .   .... ...    ...  ..   . ...  ..    . ..    . . .... . . ... .
.  ..       .. .  ...  ..... ... ...  ..... .. .  .. ..    . ...... ....  ...  . ..... .  .   .. ..   . ..   ..... .  . .. . .....
.   .. . .. ... ..  . . ....   .... .     .. .   .   . .. .....  .. .  .  .  .   .. . ..  .. . X  ..  ...... .    .   .  . ..... .
... . ....  .   .  .. .  ...  .  .. .. ..... .  . . .  ..   .  .  . .... .   .. . ..   . . .. . .. . .. .       . .  . .  ..  .  .
... . ..  .   . . . . ..... .. ... . . ..      . .. ....... ... ..  . ....  .      . . ....   . .   ..  ..  .       . ..  ... ....
.   .  .       .... .   . .. . .. .... .. ..   ....   .. . . .     ... ... . .   .... .. . ... ....... .  . .  .. ... .. ....... .
. .. ..   .   .   .   .  .  ..  ... . ..  ... . ...    ... .....   .    .      . ...  . .. . ..  .   ..   .     .   .  . ...  ....
.     . .....     . ....    . ..   ... ..    ........   ... .. . ..   . .   .. .. .. .....     .. .. .... ....   .. .    .. .. ...
.. . ...  ..  ..     .. .. . .... . .  .... .... ....   . ... . . .   .. .   ...  . ..... . .   . . ......  .. .  ..  .. .. .   ..
...  .    . . ..  .   . ..    .. .... .  ....... . .. .  .     .  .     .  . . . ... . .. .  .     .         ... . ... . .....  ..
..    ..   . .. . .   .  .  .. ..  .......  .. ...    .  ........ ...... ...    .. ..... .. ...... . ..  . ..  . ..   .  . ..    .
. .   ..... ..  .. .. .. ..  . .. .   . .. .  ..   ...  ... .. ...... . .. ..    ..      ... ...... .  ..   .... ...  .. . . . . .
. .....  .... .  ...     . . .... ... ... ....  .. .    ..  .. . ... . .    . . . ..  .  . ..  . . .  ..  .   . ..   . .   .  .  .
... .. .....    .. .   . .. .. .  ..       . . ..  .  ... .  .....  . ........ ..    . .   .  ..   ...... ... .  .. .  ..     . ..
..................................................................................................................................
