.........................................................................................................
.        .  ...       ..  ..    .  . .  . ..    .  ..     .  .    ...   ... .   . ...    .       .  ..  .
..     .        ...   . . . .        . ...        .      .   . .   .      .  ..  .   ...       .  .. .  .
..          .    .     . . .                 .  .  .  . .  .     . .. .   . . .   .     .    ...  .     .
.    ..    . .                    .  .. .   . . .. . . . .   .  . ..  .    . X   .         ...      ..  .
..  . ..   . .. .        ..    .  ..  .    .     ..      .. .. ..     .      ..         .   . ...   .  ..
..  .        .  . .. .   ..   .. .      .     .        .   .    .      .. . .      .      .    .        .
..       . . .    ...     ..   ....   .        ...   .   .  .     .     .  ..  .     .       .    .  .. .
. ..    . .   .. .  .. .     .  .    .     ...    ....  .         .   .  ..  .   .  .  . .      ..   .  .
...        ..   . .. .      .   . .  .        ..  .  . ..       ..    .   . .       .   . .     ...  .  .
.  .     . .   ..  . . .  .   .      .. . .... ..   .. .    ..  .. .       .   . .....  .   .  .        .
. ..        .    ... . .   .      . .    .    .    .   .  .  .. .  .   . .  .     .   .    .      .   . .
.        .. .     .      .  .  .   .   . ...  ..  .   ... ..   .      .  . ...   .     ..   .. .   . .  .
..   . .   .. .  .  . ... .      .   .  . .   ..  ...     . .    .       ..    ...   .  . .        ... ..
.   ..    .  ....   .   ..   ..     ...      .  .  . .     ...     ..     .  .. . .       .....  ...  . .
.  .   .....  ... ...  .      ...     .. .    .      .   .        .  . .     .   .. ..    .  .    . .  ..
.       .... .    .    .               .. ...      .     ..   ...  .      ....  ..       .    .  . .    .
..     .     .           .   . .. ...  .  .             .   ....   . . . .     .       ..  .  . .   .   .
. .     . .          . .   ..   .  .  ..    .. . .. .  ....  .    ..   ..        ... . .   ..  . .   .  .
. .  .  .....        .    . . .          ..  ...   .       . . .     . .     .                 . .  ..  .
.       .     ..  .        ..... ..    . .... . .  ..      ..     ..  ... .    ..  .    .     .    .    .
.    ..   . .   . ..   .  .     .. . ...              .  .  . . .. .                .      .   ...     ..
.        .    ..   .      ..     ..  .  .....     .    ..      . . .  ...             ....  . ...   ..  .
.       ..   .     .  .  .     .  . ..  .         ..   .. .      ...  .. .    ...   ...      ..      .  .
.   .      .  ...  .  . . .   .. . .  . .  . .  . .. .  ..   .     .    . .  .    ... . .  .      .. ....
..  .. ... . ..    .... . .   .       .  . .    .         .  .  .           . .        .    .. . ..     .
.........................................................................................................
