........................................................................................................
. .. ...  .   . . . ... ...  .      .....  .  . ..     .  . .   .. ... .  . ... . .. ...       . .. .. .
. .  . . .. ... ...  ..  .    . .. . .  ..     . .. ..   .  .  .   ...          ..  .. .. .  .   .  .. .
..   .      ...  .     .     .   . .....  . .  ....  . . . . ..     . .    . .. . . . . .     .   ...  .
.  . . ...   .. .  . .. .... ...  .... ....  .... ....  ...     ..   ..   . .  .... ....... . ..      ..
.  ...  ... . . . .     .     ..   .. . . .... ..  ..   . .. . .. .   . .  ... .. ... .. ...    . .. . .
..  . .   .. . .. . . ...  .. . ....   .   ... .  .   .......       ....  .     .      ... ..   . .   ..
...     . ... . . .. ..  ... . .. .     ..    .  .. .   . .... ... .  ..  ..  . ....   ...  . . . ... ..
......  .. .. .   .   .  ...  . .  . ..  .. . . .   ..      . .  .   .   .  ..  ... .  ...  ....    ....
.  ..   . ............  .     .  . .. . . .... .... .   .  .  .  .  .   ..    ...   .  ..   ..... ..   .
.   .   ...  .   ..  .  ... .    .. ..  .  ... .  .       .  .  . . . .  .. . . . . ... .  ..    . ..  .
.... .  ... .   .... ....  ... ..    . .      ..      .   . . .. ..     . .. .   .           .   .   . .
.  ......  . . ..    . ..   ..........  .    . ..  .     . . .. . .. . ..  ...   .  ... ..    .   ..  ..
.  ... .. . . ..   .. ... ..  . .  . .. .  ... . . .    ..... .. . ... ... ..  ...... . ... .X. .....  .
.   .  .   ...    . .      . ... . . . . ..   ... .. ...   ... . ... ... ..   . ....  .. . .  ...     ..
. .. .. .... ..  ...  .           ......  . ..  .   .     . .        . ..   .. ..       .... ...   . ...
.  .  ..  .      ..   ... ...  .. .. ....   . . .  ....    . .. .   . .  .. .  ...     . .   . ... ..  .
...... .. . .   . . .  .. . .... .    . . ..    . .  .  . . .... . ..    ....... .  ....  ..  ... . . ..
... ... .  .. . ..  ....    ..  .   ..  .  .      . .. . .. ...    . . .  .  .......  ... ..  . .  .  ..
.....  ......  . . .  .   . .   ...   . ... .. . .   ... .  ..    ...    .. ..    .    ... ....   . . ..
..   .     .  .     .  ...   .  . .   .. .. ...   ..   ..     .    ..   .  .   . .   .    ..  ..  . .. .
. ....   .  .  ..  .... .. .  . .. ..     ..   . .     ..   .. ..   . ..   .. ....  .  .... . .     ....
..  ....       ...  .  .. . . ..  . .. .. .     .  .......   .  .......  ...  ..   . . . . . ... . . ...
........................................................................................................
