................................................................................
.                        .      .              .  ..      .             .      .
.       .   .     .. .                         . .           .           .  .  .
.      .           .  .  ...     .                  ..         .           .   .
.            .        .   . .       .           .      ..            .         .
. .         .    ..             . .         .  .    . .                        .
.  . . .                                  . . .            .      . .      .   .
.                . .        ..    .                       ..  .  .             .
.   .                 .   ...      . .     .   .     .       .    .     .      .
.   .   .  . .           .       ..  .             .          . .   .          .
.     . . .. . .                 .  .     .      .       .       .      . .    .
.       .     . .  .            ..    .                     . .          .     .
.  .  .     . . . .  .          .  .     . ..                     . .      . . .
.            ..  .    ...     .    .   .                  .                    .
.    .       .                  .     .           .                            .
.   .       .     .    .      . .     . ..                      .  .  . .      .
.        ..    X                 .         ..           .                      .
.                     .          .       . .          .    .               ..  .
................................................................................
