..................................................................................
.    ...  . . .. ...    ..  . .. .. . .      .. ....   ... .   . . ... ...  .  . .
.  . ..  . ..  .. ..    .  .  .  . . .   . .  .. ... .  ....  . . ... . ...  .....
. ..   ..  . ...  .  .  ...  . ..... .... .......  ... ....  ... .... ..    .  ...
.   .  .. ... .   .   ...  . .   .. ..      ... ..  ..  X.      ..  . .... .  . ..
.   ..... ..  . ..   .   .. .   .  ..    . .  ... .    .   . .  . .. . . ... .. ..
......    .   .. .         ... .  . ..  .. .   .. . . . .. .     . ...... . . .  .
..   ..   . .   .  ... ...  ...   .. .          ...   .   .... ..  ..  ... . . ...
.       . . .  .. .       . . .  ..  . . .  ... .. . . .  ..   .       .  ..    ..
..    .. . ...   ..    . . ...    .   .....   .  ...   ..  ...    ....   . .  ....
..  .  .  . . . .  ..  .......   ...   ......   .. . ..   . ..     ..  .   .  . ..
.    ... . .. . . .   ...    . . .. .  .   .  .  . .. .. . .... .      ..  .  . ..
....  ...  .. .....  .  .     ....   . .  .  . ..   . .   .. ..   ...   ..  .  ...
... . .    .. ... .  . . .  . .  .  ....  ...  .  ...  . .... .. ...... .... . . .
..................................................................................
