............................................................................................................................................
. .  ..      ... ..      ....   ..  .   .    .. .   ..     .  ... .. . . . .  ..  .  . .   .... .. .. ...   . . . .....     .. .  . .  ..  .
..... .. .  .  .. ... . . ..  . . ...  .... ... . . . ........ .. . .  ...  .. ... . .... .. ...  ... .  ..   . .  ..   ..    .   .. ...  ..
.      . .    ....   .. ... .. .....     .. . .   .   .  .  .   .  . . .   .  .  . ...    .   .....      .  . ..   . . .. ... ..  .  . .  ..
. . ...  .. .. .....   .....  . .. .     ... ..  . ... .  . ... .   .   .   .   . .  ..  . ..  .  . .    .  ..      ..  . . . . . . ..... ..
...    .... ..  ..   .    .. .  . ... .  . .....  ... ..   .. ..  .   ..      ..  .     . ...    .. .. .... .   . ...  ... .  .  .  ..... ..
. .. ...   .. .. .    . ..   . .. ... ..   . . .    . .   .  .... . ..   .    . .    .  .    .  . ...  .. ....   . .   ... .   ... ....... .
.. ..  .  ..    ..    ..  . .. ..  ... . .     ..    .. .   .... .  . . ... ... ... .    . .  . ....   ...   ..  ...  .  ..  ...  ..       .
..   ..  .  .. ..  .. .   . . ..  .     . ...  .. .....    ... .  . .   .. .     ..... . .. ...    ..  ..   .  ..   . . .  .         . . . .
... ..    . .     . .. ...... . ...  ... . . .  .    . . . ..  .   .....    .. ...... .. . .   .  . .  .. ... ......... .   .. .  .. ...  ..
.   .    . .. ..  .  ..  .......  ..   .  . .        . ..  .   . .    ...    ..... .    ...    . .. .   .   . .  ........ ......  . ...  . .
.   ...  ....   . .. ....  .. . .   ....  .    ..  . .   . ..........     ...    .      ....  ..  .. .   ..  .....  ..     ... . . ..  .. ..
..  . ......  .  .  .     .  .   . .  .....  .. . .. ...... .      .....   . . ..      . . .....  . ..  . .. . .       .  ... .    .  .. ...
.. ..   . .  .  .   .  . ..... .       . .. .      . ....  ...  .     .  .... .  .   . .    .  . .. . ..............  . .... ....     .  ...
.... .   .      ..  .  ....  .   .... .   .    ..  ..  . .. .    .. .. .... . .  ..  ..  . ...    ....... . .  .  ...    .    .   . .  ... .
..... ......  ..  ... .  .    .. .  . .. .    . .  ...     . . . .  .  .. .  .   .. ...   ...     .   ...  .  .    ..  .   ..   . .  . .. ..
. ...     ......   ...  .  . .    ... ...    ......     .  .  . .. . .... .      .    .  ... .  ... ....   .......   .   ..    .   . . .....
....  .      ..  . ....       .. ..   . ..    ....  . ...    ..  . . ... ... ..  . ..   .  . ...   . .. ..  .   .  ........ .. .    ... .. .
. .  ....   .  ..  ...  . ....   ... .  ... . ..   . . . ...   .  ...  .   ..  .     . .   ... . ..  ..  .    ..   .   ..  .   . . ..  X . .
.  . . ..... . .... . ... ...  .. . .. . ..  ..   ..   .  ..    . .  . .   ....   .. .. .....  ..   . ..   .  .  .. ...... ..       ....  ..
.  .. ... .. . .  ..     .   ...  . .. .  ..   ...  ...  ..  .. .   ... .  .    .        .   .     .... .  . ........ .    ......  . .    ..
.  ....   .   . ...   .  ..  .  ..  .. .       . ....   . .       . ...    ... . .  ... ..   ..    ... . ...  .........    .   .  .   .  . .
.. . . ... ... ...   ...   .  .  . .     .. . .     .... . ..    .  .. ..... . ..    . . .  .    . ..     . . .. .. .. .. .. .  . . .. .....
............................................................................................................................................
