....................................
.          .                      ..
. .    .  .   .                .   .
. X ..   .  .         .    .  . .  .
..     . .           . .   .     . .
.  .         . ..   .     .   .    .
...                              . .
. .. .                     ...     .
.               .  .  . ..  .      .
.           .           .    .     .
.      ..   .                      .
.      .  .       .        .       .
.         .        .    .  ..     ..
.       .       .     .            .
.           ..    .   . ..         .
.  .              .                .
..          ...     ... .          .
.                 . .              .
....................................
