...........................................................................................................................
. .  .   .  .   .   . .. .     .      .      .       ... .  .   .          .             ..         .  . . .. . .  ...    .
.    .    ..      .       .    .      .    . .      . . .         .        .     ..    .   . .  . .          .    .      X.
.     ...             ..  .         .  ..  .    .      .. ..    . .       ..            .   .  .    .        .  .. . .    .
.       ..  ... .. ...   .    .  .   . . .      .  . .       .         .  . . .  .. .. . ..  ...   .         ..  .    .   .
...    . .   . .  .  . .       . . .   ..     ...            .. ..  .          ...  . .    .      .. .  . .   .    .      .
.   ..    .     ...   ..     .   ...         .  .  .    . . ......               ..                 .   ..   .  .  .  .   .
.. .   .   .  .  .  .... .    .    .   .  . ..          .    ..   .     ....     .      .  .    .         .   ..       .  .
.         .    . .      .   .         .             . .  ..     ..  .  ..   .    .      .   ..  ... ....   .     .      . .
.. .   .       ..  .   ..    ..     .     .  . ....  .   .   .      .  .   . .   .  .  ..   .          .  ..   .   .  .   .
.. .  . .  .     .   ...  .     . . .   . .   .  .  ..  .   . . ..  ..   .                 .       ..           .   . .   .
.   .           .     ..  .  . . .   .  ..        ..  .        .  ..    ..   .  ...  .  ..      .  ..  .           .   .  .
.          .      .        .     .   . . ..   .   .  .. .  .. .     . . . .          .     .          .. .          ..  . .
. .       . ..    . ..   .  . . .      .. ...   .  .. .         .  .        .     .  .     .   .                         ..
.                   .     .  .       ... .   .     ..    . .   .            ..  .        ..  .     .    .          .   .. .
.. . .     .      .    .     . . .     . .   .   . .  ..  ..    . . ..             .         .       .    .. . ..  . .    .
.      .            .  . .     .               .    .   ..  .      ..  .   . .  ..     .                   .   .  .  . .. .
.  . . ...   .               .   .      . .  .  .   .        . .    .       . .   .  .       .    .  .....    .          ..
...........................................................................................................................
