..................................................................................................................................
.     .                             .                 .                         .  .                                             .
.                                                  .                    .                            .   .                .      .
.   .              .X.                            .                                                                              .
.                  .   .                .       .                          .      . .       .                                    .
..................................................................................................................................
