.................
... . .  .  .  ..
.  ...    ...   .
.   .. ...  .  ..
. .  ..  . ......
.  .. .. .. .   .
...     .      ..
.... . .    ... .
.. .. ..... ..  .
.....   .. .... .
. .   .   .  .  .
.. .      . .   .
. .....  . .  . .
..... ... ...  ..
........   ......
......  .. .    .
.. . ...        .
. .. .. .   . ...
....  .... .. ...
.....  .  ....  .
. .....         .
. ...        ....
.   . .... .. ...
. ..  .. ... .  .
..... .X.     ...
.  ..   . ..    .
.................
