.......................................................................................................................................
.                   .                           .                                            ..               .             .         .
.      . .            .                     .                           ..     .    .          .      .                               .
.X                                           .       .                                                    .   .          .        .   .
.              .            .     .           .          .    .              .                 .                                      .
.              .     .    .    .                  .   .          .  .   .                     .                           .           .
.                     .   .                               .        .          ..                     . .             .    .           .
.        .            .            .                          .                                   .                             .     .
.              .  ..                               .                                  .                   .               .           .
.                                                              .       .      .   .            .                        .             .
.            .                                                        .                            .                                  .
.                               .                              .       .                       .      .  ..                       .   .
.             .                           .                              .             . .    .                     .                 .
.......................................................................................................................................
