.................
. .      .     ..
.        .      .
. .           X .
.               .
.   .           .
.................
