.........................................................
..  ..   . .........      . .  . . .  .    . . .  ...  ..
...  ..  .. .  ...    ....  . . ...    . ..    .  . ... .
..  .   .... ....     ... . . .  .  . . . .   .  ...   ..
. .   . . .       . .  ....   . .  .      .   X..  .   ..
. .   .        ...   .       . .     .... . ..  ...... ..
.... . .    . . ...  .  . .     . . ...  . ...... .. ....
.........................................................
