.........................................
..    .   . .        ..    .   .        .
.      .   . .   .   .  .  ..           .
. ...                .   ... ..   X .  ..
. .  .         ...   .  ..   .      .   .
.  .     ..    .   ...  .  .   .   ..  ..
.     .    .      . ..     . .      .  ..
.. .    . ..         ... .  .  . .. .   .
.    .       .   .          .    .  .   .
....    .    .     . ..    .     .   .  .
.  ..      . .   ..   .   . .  ..      ..
.  ... . .      ....  .    ..       . . .
.  .      ..    .         .        .    .
. .      . . .        .          .   .. .
.    . ..  .   .   .   ...    ...       .
.........................................
