.................................................................................................................................
.       . .   . . .      .  . ..     . .   .                 . . ..    .       .  . .   .  .   ....  ..       ..       . .  .  ..
.      .      .            .   .      .     .   .                         .. .  .           .     .         .  ...        .     .
..       ..             .        .     .   .  .  .       .  .      .   ..      ..              .  .  .   .  .  .    ..         ..
. . .  .                .   .    ..  ..   . .         .   ...  .   .   .               ...  ...    .  ..  .  .  .      .    .   .
...   .      .    .    ..   . .. ..   .  .        .       .  . .   .. .      .       .   . . .    ..    ...    ..     . .   .  ..
.       .        .       .   .           . .     ..  .         .         . . .  .    ...          .       ..  ..                .
.   .       .    .    .   .     .     . .        .   ..        . .     ..         . ..        .      ..   .  ..   .             .
.                   .  ..         . ..            .   . . .   . .....     .      .       .   .  ..      .           .         . .
. .      ....       ....      . .. .      .  .  ..   ..  .            . . .           .       .  .   .  .   .         ... .     .
. ..     .     .    .   .   .      .   .   . .  .               . .   .              .        .     .   .    .          .       .
.   .       .    .   .         .   .       . .             .    .        ..   .               .      ..              .       . ..
. . . .   X.               .  .      .             .              . .      .        .           . ..    .  .    .      .        .
.      .   .   ...     . .  .            ..          .  . .     .  .   .. .      . . . .       .  .   .    . .  . ..      .     .
.      . .   . .  . .   .      .                   .    .                         .       .     .     .                        ..
.  .    ..          ..               . .   .            ..     .    .               . .... .     ..   .   . .         .         .
.    .           . .  .        ...      .    .       .       .     .      .  .       ..     . .       .      .      .           .
..   .              . .  .      .   .  ..  .     .    .  . . .  .          .                      . .         .  .  .         . .
..  .  .  .   .  .   . .      ..        . . .  .    . .    .           .  .           .   .    .  .       .   . .    . .    ..  .
.................................................................................................................................
