......................................................................................
.          .. .     ...                          .   .  .         .      .   .       .
.        .    .   .        .  . . .       . ... .    .      .     ..        .    .. ..
.     X ...         ..  .  .     .  .      ..                 .          .         . .
.   .  .   . .            . ..          .   . ...      .        .   ..               .
.    .    .     .                       .       .           .   . .             .    .
.  .     .    .  ..       .   .             .                 .         .            .
.     .         .                                          .     .   . .            ..
. .  .. .. .  .  .    .            .   .      .      .               .          .    .
..          . .   .     .           .  .            . . .    ..     .        .       .
.  .                 .          .    .                 .   .        .      .         .
. ..      . . .   .. ..                    .          .     .     .   ..  .   .  .   .
......................................................................................
