.....................................................................................................................................
... . ...   . .. . .. .. .        ... .. . .  ..    . ..  . .    . . ...        .   .   ..   ..  .   .. .... .    . ..   .  .  .   ..
.    ..... . ..   .    .... ..  . . .... .    .   . ..    .     . .   ... .  . . .. .  . ..  . . .   ....  .   . . . . .... .  .  . .
. .... .. . .        .        .        . .   ..    ..  . .. .   .....  .      .  ..   .. .... ..       ...    .   .       ... .   . .
..   . .  ....  ..   ..   .   .   .. .      . .       ...   .   .... .  . . .    . .   .   .  ..    .  .       ..  ....  . .     .  .
.. . .     . ..  .. .      .. . ..  .     .      .    . ..     .. .     ... .    .  ..   .. .  .  . ... .. .. .    .. .  .    . .....
.  .  .  .   ... .. . .   .   .   ... .. ..  . ..    .    .  ...      .  ..  .     ..       .. . .  . .    .. ... .     ..   .. .   .
...    ..  .      .  .. .... .. .       .            .       . ...       ... .. ..    .     ..  ...     .      .  ..... .. . .    ...
.. ..  .. . .        . .    ...   .   .. ... . ..... .  ..   ..      .  ..    ..  .     ..   .       .     ... .    . ....   .. .   .
.  .. . ..  ....   .  ..   .. .   . .  ..   ..  ..    .... ..  .      ... .    ..  .  .      .    ....     .     .    ..   .  .  .. .
.  .. .   .      . ..    .. .  ..       . . . .. ..   .     ....  .  . ...   .. ..    .  .. . .    . .. .  ....         .... ...... .
.      .  .   . .   . . . .  ...   .   .      .   .  ... .   .   . .     .....  .. ..     . ...  .  . ..  .  ..   .   . ..    ..   ..
.  .  .     . . ..  ..   . .      ..  ..  ..       .   . .     .. ..       ..  .     ....      .  ..... .. ....  .. ..       ...    .
.  ..   ...         . . . ..   . .  .        .    ..   ..  .   . . .... .    .  .     ... . ...  . ..      .  .    ...    ... .......
.         ...  .. .......  . . . .  .  ...        .     .  .     ..    . .    ..      ..... .....        .... .. ...  . .        .. .
.     .. ... .  ....   .   ...    ...    .       ... .   ...   .        ...  ..  .  ..  .   .. .  ...  .   ..    .  . ...  .    .  ..
..  . ..    .... . .  ....  . ..  . . .     ..     ..     .    . . . . ... . X .. .  .         ...  ...  ..  . ...  ..    . ..      .
.. ....... .       ..  . . .     .      . . .....  .   .  .   . .....  .   .  .  .  ..       .. ..     .  . .....  .. ..     .. .. ..
. . ... .. .... ..... ... ..  ... .   . .  .   .      .. . . .  .. . . . .    .  ..   .   . .          . .. .  . . ... ...   .  .. ..
.. .   . ...     .  ... . .. ..       .  .. . .   . . .   . .. ... ..      .. .   .  . .           . ...   ..         .  .  ..    ...
.   .      .   .. .   .  ..  . .  .  ..  ...  .. .     .     ....     .  .  .   ..     ..  . .... .      .. . .   . .       ... . . .
.  .  .. .    . .  . .    .. .   .  .   .   ..  .  .. ..     .    . ...   ..           .... .    . .    .    .    ..   . ....   .. ..
...  . ....  ....   .   ...        .    ....   .   .  ...  .  ..     ...   . .    . .. .  .. . .   .. . .. .        .. .    .. .   ..
. .   . .    .      .. ..    .  ..  ......          . .  .    .....    ..   . .    ..    . ..  ...   . .....   ...    .       . . . .
..   . . . .. ..  . .  .   . .   . .. .  . .. .    .      ..   . .    ..  .    . . ....     ...  ... .  . ... . . .  . .... . ..... .
. . ...  . .   .   ..      ...   . .. ..  .. ..  ..  .. .   .  ....  . .  .  ..  .  .....       .           ....   .   ..    .   .  .
.....................................................................................................................................
