.......................................................................
.     .     ..    ..  . ......       .  .  ..      . . .    .. . ..   .
. ....  ... ..  .     .  .    .     .   ...   .    ..  .  .  .    . . .
. .   ..  . ..  .X. ..  .      ..   .    .     .   ... . ..   .      ..
.         .    ........    .  .     . .  . . . .     .    ..      . . .
.......................................................................
