........
.      .
. .    .
.   .  .
..   . .
.   .  .
.      .
.      .
.      .
. .   ..
.      .
. .    .
.      .
.      .
.      .
..     .
.      .
.    . .
.      .
..     .
.      .
.      .
.      .
.X     .
..     .
.      .
........
