..................................................................................................................................
.   .  ..    .    .    . .    .    . .                   ..  ... ..       .   ..    ..   . .  .        . .       .       .. .    .
. ...    ...   .    ..         X.   . .       ...      .    .      .   .   . .  ..  . . .. .          ..  . . .       .          .
.  .. .      .    . . .  .              .     ..   .         ..    ..     .    .  .      .  .   .. .    .   ... .   .          ...
. .   .     .   . .     .           .   ..   .        .  .     .   ...  .   .  .   .  .         ..   .   .  .   .   ..  . ..   . .
.. ..      .       ..  . .                .    .      .    .       .                 .     .    .  . .  ...       .    .   .     .
.             ..      .           ..   .          . .. ..   .    ....        .  .. . .     .  .   ..  .   .   .  . ..   ..   . . .
...     .   . .   .  .      .  ..   .  .  .  . .    .  .. .      .         ..      .  .    . .         .  .      .   . .        ..
...  .      .    . .  .     .       .          .  . .    .       .. .       .    . ..       .   ... .    .         .       .     .
.        .    .    . ..             .          ... ..  ..      .    .  .  . .       .    .  .  .      .     ...                  .
..       . .   . .    ... .   .          .. . . .    . .     .         . ..    .          .  .       .  .       .   .    .  .   ..
.      .    ..    .      .        . . .  .  .   .    . ..  .            .          .  ..    .             ..   .            .    .
...  .  .   . .            .  .     .     .        .     ..  .      .  . ..   .    . .     .       .   .           .        ......
.  .      .  .      . ..     ..            .. . . ..   .            .    .   .   . .  .  .   .. ... ..  .    .  ...   .          .
. .         .   ..   ..             ..    ..          . .      .   .    .   .     .   .      .          .   . .  .  . . .  ...  ..
..     .       .. ...    ..      . .        .   ..            .     ..     ....                ..  . ...  . . .  .            .. .
. .          .    .  .     ..          ..    . .  ..   .                       ..   ..  .   .... ..  .. .    .  .   .    .       .
.. ..                   .  . . .           . .  ..   ..    .. .   .       .    .. . ..    . . . .   .              .      ..     .
..................................................................................................................................
