.............................
... . .. . .. .      .  .  ..
. .  .  .. . . .           ..
.   .. . ..X .. . . ..    ...
...      ... .    .. .   . ..
......   ..   .....    .    .
...  ...  . . ...   ...   ...
. .   .. . .. . .   .      ..
.............................
