.........................................
.     ..    . . . ......    X ...  .    .
.      .   ..   .    . . .... .. .  .  ..
.  .  .        .   .. .  .  .. . ..     .
...         .   .    .. ....   .  .   . .
.........................................
