............
.  X      ..
.          .
.     .    .
.          .
..      . ..
..    .    .
. . .    . .
..         .
..         .
............
