.....................
.                   .
.       . .         .
.           .    .  .
.      .   . .      .
.       .           .
.     .             .
.       .       .   .
.         .         .
.                   .
.                 . .
.                   .
.       .        .  .
.     .  .          .
.          .     X  .
.          .        .
.                   .
.                  ..
.   .               .
.                 . .
.      .          . .
.   .   . .   . .   .
.     .             .
. .     .           .
.....................
