........................................................................................
...    . . ..   ... ... ..     . ...   .. . ...      ......  ..   ..  ..     .. .. .....
.   .. .    .  .  .... ... .   .  ......    .   . .. .      ..   ..    .. .... .  .  . .
...   . . .........     ... ..     ... ...   .  . ....  . ..       .... . .. . .... ....
.  . ..... ...    .     . ..  ... ...........    . .   .  X.... .   . ....  .  . ..  ...
. ..... . ...    ..   .. . .. . .... . . . .... . ...   . . . . .      .  ..   .  ..  ..
. ... . . ..... . .  . ..   . . . . ......   .  ...  . ....  .....    .  ..   . .     ..
......... .... .. ...  .   .    .. ..  . .. ..  . . ... ...  . .. ... . ..  .  . ...  ..
.. ..  .. .  ..   .. . . . .......  .. ..  .  ...  .  ...   .   .  ......  .   ....  ...
.. ... . ....  ... . .  .. ..  ..    ..  .  .. .   ..  . ..   . ..  . .. ..   .. .    ..
..  .......  ..    . .  ..... ... .  .... . .. . .... ...  ...  . . .   . . .. . ...   .
. . ... .. . ..... . ...   ... . . . . .    ..      .    .. .. ..   .... .  . .   ... ..
.....   .. ...  ..  . .. . ...    . ...  .     ... . .  .. . . ....  ... ..  . .   .   .
.... .. ....    ..  .... ....              ..   ... ..   . ..     ..... .  ....     .  .
.  .. ...   ..    . . . . .   . . ..  ....   ... ...   ... .....    . . .   ..  .. .....
.  ...      .. ..... ... . ..  . . .  ....     ..   .  .   .. ...  . . .  ....   ...   .
.      .. ..     ....... ..  ..    .   .  .     ...   .  ...    ....  .    .  .. .. ....
.   . .     ... .. . ..  .  . . .         .. .     ..  ..   .   .. .... ..  . . .      .
........................................................................................
