............................................................................
.  .        ..      .   . .   .. .       .   .     .    .      .  .        .
.    .  .                .               .  .      .  ..     ..  .   ..    .
.                         .  .            .      .           .       .     .
.             . .      .            .  .              .            . .     .
.            .     ..   .. .        .   .      .     .                     .
.    .        .          .     .   .         .               .   .         .
. .   .        . .    .        .  . . .   .      .  ...       .      ..    .
..                                .          .        . .     .    .       .
.     .   .     .  ..        .         .   X     .                         .
............................................................................
