.................................................................................................
.... ..  . ... ..  ......  .  ..  .  .  .  . . .       ... .  .. .... .. .. ...   .   .. ...  . .
.  .  ....   .  .. ....     .. ..  . X   .    ...  . . .  .......     ...   .. .  .. .... .. .. .
. . ...   .   . . . ..... .. . ....   ...... ... ........  . . .... .. . ... .. . ......  .. .  .
...   ...  ..  .. ..  .  ..  .... . . .... . ...    .. ..   . . . . ..  ...... .  .. ... .... . .
...  ... .. . ... .  . .. . ...  ...   ..  . .... ... .. . ....  . .  ..  ..     . .  ...  .  . .
..  . ..     ..... .  ..  .... ...  .. . . .    .... . .... . .... ... ........ ..  .    . ... ..
.. ... .  . .....  ..  . . .     .... .. ..  ....    ........ ..  .  ..    ... . .  ..  . .  ....
..  .   . .. . ...  . ....   .... ... ..    . .  .... .   . ..  .. .. .. ...... . . . . .. .    .
... ......   .. .... . ......... .    ....      .  .  ..  ..   ..      .    . . ... .  .  .. . ..
... . . .   ...   . ..   . ... . . . .     .. ...  ... .      .  ..   .    . ... . ... . ....  ..
. .    .. .   . .. .. . ..... ..  . .. ..  .  ... . . . .    ...   . ..   ..  .. .  .... .... ...
.   .  . .....    .          . . .. . ......     . .. .  . . ...  ... ..... . ...  .  . .. . .. .
..   .... .    . .... ...  . ... ..... . ..  .....  . .    ... .   .. . .         . . ...... . ..
.. ..   ...  .  ...   .. ........... .   . .. . . ..  ... .. .   .... ....  .  ..  .. .. .. ..  .
.. . . .   .. ..  .. .   ....   ...   .....  ..  . . .  .. ..  .    .  ....     .. .. .... ..   .
..   .... ..      .. ..  .  ..  . . . .. .    .  ..   . .  .   ..  . .. . . . .. .   .. .    .  .
...     .......    ..  ...... .  .. .   .. .... . . . .     .... ..... . ..  .......  .  ....  ..
.. .     ..   ...... . ...  .. . .  .. .....  .  . . ..  .   .  ........ . ...  .  .  .   .  ....
. ...  .  . .    ..       . . .  .   . .  ....  .  .. ....    .  ...   ....   .   .   .....   . .
..  ....    ...   ...  ... . .... .. ...... ... .. ...  ..  .    . .  . ......   ... ..   . . ...
.................................................................................................
