............................................................................................................................................
.   .     . ..   ..  .. ..  . .           .         .     . ..   .  . .   .. .    .    .  .  .     .   .   .     ..  .  .   ...  .   .     .
. .   .  .  ..    ... .   .  . . . .. . .       .. .. .  . ..  .   .    . ... .      .  .  .           .            .        .. . ...  .   .
.   ...    .. .  .  .    .     .      . ... . .. .... ....       . .   ... ...  .  . ..     .         .      .   .    ..     . .          ..
.   . ..     .    .    . . .  ...  .....  ...    . .    . .. . .   . .. .   .   .    .  .    ..  ...      . .    .       .     .      ...  .
.....  ..  ..             .  . .    ..    . .... .     . . .....    . .    .     . .. .     .  .. .  ..   .  ...  ...   .  ..  .      .  ...
.    .   .    .  .          . . .. .  .    ..    . .  . . ...      . ...   . ...    .    .   .  . .  .   ..  .  .     .   .     . ... .  . .
.  . . ..  ....   ..    ..   .. ..    .    ..   .       .     .  . ...... .  . . ...... .  .        .      .   ...    .  .  . ...    .  .. .
..  .      ..   .      ...  . .    . ..  . . .....  .    ...  . ..  .    ....   ..  . .. .   ....     .  .      .    ..  .         .   .   .
...   .. ...    .   ... . . .  .  . .  .. .       .. .    ..   .. . ...   .  .  .     .    . .   . ...   . .  ..        ...    ..   .    . .
..     .   ..   .    ..       .  . ...   . ....   ..   . ....    ....       .....     .  .     ..   .. .      ....   .   .. .         ..  ..
.    ..     .   . .. .    .. .    . .  .  ..  .   .  ..      .    .  .  . .... .    . . .  ..  .  ..     .....      . .  . .  ...    .     .
. .  .   ..     ..  . . .     .  .  . . . . ... .   . ....   .  . .. .      .  ..     .  . .            . .. .     ....    ...  .    .... ..
.      . ... .    .        .   . .  ...  ...     .  .  .. .  .    .    ..      . ..    .        ..    .. .           .    .  .   .  .. . . .
. . .    ...    .     .             .    ..  ....   .  . . .   .. .   . . .    .    .       .    ..    .....  ..       ..     . .  .    .. .
.    .   ..  . ..   . .   ..  ..  . . ...  ...  ...  . .   .   .  .....     ...   ..  . .. .  ... ....    .   .     .  .  .    . .... .  ...
.    ....     .        .             .        .    . ...   . . .       . .  .  ..             ... .  ..  . .    .  .   .   . . . ... .   ...
. . ..  .    ...   ..    .      .      . .. . .  .  ..     ... .   .  .        .. . ..  . . .      .. .     .            .  ...  .    .. ...
.   .. .  .  .       ... .  .   . .  .. ..     . .. ....     ..    .. . .         ... .   . ..  . .   .   . . ..  ...   .  ..  . .. .   . ..
..     .     . .   .   .   .     .. .    .  .. . .     ...       .        ..    ..     .  .  .   ...  .   .     .   .  .X .   ...  . . .  ..
..   . .. .  .   .. . . . .   .        .       .  . .... . . .. ...  ..   . ..  .      . . ..    .     .. . . . ..       ....      .   .   .
.    .  ... .    .    . ...    .    .. .   ... ....   . ..  ...       .  ..     .    .    .   . . . .....    . .     .  .  ......    .. .  .
... ..     .. ..       ..   . ..           . .    . . . ..         . ..      .  .   .    .. .. .  . .. .    .    .  .   .  ...    .      . .
.    .   .      ...          .  .. .   ...    ...  .  .  .     .    . .     .    ...  .       .   . . . .  .   ..     ..  .. .   .    . .. .
.      . ..   .... . .  .  ...  ...   .  ... .  ..     ...      .  .   .  .      ..  .  . ... .. ..  .   ...  ..  .  .   .    .   .. .   . .
.  .   ..   ...   . . . .... . .. .  ...   .     .   . . . .   ..  .   . .      .    ...   .        . .    . . .     .  .    .       .......
. .. .   ...  ..    ... . . .. .  .   .    .   .  ....... .   ...    . . .            .    .  .   . .  ..  ..  ..      .       .    ..    ..
.       ...  .. ..           .   ....     ..   .  .   . .       .  ..  .   ..    ..   . .... . .    ... .. .. .  .         .   .  .   ..   .
............................................................................................................................................
