.......................
.    .  .             .
.      .     ..       .
.            .        .
.    .      .         .
.    .                .
..      .    .        .
. . .                 .
.       . .      .    .
.  X        .         .
.      .              .
.      .              .
.                     .
.   ..    .           .
. .                   .
.                     .
.   .                 .
.           .         .
.                .    .
.      .          ..  .
.          .      .   .
.......................
