...................................................................................
.           .          ..    .                                             .      .
.         ..                      .        .                  .              . .  .
.            .                                .     .   .  .                   .  .
.           .   .               .        .                        .            .  .
.               .                      .   ..    .           .        . .         .
.      .      .    .  .        .     .                      .                    ..
.     .                      .  .     ... .           .          .            X   .
...................................................................................
