......................................................................................
... .    . .... ... .   .    ..   ..    .               .     . .       .       .    .
.   .     ...  . ..     .  . .  .  ..  ...     .. .    .    ... . .        .   .     .
. .           . .     .. ..  . .  .   ...  .    .  ...... . .. .         ..    .  .. .
.       .. .  ...       ..       . .  .     .   .. ..    . ..  .   .. .   .          .
.... . .                 ....  .      .   ... . .   .  .     . . .     ...  .       ..
.  X.  .    .  .  ..  . . . .     .. ... ...     ...   .          .    .      .      .
.     .   .  ..        .  ..  .    .. ..   .. ...... . ..    .   ..   .  .  .   ..  ..
. .    .      .  .. .    .          ..   ...  .      . .     . .  ..  .    .. .    ...
. . .   . . .   .  ... . .    . .          .   . . .   .    .  ..  . ..  .    .. .   .
.         .               . .         . . .    .       .     .   .     .   ..        .
.     .        ...     .... ..    .       ..   ..  . .         .  .  ..              .
..       .          .   .      ..   .  . .  .   .     .   . .   . ..  .      .. . . ..
.  .  . .    . .  .   ... .    .          .  .  ..  ..       . .     ..        . .   .
..  ..     .  .   .       .      . .   .       . . .      . .    .  ...           .  .
.           .  .   .. . .  .               .   .  .    . .           .  .  .  ..   . .
.    .        .....    .     .   .   .  . .  .   ..      .   .    .       ..      .. .
. ..  .     .   .    .   .  . .. . .      . .   ..  .    ..   .     . . .    .   . . .
......................................................................................
