...........................................................................................................................
.       .   .    . ..  .         .  . .    ..       . .   .  ..     .. .  . .  .       ..  .  .                    .  . ...
.   ..                .  ..   .              . .  .....        .  .   ..  .                   ..  .            ...       ..
.. .           .   .      .    .   .        .    .   .   .  ...  . .        .         .    .            .               ...
.    .....      .   . .  .    .     .   ... .      .           .. .. .            .      .  .     .   .     .  .  X     . .
. .  .    . .     ..   .   .  .. ...              .         .  .  .  .     .    .         .     ..  ..     ..     .       .
...........................................................................................................................
