.................................................................................................................................................
. . . ...... .       .    . .X..  . ... . . ..     .  ...  . .. .     ....   .. . .. .    .      .   ..    ... . .  .    . . ..  .  . .  .    . .
. ....    ....  .  .....  .    ..  . ... . .      . ..  .    .  .   .     .  ...   ..... . .  ... .     ..    ..   .     ....   .  .   . ..    ..
. .. . .    ..          .    .  . ..    .. .  .  . .   . ..    . .  . . .    ..  . ..  .... ...  .. .     ..   . ... ..              . ....  .. .
.. ....   .  ......  .       .  . .  .   .  ..  .      ..     . ..   ..... .       . . .        .... . .     .  .  .   . ..   .        .  ..   ..
....   .   .     ...  .. ...  .    ..       .   ..  . .. .  ..  . .  .   .  ...   ..  ....    ..     . . . . . .    ..   . ..... .    .   . ..  .
. . .  ...   . .    ..   .  .  ...   .         . ......... . ....  .    . .. ...  . .    . . .. .    .   .... ....    . .    .       . .. .. . ..
... .  ..   ..     ... . .         .   ...  . ...     ..   .  ..   .     . ....     .  .      . ....  .. .    .  .       ... .      ..  .   .  ..
.    . .        ... . .  .. .   .    ......  .  .. .   . ....  .  .  ....  ....   ..   .. ...  ..    ...  ..   .  .   .  .. ..    . .      ..   .
.................................................................................................................................................
