........................................................................................................................
... ..  .   .  ...     .  ..  .   .  . . ... .     . ...   ..  .  .  ..   ..    ...  ..  .   .   . .  . .. . .  ... ....
.     . ..  .  .         . .  .  .  ...  ... ....  .... ...   .   .         .  .. .  ..  ..  . ...  .    .. .  .  .. ...
.  .. .....   .   ..       . . .  .. ..          ... ..      .      .      .  ....   ...    .   ..   ....  ..  .  ..  ..
.  . . . .... ..  ...... . . ..   .  . .  . .... . ...         .   .. .... .   ...  ..   .   ..  .    ..     ... . .  ..
..   . .. . ..... . .    . .. .    X  .....    ..  .. . . . .     . .    .    ....  . . ..   .   .. .   .     . . .    .
.  ..  .  .      ... ..  . .  . . .  .  . ... ...    .   . .... ..  ...   ..  .  .  ....   ..   . ..   .  . .  ...     .
.          .   . .      . .   .  .. .    .   . ...    . .      . .... . .   ... .. .. .    .    .   . . ... ..   . .....
. .. ... .. . .. ...  .. .  ... .  .  .     ..     .  ....  ...    .. . .... .  ...  . . .    .     ...    . .. .  .. ..
..     ..  .   .  .  . .    .  .. .....     ...  .. ..... .  .   . ....            .. . . .. ..  .       .. ... .  .. ..
.  .   .. .. ...  ...  ..       . ..  .    . ..    ..    ..  .  . . .. . .. ..           . .  ... . .    . . . . . .. ..
........................................................................................................................
