.........
.       .
. ..  . .
.   .   .
..   .. .
.       .
.  X  . .
. . .   .
. ...   .
.   . ...
.........
