...................................................................................................................................................
.                             ..   ...            .              .          .        .     .. .                                .        .         .
.  .        .      .  .          .       .   .        .   ..        . .  .  .   .   .    .                      .                                 .
.                 .  .           .  .      .    .  .     . .   .          .   .       .           .          ..       .   .  . .     .        .   .
..   .     .   .       .          .                   .       .      .  .            .      .              .         .            ..    .         .
.         ..           .   .    .  .                .   .     .      .          .        .    .        .         .     .                          .
.                      .        .     .      .        .     .              .          .            .  ..                       . .  ..  .         .
.        .        .  .    .      ..                   ..          .            .   .         .        .     .    . ..          .   .     .     .  .
.  .          .                     .                  .                        .   . ..        .         .      .  .    . .       . .     . .    .
.             .          .       .        .    .  .    .  .       .           .                 .     .                .           ..        . .  .
.   .        . .                    .     .    .          .  .                     .        .                     .       ..     .  .   .         .
..              .                    .    . .      .  ..            .  .   .   .       .         .     . .    ..  .  . .        ..     .     .    .
...         .      .   .                             .       .    . ..               . .     .           .             .               ....  .    .
.          .             .. .        .    ...    .  .      ..   ..         .         .              .       .      .  .                     .     .
.   .  .       .     .        .       . .       ..    .   . X   .         ..                 .      .      ..    .         .         .       .    .
.           .        .                   .         .              .      ..        .             .     .  .   .        .      .     .             .
. .         . .          .  .            .     . .   ... ..     .   .  .  .   .                     .  .   .   .   .          .         . .       .
.                 .         .            ..           .    .  .  ..                      .   .   .      .  . .               .    . .             .
...................................................................................................................................................
