............................................................................................................................
.  ......          .  . .. .      ...  . .. ...   .  . .... . .  .   ..  .   .. .   ... .  .  ...  . . .. .   .  ..   . .  .
.  . . . . .. . .. .  .    .  ... .     ..... .   .   .. ..  . .. .    .  .  .   .  ...... .  .. ...  .  .    ..      .. ...
.. .         .   . ...  . .  .. .   ...  . ...  ..  ...  .        .  ... . . .    ..      .. . .. . .  .  . .. . .. .. ... .
. .   .    ..   . ...   . .     . .  X..   ..  ..         .     . . .   ..  ... ..  .. .    . .      ... .     .  .  .. .. .
............................................................................................................................
