..................................................
.. .. .... .    . . .      ...    .. .. ..     ...
.  .   .  .... ..  . ... .   ..  . . ....   . .. .
.  ....  . ..  .   . .  .   . . ...   ...   ..   .
..  ..   .X    . . . . . . ...   . . .. .   .    .
. . . . . . ...   ..    .       .. .... . . .  . .
...  ..  .    .   .    .   . .  .. .  ...   .. ...
... .  .. ..  .  . . ...  ... . ..   . . ..... . .
.....   ..           ..   .  .    ..    . .... ...
. ... ... .  . .  ..  . ..   .       .. . .. . ...
..  ... .... .. ..... .   .....  ...       .  .. .
... .    .. ..  . . ..  ....... ..   ..  ..   .  .
.    . .. .. . .  .....  ..  .... .   .     ..   .
..  . .     ...     .. . ..   .     ..  .......  .
.     ..... .. ..... .  .   ..   .  ...    ..    .
.. .  ......   .     . . ... .   .  . . ...    . .
....  .  ...... . ..  . .. . . .   . .... .. . ...
.  . .  .  .  .       . .. ...  ....  .  .  . . ..
. . .  . ... .  .   .  . .... .....  .. .       ..
.   ... .    . . .  ... . .. .. ..... ... .  ..  .
.    .......   ..  . ..  .   .         ... .   ...
....   . . . .    .. .  .. .. .       ..         .
..................................................
