..........................................................................
.        .                                       .    .               .  .
.   .   .          .                      .        ..   .                .
.                      .                .                                .
.  .                                        .       .   .              . .
..       .                  .                  .    .       .    . .     .
..         .                                    . .                   .. .
.                     .X .                      .                .       .
.        .                . .         .                                  .
.      .                                          . ..                 . .
..........................................................................
