...........................................................................................................................
.     .      .  .  .          ..  . .  .......   ..    ..   .  .  . . .  .    ...    . X   ... .     .  .  ..           ...
.    ..   .  .  .         ..      .   .   .. .   . .  .    .   . .    ... . ... .  . ..   ..  . .     .     .        .   ..
. .        .  .     . .. ..    . .    . ... ..  . . ..       .  .   . .        .     .  .. ..    .   .         ..     ..  .
...........................................................................................................................
