............................................................................................
. .     .   ..   . .    ..       ....  .        . . .       .             ...     .      . .
.     . .  .. .  .    .       .    .    ...   .      .. .   .                 ..   .       .
.            .   X ..  ..   .     ..  .   ..         .            .   .   ..  .   . .      .
. .  . .. .. .   . .          .         .    .   .          .  .         . .   .   . .     .
............................................................................................
