..........................................
.. .  ..    .  X  ... .    .            ..
.      .    .      .     ..  .  .   .    .
.   .  . .     . .   ..      .  . ...   ..
. .        .    .    .     .    . . .. ...
.         . .. .          . .   ....     .
.  . ..   . .  .  .       ..            ..
.  ... .   .   ..   .   .  .  .    .  ....
.  .           . ... .    . ..   . .  .  .
. .. . ..   .      . .    .  .    .   .  .
. . .. .  ..    .      .    .     .     ..
.   . .     .    ..        .. .          .
.   .    ...        .   . ...      .  . ..
.       . . .     ..    .. ..   .        .
..    .   .. .  .    .    . ...   .     ..
..    ..              ..  ..             .
.     .      .  ..  . .  .  .  .. ...  . .
.          .  .  .    .  .   .   .      ..
.  ...   ..   ...    ..    ... .  .    . .
.   .  .              . ..   .     .   . .
.  ..  .  .          . .     . ..    .  ..
. ..         . .... .... . .. ......    ..
... . .      . ..   ..      ..      .  . .
. ..  .             . .    .   .         .
..........................................
