........................................................................................................................
. . .          .  .   .. .    .            .                           .             .                 .  ..  .  .     .
.       .      . .     .      .              .    .      .            .    . .             .     .             .       .
.        . .        .         ... .       .     . . ..                     .  ....   . . ...                   .    .  .
.         ...      .                . . ..     .             .       .  .        .    .  .          . ..       . X .   .
. . .          .  .                .    .      .   .         .           .                    .    .   .     .  .      .
..       .   .                 ..            . .  . . .      .         .            .  ..          .           .   .   .
.     . .    .        ..         .       .           .    . .     .     .         .  .      .     .        .           .
........................................................................................................................
