.....................................
. .... .     .  .  . . ..... .   .. .
.  ..   .  .         .   .    . .   .
. .   .  .      .    ..   .  . ...  .
.  ..            .  .   ..     .    .
.        .. . ..     ..    . .  . ...
.     .   ..    ..      .   .  . .. .
... .    . .  . ..     .    .. .. . .
.  ..  ... ..      ... . ...   .    .
.. ..  ..        .  X. .  ..  .     .
.  .   .   .    .....  .           ..
. . .  .    ..     .   .         .  .
. ... . .......  . .    .  ...    . .
.        . .  . .    .  .. .       ..
....  .  ... .  ....... .      . .. .
..        . .       . .     ..    . .
.... .  .. .       . ... .   .  . . .
.. ... .     . .. .. .   ..    ... ..
...   .   .. ... . .  .    .  .  .  .
.....................................
