..........................................................................................................................
.   .  .  ... ..  . ...   . . .. .  .    ...   .  ..       ...      ...  . . .. .  .  .  .      . .  . ..  .. . . .     ..
... . .. ...   .. .. . . .    .. . . .... . ...  ...      . .     ...... ..  . .          . .   ...    ..  ..... .  ... ..
......  ..... . ...  . .  . . .  . .. .  . . .  .. .     . .    ..  .. .     .  . ... .    . ......    .  ..   ...  . .  .
. ..  .  ....       ... .  ... .   .. ..   .   . .   .. .  ..   ... ..  .. .. ..  ..   . ...   .  . . ..  .     .       ..
.       . .    ..  .   ..  .    . .  . . . ..  . .  .  .    ...   .... .  .  ..         .  ..     ..X  . .  .. ... .    ..
. ... .  . ..... . . . . ...  ..  .....   .      ....      .   .     .  ..   .     ..   .  . ..     ....  .       ..  .  .
.       .  . .  ..      . ... .  ..  ...  ..  ..    ..   . .   . .     .     ..  .   .  .     .....  .. . .   ..     .   .
..........................................................................................................................
