..................................................
. .   . .X    ... .  ..... . .  ..  . .. . ...   .
.       .  .. ..  ... .   . . .    .. . .. .  .. .
..  . .  ...    ... ...  . . .  . .     . .   .  .
.   .  . ...  .      .       .. ..   .  .  .    ..
. .....       .. ..  ..  .. . .    .. .. . ..  . .
..................................................
