.....................................................................................................
... . .  . ...  .  .   .   .. ..  .. . ..  .    .. ... .... . .. .  .. . .. .. ..        . . ..... ..
. .  . .  .   . . .   ...  . . . ...  ...    .  .          .. . ..   .. .. .. . .       .. ..  .. . .
. .. ..   .  ..  .. ... .    ....   .... ..  ..  ... .  . .   .  .  .. ...... .    .  .   ...   . . .
...   .  ..  ..  . ..   .  ....  . ..  .. .. .  . ......           ..    . .. . ... .  .... .   ..  .
....  .   ...    .... .. ...  ... .... . .  ..   .. .  .... ..  ..... ..     ..     .  .     .  . . .
. ....  .  . . . ..      .  ...   . .. ..    ... .   ...  ....   . .  .   .. .  ..  . ... . ..   .. .
.  .      . .    ...  ....  .  ....  ..  . . .  ...     . .  .. . .  ..   ....  .  ..   .  . . .. . .
.  .. .  .   .     .. .    .. ...  ....  .   ...  ..    . . .. . .  ...  . .. .... ...       . . .. .
.  . .........    .        ..  ...  .. ..  ..  .    ... . .    ..  .  .. .. .. . . .   . . ... ......
. ..  . .. .  .   ..    ... .    ... ..  .. .. .. .. ..  .   . .. .. .   .  .       .... .. . ..  . .
..... ..   .... ...  .... ... ....  .  .   . .. .  ..  . . ..   .....   ..    ... . . .  ... ...    .
.  .    .  . .. .. .  ..  ......  .. .. .. . .. .    .. . .. .  .  .....  . .      .   . . . .      .
.  .. ..    ....  .. ... .. .         ..  .  .  . ..    .  .  .     .  .    . . . .  ..     ...  .. .
.   . ..   ..  .  ..   .  .   . .  .     ........   .   .  .    .  .   ....     ..    .... ....     .
.. .. .   . . ...  .    ....   .. . .      . . .   ... .. .    . .      ..  .....  ......X ..   .  ..
..  .    .. . .  .. .   .   . .   . . .... ..      ..  .  . .  ...   .    .. ... ..... .       .. . .
..   . . .  ..     .  .. .... ... ..      .  ...      . . .. ..     .  . .   ..  .  .. . . .  . . . .
.. .. . ... ...  ...      .   .. . . .      ..  .. .   . ..  .    ..  .  .  ... ...  ..  .      .   .
...     .       . .  .       . .   .  .. ..  .   . .  .  ....   .    ..  .. .. ...    .. .   . ..  ..
.  .    ....  ........  . ....   .... ..  ..  ..   . .  . ..... .          .  ..  .... .   ... ..  ..
.    ...   . .   .....    .     .  .  .. ..     . ..  .  . ... .. .           .     .      .... ..  .
. ..... .  ..  .   .   .   ...       . ...  . .. .   . ..   .  ... . .....   .......  ..  .    ..  ..
. .....  .   . .. . .....      ......  ...  .  .    .  .      . .  ....      . .. . . .     ..      .
... .  .  .... ..  . .. ... . . .  .   .  .....   .      .  .   .  . . .. ..    .   ..  .  .       ..
.  ..  ..       . ..... ..  .. ...   .  .   .. ..    ...    . . .  .  .... .  ... ...     . ..  ... .
. ..  ...... ...   . ..   ...   ..      ... .   ...     .  .  .  .      .  .. .   ..  .  ..   ..    .
.        .     ....   ..  .. .  .  ..... .     . .... .     .     .   . ..  .....     .. .      ..  .
.....................................................................................................
