.................................
..  .. .       .                .
.    .        .  . .        X   .
.            .             .    .
..  .     ..               .    .
.     .  .         .  .         .
.           ..    .      .      .
.             .           .    ..
.                     .    .    .
.        .                      .
.                  .           ..
..                 . . . .     ..
.     .          ..   .  .      .
.      .         .      .       .
.                .         .    .
.              .          .     .
.  . . .                 .      .
.               .    .      .  ..
.                 .             .
.            .  .   .     .     .
. .  .             .            .
.                     .         .
.        . .     .             ..
.  .              .             .
.................................
