.............................................................................................................................
.    .. . ..    ..  . .     ..   .    .   . ..     .      .           .    .     .  ..         ..           . . . . .       .
.... . ..      .           ..  . .      .  .  .....  .                .    ...   .  ....   .      .  . .  ..      .       . .
.  .    .           .  .      ..  ..       .    .  .            .   .  .. .     ..  ..   .  . .  . .     . .. .       .     .
.   ..  .  . . ..     . ....    .     ..  . .   . .  ..                       .    . . ..   .  . .    . .  ...  .  . .   .  .
... .  .               . . .  .   .   .  ..      ..   .   ...  .                       ..   . .   .   .. .  .        .      .
. .   .  ..           .   .  .  ...   ...  . .  . .     .  .  . ...     .      .    .    ..        .    .  . .         .    .
.   .    . .  .        .         .      .   .     . .  .   .           .  ..    .. .  ..    .    . .   .  .      ...   .  . .
.   .     .. . .       . .    ...  ... .      .             . .    . .      . ... . .      .   ..    .      . ..          . .
..  .   .   . .  .. ..  ...         ...   ..          ..  ...       ..  . .       .      .     ..    .           .        . .
.  .     . .     . .   . . .    .         .. .         .  .    .   ..   . .    . .  .   . . ..... .   .. . . .  .  . . ..   .
. .    .  .. .. ..      ..      .          .      .  .  .   .  . ..    .  .      ..         .     .     .     . . .   .    ..
.     .   .   .  . .         .  . .     .  . .  .        .       .  .   ..   . .. . . .      .       .     .      . . .. .. .
.    . . .   ..       ..   .. .  .  .  .   .   .         ... . .     ...     .       .       .  .       ... .   .  ...  .. ..
..   ..   . . . .      ..     .          .               .  . .    . .    .   .  .     .    .          .      ..            .
..          .  .         ..  .  .  X..    .   .   .    .   .  . .     .      . .  .    .     .       .    .      .  . ...   .
.   .. .     . .. .     .  .. .  ..       . .     .  ..      .             .      .. .. .  .                 .      .    .  .
..        ..    .   ..  .  .  ... .   . . ....  ..   ..   .         .. .       .  ..       .  .       ..   .     .       .  .
.  .  .   ..   . .  .     . .. .  ...   ..   .    .  . .          .  .       ..  .   .     . .            .    ..  . .  . . .
.     . .      ..   ..   . ..   . .  . .  . .  .  ...    .      . . . .    .           .       . ..  .         ..     .. . ..
...  .   . . .     .... .     . . ...   ....  .    . .                   .      .  . ..          .  .           .      ..   .
.............................................................................................................................
