.............................................
.         .   .  .         .       .  .. .. .
..     .  . .X .    .  . ..   .          .  .
.  .  .  .         .        .         .     .
...        .  .        .     ..  .  . . . . .
.         .. .  .                .          .
.  . .....  .   .  .  ..   .        .    .  .
.                 .  .      . .  .          .
.............................................
