.....................................................................................................
. ..   . .X  ..   ...    ...  ...  ..  ..  ..  .. .  ...  ...   .......   ..    .   .. .   .   ..  ..
.  .   .  .. .   . .  ..  . .. .... ..   .. . ... . . ...   .   ..      .. . .   ...  .. .     .    .
.   . ..   .    ..  . ...  . . .. . ..    . ..   ..  .  ...   .  .... . .   ..   .    .. ...   .  . .
.  .  . .  . . .  ..  ..... . . .     ...    ..    .  .  ..  .... . ..   .. .    .   .   ..... ..   .
..    ..... . ..  .  . ...         . .. . ..    .......  ..   .    . . ..     . . .  ..... .. .  . ..
....   ....  .  .     .  ..    .. ..       ... ..       .. .. ..    . .. .  .   .      . ....       .
. . .. ......    ...  . .  . . .      . ..  . .   ...     .. .. . .. ..  ..  . ... ... .  ....   .  .
.....................................................................................................
