..............................................................................................................
.  .           ..  .  .  .     ..      .  ..    ..  .            .       . .    . .  .      .  . .       .   .
.  .  ..       .  .    .          .    . ....      .   .     ..             . ..        . ... .  .  . .. . . .
.      .          ..    .         ..       .. .   .. .  . . . . ..    .. .    .      .        .    .  . .. . .
. .   .            . .  . .  .       .  . .        ..         .   .            . .        ..     .   .      ..
.    .   . .        .    .                ..  ..   .  .  .      ..  .         ..    .   .    .            .. .
.  . .           .  ..   ..   ...  ..      .  . ....   .            .               ..  .       .            .
.  .    . .     ..      .           .    . .. .  X      .         .   .  . .  . .       .           .    .   .
.  ..    .  .  .     .    .       .          .    . .          .             .  .     .      .   ...   ....  .
.. .   ..      .      .              .               .    ... . . . .       . .     .    . .        .  . .   .
.                        .     .... ...   .  ..          .   .      . .              . ...   . . .    .  .  ..
.     .  . .         ....          .      . .             .  .. .. . .  .   ... .              .. .   .    . .
.   .    .               . .  .      .  ..   .  ..    .         ..    .      .            .  ..  .     .     .
..............................................................................................................
