......................................
.  .      .      .    . .         .  .
.  .....   .   .         .         ...
...      .  .     .. ... .   .  .    .
.   . . .. .   ..                 .  .
.   .    .  .. ..X   . ..    .       .
..   . .   . ..  .  . .     ..      ..
.     ...   ..     . ....           ..
.           .  . .   . .     .    .  .
. ....  ..  .    .   .    .  .       .
.   . . . ..  .. .. . ..        .. . .
......................................
