............
.    .     .
.  ..      .
.          .
.X  .      .
.    . ..  .
............
