............................................................
.   . ..  .      . .   .       ..       .  .         .    ..
.  X .    .       .  ..  .                                 .
.   . .    . . ..     .   ..  .    ..    .    .   .   .  . .
.  .                     ...   .               .    ..    ..
. .       .       .   .      .             .    .     .  . .
. .  ...         .  .  .       .  .                   .    .
..        .      .       ..  . ..  .      .           .    .
.              ..    .    .  .   .    .    ..     .   . .  .
... . .        .   .           .  .  ..             .      .
.     .    .  .. .  .   .           .   . .   .    .   .   .
.   .      . .       .           .   .  .     .        .  ..
... ..                        .  .    .          ..        .
.  ..       .      .      .        .       ..   . .  .    ..
.       .     .    .    .  .   .    .     ..      .     .  .
.   .         . .              .   .          .  .      . ..
..     .      .  . .  .          . .                    .  .
.                ...     .     .   . .       .   . .  .    .
.    .   . ..   .    .   .   .   .   . ...    ...     .  ...
.              .       .    .    .  .     .  .      ..     .
............................................................
