.......................................................................................................................................
. .     . . .. . ..  .. .  .. . .  .. .  .. .. .  ..   .      .  ... ..... . .  .. ..   .. .   .   .... .  .   . .     .  . .. ... .. .
.  . ...   . ..... .   . .. .  ..  ...  ......  ..   .  ..   ......  . .. .     ..    . ...... ..   . .... .   .... ....  .  ....   ...
. .........  . ...   ... . .  .. ......  .   ... .   ... ..   .  ..  ..   . . .... . . .  . .. ..... .. .   .  ... . .... . .. . .    .
. .  .  .. . .... .... . ..   ..   . . .. .       .  .   ...  .. ...  ..   ......  .  . .  . .   .   .  ....  . .  .... .  . .... .   .
.   . .    . .  . . .. ....  ..  . ... .....  ..   ..  .. ..... ..  ..  ..X .     ..   .. .  ..  . .. .....      .. ... .  ..   ... ...
..   ... .  .   .....   . . .. .  ...  ... .     .  .  ...  ..     .. .. .   ....... . . .. .. .. ...  ...  . .   .  ..  ...    .  ....
. . ....  .. .. .. ...  .......  . .  ..    . . . .     ... .  . . .   ... ........  .... .  . .  ... .  . .. . .     .   ... .. ... ..
..   ..   ..   .....  .   .. . ...  . . . ..    .. .... ... ...    .    .. .  . ... .  .  .  .  ... ..     . . . . . ..   .  ....  .. .
.    .. ..  .  ... ....  . .   ...  .     .   . ..   . . . ...  . ... .  .. ..... .  ..... ...    . .  . . . .. ..  ...   .    ........
. .  .   . . . ..  ..  . ...  ..... .. ..  . ...  ... ...  ... . . ... ..   . ....    ..   .... . .   . .....    ... .    . .    ... ..
. ..  ......     .. . ....... ...  .. .. . ..   ...    ....   .   ... .  .. .  .   . .    ..  .  .  ....  . ...   ....... ..... ..... .
. .. .   ..   .... .. .. . ..    .    . .   .  ...... ... .. .. ....  .. . .  ...  .    .    ..     ..... . . . .   ...... ... .. .  ..
.... . . .  .. .. .  .. ... ... .  . ...   . ..  .   .. . . ..  .. .   ...  ..  . ..  .  . ...   .. . . .  .  .. . .  ..... . .   .  ..
.      .   .   .    .. .... ....   .. .. .   ..    ....   ....  . ...... .. .  .. .... .. ..  .   ..   ..    ..    .  ..   .. ...  ....
.. . ..      .. ...  ....    . .   .. ..  . ..... ..  ......  ..  .  . . . . . ... ...   .        . .    .    .  .   ..      .    . . .
.. ... .       . . ..  . .. ..  . .. . . . .   ....  ...  .. ...  ... .. .. ..   . ..  .    . .......    . .  ..  .   . . .  . ....   .
.......................................................................................................................................
