...................................
. .    ..   . .        .       .  .
.  .              .      .. .   . .
. .     . .        .. . ..        .
.      .    .   .. .  .     ... . .
..      ..    .      .. . .. .    .
.   .     .   .       ........  . .
.     .   .. ...  .          .    .
.  . .                  .         .
.      .  .  . . . .  .  .       ..
. ..                  .      .    .
..    .  .            ..    ..  . .
..         .. .    X. . .         .
.    ..   ..      . .   .. ..  .  .
.  .  ..                  .  .   ..
.. .              .  .   .   .    .
..          ....  .    .    .  ....
.       ..  .   . ..          .   .
. .. .   .    . . . ..    .       .
...................................
