..............................................
. .     .  ..X         .     .   . . .   ... .
.. .. .    . ...   . ..        .  . .. ..  . .
. .     ..  . ..    . ...  ..   .     ..  . ..
..............................................
