...................................................................................................................................
..  ..   .  . . . .   .      .            .  .  .        .   .    ... . ..  .      .  .     . ...     .  .    . .        . . .  . .
.   ..... .       .  .. .....         .  . .   .   .  ...    .  . .     . .     .        .        .  .    .. .  .       .       . .
..      ..  ..    .       .. ... .          ...     ..     ... .                 .... . . ...  .  . . ..    .        ..   . .  .. .
. ... ..   . .   .  .      ..   .   . .  .  .  . .   .      ..  ...       ..  .  . ..            .        .     . .  . .    ....  .
.. ..    . .     .  ...  .   . .     .    .  .   .. .     .      .    ..      ... .    .   . .    .    .   . . .     ..  .    .....
...    .  .X.         ...  ..  ..     ...       . . . .  .  .   .... .. .          .. .    .    .   .      . .    ..  .    ..  .  .
. . .      . ..   . . . .      . .  ..   . . .  .  .   .    ..        ..  .  ..  .   .   .     ..   . . . .. .         .       .  .
.     ..     .  ..  ..  ....   .. .. ...      .  .. . .   .. . .  .      .  .   .   ..   .  ...  . ..    .      ... . ..       .. .
.   .        ...   . . .         .      . ...  .  ..  ..    .  .  .    .    .  . .  . .    ....  .    .. . ....  .  ..    . . .  ..
. . .         .  .       .  .   ... . .    .    .    ..   .   .  .. .          . ...           .        . .   .         ..   .    .
. .  .  .    .   .           ...    .         .    . . ..      . .    .  .       .        ..   ..  .  . .  .      .   .       .   .
.   .     .   ...  .    .  .  .   .    .   ... ... ....                 .   ..  ..  . ... .  .  .. .    . .   ... .     ..   . .  .
...................................................................................................................................
