.....................................................................................................................................
.  .  ..     .     . . .  ..       .      .        .  .   .. .  .   ...   .. .         .   .    . .. .   .   ..  . ..  ...     .. . .
..       ..  .. .  .    ..  ..  .      .       .  .  ...      .  ... .   .    . ..  .. .  . .  .       .      .   .  ..            ..
. .    . . .   ..  .. . .   . ...     ..   .  .. ...  .X . . .     . .     .  .      ..        ... ..              . .    ... .    ..
.  .      . .      .          ...    .....   .  ..         .. .. . .  .              .  .   .     .   ... .     .   . ..   .   .    .
.       .    .  .   ..  . .    .   . . .         ..  ..  .. .   .        ..  .          . .         .  .        .   .  .. . .   . . .
.   ..      .  . . .. .    .  .     .     .  .  .  ...     .  .       .. .      .       . .   .            . . .   ..  . . .  .    ..
.  ... .  .     .   ..       . ..        ..  .  . .. ..    ...    ...  . .    . .   .  ...   . .      .   ..  .         . ...  . ....
. .  ..    ..   ....      ..   .     .  ..  .  .       . . .   .   . .  . ...     . ..  .   . .         .. .     ... ..    .   .    .
.              .         .  .    . .. ..       ..  .... .     ...   .     .  .. . .  . .. ... .    . .  .    ... ..   .      .  .  ..
.   .  .  .  ..  . ..       ....  .     ..    ..  .       ..   .  ..   .    . .         . . .... .   ..         . .  . . . . . ..   .
.   . . .     .. ..        .        .   .   . ..       .    .   ..      ..   ..  . .. .      .   .  .      .       .       .  .     .
. .      ..  .... ..   .   .     . ....      . ..  .   .. ..   .  .   ..   .          .   .     .     .  ..    ....       .   . .   .
.  .               .    .      .     ..    .....    ..     . .      .   ..   . .        .  .  .    . .  . ..    .      .         .  .
.   . ...   .    .  ..   .            . .     . .     ..  .    .  . ..    .. .   .   .. .  . .   . . . .  ..   . ..       . .. .  . .
....  .    ..    .. .        .       .     ..   .   .  .          .   .    .. .  . . . .   .  ..  .   ..      . . .    . ..         .
.        ...     .       .     .  .   . .  ...    .   .   . . ...   ..   .        ... .   .     ....  ..  .  . . ...   ..   .   .   .
.....................................................................................................................................
