........................................................................................
...   . .... . ..    . ..    .....  ..   .. . . .   .  ... ..   . ... .    . ... ..    .
.      .   .  ..   .. .  .  .    ..  .  .  . .      . . .  ..    .. ...    ..      .  ..
..        . ....      . ... . .  ..       ..   .... . .   .    .. . ...     . ..       .
.   .     . ..  ..  ..   .     . ...    ...   .  ..     .     ..      . ... ....   ..  .
.  .  . . .. .  .      . ... .  . ... .. ..      ...   . . ..  ..    . .. .  .      .  .
.. .  . .  .     .. . . .  . . ...       . .   .  .  . . .     .   . .. ...    .. . .  .
. . ..  . ..   .. .   .    ..    .       .. .   .  .  . ..    ...   .  .  ..    .      .
.   ...   .     .   .  ..        .. .. .    . .. ... .      ... .. . . .... . . ..    ..
. .    ... . ... .  ..  .  . .       .....   .  ....  .. . .. .     . .  ... .  ....   .
.   . .  ..   ...... . . . .   . . ..  .             ... .. .  . . .. ..  .  ...    . ..
..     .  . .   ..    .    ..  .           .  ...    ..     .. ...  ..    ..   . .  .. .
. .. . .  .  .  .  ..          ... . ..    . ..        .. .. . .     . . .    .   .    .
.. ...  .    . .    ...  .  .  .     ...  ..  .   . ....  ..    . .   .  .  ...     ....
.     .     . ..  .    .    . .  .   ...         .. . .    ..    .    .   .. .   .   . .
.. ....  ...  ..    ...    .. ..  .. .  ...  .  ..   .      .  .   . ....    . .   ... .
..   ...    .  ..  ..  .  . .. ..   .    ... ....   . .  ... ...    .. .  ...  ..     ..
.    . . ...    .   .   ..     .     . .        .    . .   .  .  ...  .  ...  ...  .  ..
..   .  . .  . .. .  . . ..  .    .   . .   .    .. ..    .    .. .. .. . .. .       ...
..  ..  ... .. ...  .      . . .   .       .  .. . .    ...   .  .. .   ...  ...      ..
..   . X  . .   . . .....  . .. ..   .    .         ...        .         ...   .   .. ..
.  .. .   . . .     .. . . .   .   . .. .    .. ..      .    . . . .      .  ..   ..   .
...  .   . ...   .. .. .  . .. . ..        ....        .   ..     . ..  ..    .... ..  .
.   .  .   .       .    .. ....    .  . .   . .....      .. ...   .   .              . .
.. .        ...  . .    .      .. ..  ..  ...  .. . .  . .      ..  .. .     . ....   ..
. .     .   ..  ...   ..   .  .    .   .  .  ..   .  .   .        . .   . . .     ..  ..
. ... .  .    ..   .   .. . ..   .. .   ..    ..  . .. . .   .. . ... .    .  . . ... ..
.. .     .....     ..    . ... . .. ..  . ....     ..      .  ... ..  .        ... . . .
.    .    ....  .    .  . . ....   .  . .   ..      .  .    .     .   . .  ..      . ...
........................................................................................
