......................................................
. .. .  .    .   . .   . .... . . ..  ..       .... ..
. .  .  . . .  ...         . . .. . .       .   .    .
.   ..   ...    . ...   .   .      ...          .  . .
.     . .  . .. ...    ..         .      .. .       ..
...  .       .   .  .   .. .  . .  .   . ..   .   .  .
.      ... .  .   .    . .. .  ..  ..    ..  . ... ...
.  . ....  .  . ..          . ...       ...    ..    .
.   ... .       . .    .   .            . .  .     X .
.   .    ..        ....     .  .       ..     ... .  .
...       .. .. .. .      ..     . ..   ...  .  . . ..
.   ...   .    .. ..    ..     .             . .  . ..
.   .  .       ..    ..   .  .. ..    ... ...        .
.     ...  .   .    ..  .  .. .. . .    . . ..    .  .
.    .    .             . .  .     .  .   .    . .  ..
......................................................
