............................................................................................................................................
.    . .  ... .  .. .   .  .  ...  .. ... .  X .. . .   . .     . . ..   .  .  . .  .  ... . .  . ... ..    .      . .  .    .    .        .
.  .       .      .  ... .    .           ...  .       ..   .     ..   ..  .. ...  ...    .  ..         . .     . . . .   .  .      . . .  .
.            ... .   .   ..     ....  ... .  .  .   .. .   .....   .        .    .. ...   .     . ..   .   ..  .     .  .  ..  .    .  ... .
. .  . .     .    ...  .      .     .. ..   .     ..  .   ..   .  .    .  . .. .      .....         ..   .            . ...  .   .   .... ..
.   ..  .  .     .  ..    . ..   .  .      . .  .... .       .  .     .     ...     ..    .    . .. .  .   . . . .    .. .  .. . . . .  .  .
..  . ..     .  ..   . .    .  .          .. . . . .  .  ..   ..        .   . ..... .    .. .  .   .  .  .      .      . ..      ...   . . .
. ..         ..   . . . ..   . ...    .   .  ..   . .           .     .. . .       ...         ..  ....  .  . .        .   . .. .        . .
............................................................................................................................................
