......................................................................................................
.....   .  ..  ... .. .   . . ..  . ..      . ..     . . ... ..  . .    ....  .    .  .  .... ...  . .
.....  .  .... ... .  . .       .. . . ... ....  .  .  ...    .  .... .. .... ... .. ..   .  .   .....
..   .. ... . ....  .   .. ... .   . . . ...   ... . ... .    ...  .... ...  ..  .....   .  ... . .. .
.. .. .. . ..  .   ...   .. .. . ...    ...... . .. ...   ... .. . .....  .. .....  . . ..     .  . ..
.  . . ..   .  .... ..  ..   .. ..    .  ....... . .. ...  . ..  ...  .. . . ..  .   . . .  .....  . .
.   . . ... .  .  .   ...  . .. .. ... .. . ... .     .... .           ......   ..  ....    .     ....
. .. .... .    ...     .. .. .....  ..  . ... .  ...   . . ..   ....  ....     . ..... . ..  .  . .  .
. .  .  . ..  ....   ...  ... . .. .  . ...      .     . .... .........  .. . ...  . ..... .. .. ..  .
. ...  . ... ..  . .   . .. ... ..   .  ..... ...     .....  ..  . .   . ...  ..  ..  . ..... ...  . .
. ...    .. .. ..  .. . ...  . . ... . ...... ....  .    .... .  ... . ... . .. ... . . ..  ....   . .
. .. .     . .. . .   . . ....  ..   . .   .. ...  ....  ..  ..  .   ...     ..    . .  .  .. . ... ..
..  ... .. .... .. .. .  .. . . ....  ...  . .. . .   . . ..  .       .. .. ..    .... ..  .  .... ...
...  ....   .. . .. .   .    .. .  .. ..   .  .  . ... . .....  . .. . ...   . ..... . ...   . .   ...
......  ... ....  . .    ...   ... . . .        ..  ..     ...  .. .. ... .. ...    ..  .. . . .. .. .
.  . ..  ... .. .. ... . .   ..  . ......  . .    .   .   .. .. . ..  .. . . .  .. . .... ...... . ...
....  ... X   ..  ...    . . ...  . . ...    ....    . ......  . .  .   ..      .     .....  ...  . ..
.   .. .   . . ....  .. .....  ....  ..     .... .   .. .  .  .. ..   ...   .   .......  ...   .  .  .
.  . . .   . .... .    .. . .      ..  . .. . ..       ...  . ... .. ...   . .    .   ..  . ..   ..  .
...  ...  .     . .     . ...  ...     . ..  . ..  ....    . . . .. .  ...  .. ....    .....   . ... .
.    .  ..  .   .....     ..    . .... ..   . . ..  ... .  . .  ..   .   . ..   ..       . .... .. . .
. . ......  ... ... ... .  ...  .....   .  .  .   .. .......  ..       .. . ...  . .  . .....   .. . .
..   . ... .. . ..  .  ....  ..   . . . .    . .. . .      .  .   .. .        ... ..  .    . . . . ...
.. .. .    . .      ..  .   . .    ..      .   ... ..   .. .. ..  ..    .    . ....  . ...  ... .   ..
. .    .  .. .. . ..  ..  . ... ....   .. ..     .....  ..   .  . ...     ..    . .....   .... ..... .
.. . ..    ..         ..  ..  . .  ....    ... ..  .     .  .  . . .. ...  .  ..  ... . ...  ....... .
. ... .  .   . ..   .   .....    . . . . . ....  . .   .     ....    .......  . ....  .. .   ... .. ..
......................................................................................................
