......................................
...     .        .            .  .   .
.  .. .       ..  .X     . . ...     .
.        . .  .     ..  .. .    .    .
..  . .    .   .       .  .  .       .
. .   .        . .  .  .    .   .    .
.    . .. ..         .    .  .       .
.     .  .     .   .    .      .    ..
.. .  .   .  .  . . ..  ..     .   . .
.   ..                               .
. .  .           .        .  . .  ....
.   . .    ..      ..     ..      . ..
..            .        ..   .. .  .  .
.   .                       .      . .
.  .        .        .     . . .     .
.     ..   .  .. .. .              . .
..      .  .              .   .  .  ..
.     .       ..  .       .     .    .
.   .    . .   .         .           .
......................................
