......................................................................................................................
. .         .   .            ..    .                         .         .         .   .  ..   .              .    .   .
.  .              .  .       .       .   . ..     .   .       .  .    .  .       ...      .      .   .    .    .   . .
. ..         .  ..     ..        . . . . .     .     .  .                 .    ...    .           .        .. . ..  X.
......................................................................................................................
