........................................................................................................................
.  .  . .    ...    .    .     . . .   . . ..  .  ..  .  . .   .  .  .  ... .  ... ....     .  .....   . .   .        ..
.    .  ....   . ..   .   .   .     ..  ...    .  .    .        .. ...  .  . .. ..   .  . .  .  ......    .            .
.  .         .  ... .. . . ...   .  .. ..   ...   .  ..   .       .. . ... . .        .    .. ..   .   ..    ..  ..   ..
... .  .  ..  ..    ... . . ..    . ..  .   ... ....       .  . .  ..    .  .     .  . . .   . ... . . .. .   ..    .  .
. ..    ...     . ...      .      .          ..  .         .        .     .   . .  .  .   .      ..   . . .      . . . .
.                ....    .    ...    ... .  ..   ...        .  ...   ...     .  ..  . ... ...  .     .        . .  .  ..
..   . .  ..   .       . ..   .    .   .. .  .   .  .  .  ...  .    .   ..  .    ..  ....  ..  . .  . . . . .   ...   ..
..     . .      . .  . .  .  .     .. .      .      .   .    ...  .  . .  .     .  .. .  .  . .   .    . ..           ..
. ...   .  .  ... .     . .     . .    ... .    .  .  .  .. . . . ...  . .    . .    .... .                     . . ....
. . . ..        . .. .. .      .       .                . ..         ..  . .... ...  .. .    .. ..   . .   .. .        .
.            . . .    ..   .    .   .  . . . . .. .. .  ... ...  . .  ...  .  .    .  . .     .    .  ...  ..     . . ..
.  .    . ..     .     ...     .   . .  .   ..     ....        .  .    .  .   . . .   .  ..   .   .   . . .    . .     .
.  .. ...     . ..          .   ..     .. . ..     .  ..  . .. ...   .  .    . .. .      .. .. . .     . .    .        .
. . ..  . .  . . .   .        .      .  .    .         .  .   . .    ..      .  ...         ..  .   .  .      . ..... ..
.  . . .... .      . .. .  ..    ... .  .    .    . .. .. . ...  . ..   ...  .  .      . ...  . .  ..   .. .. .     .  .
.. .       X.... .    . .. . ..  .  .           .  . ..       .    .    .  .   ...       .. ...... .   .... ....  .    .
. .  .          .   .  .     . . .      .     ..  .  .         .     ..    .     ..  ...    ... .         .    .. .  . .
.  .   .  . . .. .    ..  . .     ... .   .. .  . . . .   .  ..     .    .               ..   .     .     . .   .   . ..
........................................................................................................................
