.................................................
.. .   .. . .   . .. .  . ..... . . ..... . ..  .
.. .. ..    ..  ..         . .. ....  . .  .    .
....    .   .  .  .. . ..  .. ... .  ..   ..   ..
. ..  .  .  . ..   ...      ...    ...  .  ... ..
.     ... . .... . . .....  .    .  .  .  ..    .
.. ..     .   .. .... .. . . . .  ....    .  .  .
. .. ...  .. .    .  .... ... .    ...   . .  . .
.    . ..      .... ...    ..   .. .  ... . .. ..
.. .          ..  ..   .. .  .    . . . . .. . ..
..   .   .   ... ..    . .      ..  . .   ..  ...
... ...  . .... ...    .  .  . . . .      .  .. .
. .. .     .. ... .  .  . ...   . ......  .   ...
.   . . ..   ...   .      . ...   ..  ...  .. . .
. .    . . ....   . . . .   .  ..   .   ..   .  .
..    .  . . .   .  ....... .  .. ... . . .   ...
. ....  ...  .  ..  . . ..         .. .  ..     .
. . ..  . . ...  .  .      .. .    .... ...  . ..
.... ..  ...... .. .  .  . .....  ...    .     ..
.  ....  ..       ...    .   .. .  ..X ..  .    .
.  ...   . . . ..   ....  .    .. . .   ..  ..  .
.....   .. ..  .   . . . . . .. .... .. ..   ....
.  . .   ....   .      ...  . . .  .   . ...  . .
. ...     ...      .   ....  .   ..  .  .  . .. .
..  .. ....... . .    ..   .  .  . ........ .  ..
...... . ... .. .   . .... .. . .. ... . . .... .
.. . ... ..  . .   ..  .. . . .  .. ..... .     .
.. . .   ..   . .     . ... . ...  .. ..   .  . .
.... . .  .         .. .. .    .  . . ....  ..  .
.................................................
