................
. . . .  . .   .
.   .       . ..
.. .     . . . .
.        X   ...
.  .           .
.. .    .     ..
.   .  ..   ....
.       .    ...
.   .   .  . ...
.. ..      ..  .
.. .      .  . .
. .    .  .    .
..          .  .
.   .. .. .  . .
.. .      . . ..
.  .  ..    .  .
.    .      .. .
.     . .      .
................
