..................
....            ..
.   ..   ... . . .
..       . . .   .
.    .    .   .  .
. .    . ..  ..  .
.   . . .  ..   ..
..  . . .     ....
.        ....  . .
.   .   ..   ..  .
. .   .  .  . .  .
.  ...   X.      .
.       . ..     .
.   .           ..
..    .   .      .
.              ...
...       .      .
.    .     . .   .
.        .. .  . .
..           ..  .
.       .  .     .
.     . .        .
..       . .     .
.            .   .
. ... .     .    .
.  ..   ... . . ..
.    .  . ..     .
..................
