..............................................................................
.      .                    .          .   .   . .     .   .       .     .   .
.  . .              .                    .                .        .         .
.     .               .    . .      .    .   .              ..      .        .
.                                            .. .         .    .             .
.            .              .     . . . .  .     .        ..   .          .  .
.          .  .        .     .                                      ...    . .
.       .  .     .  .          ..   .  ..  .          .      .     .         .
.           .    .              .  .      .     .     .                    . .
.         .    .                   .  ..  .    .  .   X                 .   ..
. .               .      .          .         .                              .
.            .                           .  .     .         .                .
.       . ..     .   .          .        .        .     .                   ..
.                     .                                   .    .         .   .
..............................................................................
