..................................................................................................................
.      .     .       .     .           .      ..                   ...              ..             .             .
..       .     . .  .      .     .       .      .                                    .  .      ..    .   . . ..  .
.      . .  .                   .       .           .   .        .     .    X   ..    .     .       ..  ..  .    .
. .  .  .  ..  ..    .        .           .       .        .              ..        .  .     ..          .       .
.                 .            .. .                     ..     .   .                 . .   .    .     .          .
.. .   .    .     .             . . .           .    .                    .            .      . .  . .     .    ..
.  .  .           .         .    ..         .  .   .                       .                           .      . ..
..  .   .    .     ...       .              .   .       .               .  .          .  .     .    .   .      . .
.     .     .      .  .    ..   .  .  ....    ..        .        .                 .. .     .       .   .      . .
.     .   .   .         .    .        .  .   . .                .              .  .  .     .   .   .       .     .
.   .     ..               .                ..   .                   . .             .  .                 ..   ...
.               .   .     .         ..        . .               .       .       .    .        .            .     .
.    .  .          .     .   .     .                .           . .  ..  .     .       .          .              .
. .        .            .     .    .        .     .  .    .        .        . .         .    . .  . .     ..     .
.   .   .  .        .                                           .             .       .     .    ..        .     .
..   .  .       .       .           .          .   .      .     .   .  .               .   .         ..          .
.    .     .  .   .             .        .                   .                .    . ...      .. .   .    .      .
.                   . .       .      . .   .  .      .     .   .   .     .         ..     . .  .   ..  .         .
.           .      . . . . .            .         .            .      .      ..                       .          .
.   ..      . .   .    . ..       . .  ..          .      .    ..                                .  .            .
..................................................................................................................
