...................................................................................................
.  . .    ..  .  .  .  ..     .  .   . .    .. . .... .     .     .  ....    .  .  .     ..      ..
...... .    . .  .     ....   ..     .  ..  .      .    ..  .. .. .. . .. ...  .    .   .. .   .  .
. .  . ....   ..  .. .. .    ..  . . .. ..  . ..       .      ..     ..   ... .    . .   . ... .  .
.  .    ..  .      . ..   .. ..     .  ... .... .....  ..   ..    .  ... ... ..    ...    ... ..  .
.  ... .      . . .  .    . . ... ... ..  .   . . . ..  ... .    ...      . . .  .   .  ......  . .
.   .   .......  ..    ...   ..  .   ..  . .... ..  ...  . .     .       .  . ....   ...   ..  . ..
. ..     .   ... .  .   .    .      .  ......  .  .  ..      ...           .  . .....  ..   . .   .
.     ..  ..... .   .  . .  .  .   .. .  .... .. . ....        .     . . .     . .  ..   .. ... ...
.. ..      . . .   .   ..  .  . .  . .   .. .   . .  .      ..     .  ...... .    ..  .  .    ..  .
.  .  .   . . .... . ..   . ..  .. . .. .     .. .   .. .  .  . .. .. . ..  .   ......   . ..   . .
.....   .     .    ..   .. . ... . . .... .   .. . .     ..    .    ...  .  .... ... .. .   .    ..
..            .  ...  ..     ..  .   . . ....   .. .   .  .   ....    .      . .. ..   .   ..  .. .
..    ..    .  .  .  ...  ..  ...    ... ..   .  ... ..         ...    .... .. . . ..     ... .  ..
..         .  .    .    . ... . .. .   . .        .        ...      . ... ..       . .   . ..  . ..
... . ......  ..   . .   . . .       .. .   . . .. . .  .   .. ..  ....      .  ......   .   . .  .
...   . . .  . . ...  ... .  .. .  .. ..    ...   . ..        .   ..      . . .    .  . ...   . ...
. . ..    . ..   .   . . . . ..  .  .... ..    ..       .    .  . .  . .  .  .    ..    .        ..
.  .. . ..   ..  .     . ..   .. ... .   .. ... . ..  .   .   .   .  ... . .  .. ..  .   .        .
..    .   . .      ..  . .... .. ..   . .  ..  . .  .....  ..    .. .    ...  ....  .  . . . .    .
..    .        .. . .  .       .. . ..   .  ..     . .    ... .   .  ...      ...    . .. . . .  ..
.         ... ....       ..... . .  .  .. . . ..   . ..  . . . .    .    ..  .    .  .. ..  .    ..
.. ..    .       ....  . ... .  ...  .  . . . .  .  ...    . .   ... .  .    ..  .  . .. ..   . . .
... .   .  . .  .  .. ... ..     ..   ... .  . ..  .    .  . . ....  .. ..     .  . .  . ..       .
.     .       . .   ...     ... .   ...  ..   . .  .    .. ... .. . .     .  . ...   . .   . .    .
..    ..     . . .. .. ... ... .    .  .    .. ......X    .. ..... .   ...    ..  ... .       ..  .
...  ..   .  . ..  .. .   ..  .. .. ..    .  ...   ..... . .  ..  .  . ..  . . ..     . . .  ......
...................................................................................................
