....................................................................................................................................................
.                   .                                       .  .   .      .   .   .         .      .               ..    .       . .             . .
. .            .        ..  .   .                                        .               .                   .  .      ....  .      . .  .   .   . .
. .             .    .      .                      ..  . .        .               .   ..        ..  . .       . .     .     .       X    .         .
....................................................................................................................................................
