......................................................
....    .   .. ...  .   . . .      . .  ... . .   . ..
....   . .  . . .. .      .    .....   .X....... . ...
. . .        ... .   . . .. .... . ....... . .  ..  ..
.. .. ...  ... .    ....  ..  .  .  .  .. .   ..  . ..
. ... .  . .   .. .    . ... . .  .. .   ....      ...
.......    . . ...      .  ... .   . .  .  .. .. . ...
...    . ...  . . ..   ..    .. .   . .. .... . . .  .
......................................................
