....................................................................................................................................
..     .. ...    ..    .         .         .   .       . .       .         ..      ..   .       .  ...         ..       ..   . .   .
.  .           .   . .    ...   .           .             .   .          .          .                 ..    .        .             .
..         .  .   .            ..   .          . .                       .. .  .. .    .  .  . .. .         .  .     ..    ..      .
.   .  .  .         .    .       ..  .       .              . ..  ..    .      .       .   .     . .            ..       .         .
.           ..      .        .           .  .  .. .. .         .         .   .           ..    .    . .    ..  .        . .  .   . .
.                  .     .. .      .   .. .  .                .               .   .     .    ..  .  .        . .     .    .        .
.   .. .       ..     ..  . .  .      . .  .  .   ..                  ....   . .          .           .      .   . .  .     . ..  ..
.    . . .  ... .        . .   .    .  . .           .  .  . .        .           .       .  .   ..  ..    .    . ..   .    .. ..  .
.  ..    .   ..     .        . .       .   .  .. .    . . . .              .   .     ..  .      .   .. .  .. .       .     .      ..
.  . . . .  .     .  ..  .                           ...     .     .     . . ..  .     .    .  . ..    .       .  .      .   .    ..
. .  .           .. .       .           .   . .           . ..  ..      . . . .. ...  . . .        .   ...      .     ..     ...   .
.  .      ..            ..  .  .. .         ..               . .       .           ..    .      .     . . .   . .    .  .  .    .  .
. ... ..        ..      ..           ..             .      . ..          . .       ...      . . .  .. . .. .     .      .. ..   . ..
.                   ..      . .       .. .    .    .   .    . .         .      ..            ..   .                                .
.            ..  .      .  .            .   .  .  .    .     .    .X . .       .  .    .     ..      .   .   .       ..      .     .
. .       .       .  .   .          .                        .               .        .            .   .  .        .  .       .    .
..    .   ..      .      .          .  .       .                  ..      ..  .      ..       .   . .   .   .. . .  .     .   . . ..
.     .   ...      . .  .       .    .  .           .         . .             .   .     .  ..  .   ..    .   ..      .             .
....................................................................................................................................
