..................................................................................................................
.     ......   . . .... . . ..... .. .   . . . ...      ... .. .. . ..  .    .  ....     ..  .   ... . .. ... .  .
.. . . ..  . .  . X..   ... . .     .... ..  ... ...   ....  ....  . .  .   . .. ... .... .. .  .     .... .. . ..
..... . .    .  .. ..  . . . ..  ......  . .  . .. . ..  . . .  . . .   . .  .. ..   ...... ... ....   . ..      .
.... .. . .  . . ... ...  ....  ... .   .  . .. ...... .. ..  ........ .. ... . .. . .   ...       . ..... .. ....
.  .   .  ... . ..   ..  ... ....   ..   ..    ..    .  .. . . .  . .  ...  ........... .  ... . ..    .       ...
......  . . ...       .. .  .. ...   ....   ..   .. ....   ... ... .   . ..   .   . . .. .  . ..  ..  . .  .. . ..
..................................................................................................................
