..............................................
.  .       . .   .  .     .     .      . X   .
.     .                       .    .  . .    .
.       .   .   . .       . .       ... .    .
. .               .   .      .   .. . .   . ..
.     .   .                         .        .
. .  .    ...    .                           .
.     .   .   . . .                        . .
.             .     .      .             ..  .
.                                    .       .
..............................................
