............................................................................
.   ..   ..... ...   .  .      .  . .  ..   .  .. .  .. . . .   . . ...... .
.  . . .  . .   .. .      .   ..       ..... .....    .......  . ....  .   .
. . .  .. . .  .  . .         .   . . .     .. . . .. ..     . ...  . . .  .
.   .. . .  .....  . .   ..... .      ...  .  .  ...     .     . .  .    . .
...  . ...  . .   . .  .  ..    . .        .. ... . . . . ... . ...    .....
.  .... ..  .. .. .    .... . .     . ... .  ... .. .     ........   ..   ..
..       .   ..  . . .. . ...   .   . .  .     .. ... .   . . ...   .  . ...
. . ... . ... . . ..     ... .   ....     ... . ..   . ..  .  ..... .     ..
.     .    . .  . .  ..  . . ......      ..       .  .   .     ...  ...   ..
..  .   .   ..     . . . .   ... ...    ....   .      .. ..  .      .   .. .
. .    .      ...      . . ........       .. ....  .   .    ......    .. . .
.. .  .. . .   ..  .      .. .  ..    . .   .      ..  ..     .  . ..  .  ..
..      .    . . ..  . . .  .         .   . . . ... ...  ..   ..  ... ..   .
..      ..   ....     . .    ....    .. ..  .  ....      ...    ......   . .
..... ..   ... ..       .   .. .  . ...  . .   ..      ...     .    .  .. ..
. .  . . .  .  ...  ..   .. .  ..  .    . ....  ... ... ..      .. . .. . ..
. . .  ..      .   ..  . . .. .  . ..... .....  ..       .   .. . ..  . .. .
.  .....   ..  . .  .     .  . .  . ..     .. . .. ...    . ..    ..   .   .
..      . .  ..      . .  .    .   .. .  .. .   .  . ..... . .   .   ..  ...
.  . .. .    .. .  .  .. ..  ...   . .     .    ...  ..         .. .. . .  .
..    ...  .     .  .. ..   ..     ....   . .X ... ..   ..    ..    . .    .
.  . .. ..        ..  .. .. . ... .....    .  . .  . . ....   . . .. . .. ..
. ....  ..       ..   .       ..   ...    ....  ..  ..     . .  .    ..... .
..    . ...  .   . . .  .   .  ..  .. .      . .. .     .  .    . .  .   ...
.  .   .   ...  .. .. .. .... .   .  .  .... ..  .  .    . ..    ... .. . ..
............................................................................
