.................................................
.. .   . . .  ..   ..   .  ...          ..     ..
. .        .    . . .. .    .   ..  .. . .   .. .
. . .    .. .   .  .    . .      .      . ..  . .
. ...    .  .          .. .   ......      . .  ..
..  .      ..       . .  . . ..  .   .....    ...
.     . ..  . ....    ..   ...     .      .     .
.  .       . .. . ...    . . .   ..     .   .  ..
. ..    . ....   ..   .    . .    ........      .
.       .  .. .    .    .  .... .  .  .   .    ..
.    .     .    ..  ..      .       ..         ..
.  ......   ..    .    . .        ..       . ....
. .     ..     .     .     ..   .  .   .        .
. . ..  . .     .  X       .   ..       .   ..  .
.    .               . .  .  .     ...   . .    .
. .  .      . .   .  .     . .   . ... ...  .....
.      .     . ...  .   ..      .  ..   .    .. .
.    . .   ..  .   .. .         .  . ..    .   ..
..  ..      .. .  .     .   .   .   .  . .. ... .
.  .. .        . .  . .     ..   ..   ....      .
.................................................
