............
. . .  .  ..
. . .. ... .
.  . . . . .
. .  .    ..
.    .X . ..
...  ...  ..
..... .  ...
.... ...   .
..     .. ..
. ...   .  .
... .. . ...
............
