...................
..  .  ...   .. . .
. . .  .         ..
. X  ..   ..  .   .
..         .... . .
..     .. ...    ..
...................
