..............................................................................................................................................
.     .        .       ...        ..  .      . .   . . ..            .           .  . .   .   .         . . .  . ..       .         .   .    .
..  .     .    ..    .. .   .       .X         ..       .  .           . . . .   .   ..     .          .  .       .. .   .. .    .   . .    ..
.         .. . . .       .    .     .        .    . .  . .      ..         .      .   . .    .   .   .    ...   .            .  .  .  .      .
... .    .      .          .  .  .  .      .     ..     .    . . .    .   . . . ..   .  .   .        ..      .     .    . .   ..  .. .    .  .
.     .                   .. ..   .             ..     .      .  .     . . ..      .     .          . .       .       .   .  .       ...     .
..  .  .          .    ...     .    . ..    .   .. .    .           ..  .     . .  . .  ..  . .     ..   ..    .. ...         .     ..       .
.    .    . .. .       . . .      . ..          ..    ..    .       .    .  ..     ...       .           .   .   ..     ..  ..      .        .
.. .           .    ...  .       .   ...  . ..  .  ..   .. .    ..  .        .    .  .     .  .   .. .   . .        .       .            ..  .
. ...  ..    . ..  .               .   .  .   . .     .     .    ... . .    .  .  .  .       . .   .   .  .  ...    .           ...  .   .   .
.     . .     . ..    .                .  .            .   ..      .     ..    . .      . ....    ...      .       .  . .  .      .  . . . . .
..............................................................................................................................................
