.........................................................
. .. ..   . .  ..   .... .  ..      . . .    .   ..    ..
. .   .  . .   .. .      . ..  . .   . . .   .   .   .  .
. .  .       . .  . .X. .    ... . ..       .   . .  .. .
.........................................................
