....................................................................................................................................................
.      .    .. . .  . .  .      .  .   .  .              .     ..   .... .         .    .    . .     .   .   .      .     ..   ..   .    .      . ..
.      .     . . . .         .  . . .  .       .     .            . .       .                       .          .... .  .  .    .     .             .
.    .   .      .           . .  . .       .  .   .      .    . .            .   .   .          ......           .  .     . . .  .. . . .    .  .  .
..  . .  ..  . . .. .         . ..     .     ... .  .   ..  .  .     .  .  ... . .  ..  .     .   .  .     . .        .    .   .  .       .   . . ..
..                .  .      .   .   ... .   .  . .      . . .  ...  ..     ..         .          .     .     .  .     .   ..      .   ...    .    ..
.    .. .      .   .          .   .      .           .         ..       .. .     .              .        ..  .         ... . .  . ..       .     . .
.          . .  ..    .        ..  ..    . .   . .     ..  .  . .   .   . .   ..  .      ..       .         ..        .   .               .        .
.    .   .    ..      ...    .    . ..      . ..                .. .     .      .          .    . .               .     .       .           .    . .
. .              .         . . .   .   .   .     .      ..  .   ..    .     .        .  .              ... .    .      .       . .   .      .      .
.       .  ..   ..       .         .   .    .     . .. . . .   .  .    . .        .   .        .    ..  .   .      . .  .   .                      .
.  ..   ..      ..        .    . ..  .        ..           ...    . .        . ...   ..   . ..        ..    .    . ..  .       .   . . .  .. .   . .
.            .   .  . .   .   . .  X.   .    .. .   .    . .   .   .      ..  ..     .  . . . . . .      .      .             . .       .   .     ..
.  .         .  ..           . . .     .   ...     .. .   ..  ...  . .      .    .  .    . ...        .   .  .    ..  . .        .   ..            .
.      .. .  .      .   ..              .    .            .  .  .    .. .            .         ...   .        .       .     .    .  .   . ..  . . ..
. ...             .    .        .            .    .         .     .          ..  .  .      ..         .     . .  .. . ... ..      .. .     .    .. .
..    . .        .  . ..   .     ..      .  .   .              ..           . . ..      . . .      .      . . .           .   .    .            .  .
.   . .. .   . ..       .   ..   .    ..              .     ....   .      ..      . . .                  . .       ..      .        .         ...  .
.    .       .  .       .  .       ... .     .   .     . . .     ..   .  .       .         .  .        .  ...  .     . .     .  .    ..    .  ..   .
..        .     . . .       .    . .  .     . .        .   .         . .  .   .      ...  . . .       . . ...   .     .     ..       . . .       . .
....................................................................................................................................................
