........................................................................................................................................
.        ..  .  .   . ..      .  .     ..   .  ..   ...                   ..    .   .            .      .... .      ..     ..    .  .  .
.   .    .        .    .  ..   ...     ...    .        .     .          .     .  .  .        ..    .      .. ... .. .   .  . .      .  .
.     .. ..        .       . .     ..                .           ..          .  ..       .      .       .       .   .               .. .
.  .  .             .            ...          .   .    .          .   .  .           .           . .                 .   . .           .
.              ..   ...   ..               .   ...  .          .     .      . .         ..     .   . .   .   ... .   .     ..  .       .
.. .   ..    .    ...   .      .  ...    .        .   . .             . .   .  .  .   .       .    .  .   .     .         .  .  .     ..
.    .      .           .      .      . ..  .    .   .    ....      .      .        ...     ..  . .  . .    .      . .   . .  .  ...   .
... . . .   .  . .       . .       .      . .    . .     .     .   . .  .             .         .         .     .      .     .        ..
...                 . .              . . ...    . .        . ..   .  .  .  .         . .      .    ..     .  . .                ..    ..
.      ..      X          ..     .   .. .     .      ..  .    .   ..  .  .   . .     . .        .             .  ..    .  .     .     ..
.    .                        ..   .    ..        .              ... .    . .    ...  .  .  ..    . .       .  . .         .    ..   . .
.             ... ...  . . .. .   .  ..   .   .    ..        .  . ..          .   .         . .      . . .   .     .      .   .  ..    .
.  .     ..   . .    .         ..  .   .       .         ..     . .         .                    .   ..   .. .     . ..                .
. .   .  .   .     .    . ..   .        . .       .   . .    ..  ..    . ..                .      .          ..        ...    . ..     .
.    .   .    .  .     ..              .   ..        ..      .      ..     . ..  . .        .      ... .  .         .. .   ..   .   .  .
.      .   ..   .   .  ..    .  ..       .  ..    .         .    . .  . .       .. .. .    .       .. ..    .      .  . ..           . .
...                .  . . .  .             .  .             .     .  .  . ..      . .           .   .               ..  .  . . . . ..  .
...   ..           .      ..           .               .           .           .  .   .    .    .. .   .      .    . .   ..  .       . .
.   .         .. .   . . .   .  . .       .                ..        .            .      . ..  ..      .      .   ..      .  .  . .  . .
........................................................................................................................................
