........................................
...     .. ..  . . ...    .  ..  . ..  .
.... ... ...  .. ... . ... ... .    . ..
.    ..   ..  . ... ..    ... . .... . .
..    .  . .  . .  . .. .  ... ..  .....
.  ... ..    ... .      .. .. .  ... . .
. ..  .  . ... .. ... .     ............
..   .  ..     .. . .   . .. ..    .. ..
...   ....   .... ... . ....  .... .....
.   .. . ...     ............ .  ..   ..
..        . .  .  .   .  .   .. ...  ...
.     ....  .. ...       .   ....  . ...
.  .   .... ...... .. .  .  .. .. . .. .
. .  . .   .. .. . . . . . ......... ...
. .  ....    .    .. .  . .  .  . .. ...
...  .. . .  . .  . . .  .X     ....  ..
...  .    ... .  ..... .   . .  .  . ...
..  . ..  .. .. . ..  .  ... ...    . ..
.  ....   ..  ....  . ....  ..     .. ..
........................................
