....................................................................
.                                                              .   .
..             X                      .           .                .
.             ..            . .                                    .
.      .       .      .      .                     .   .           .
.  .      .            .       ..                .        .      . .
.  .        .       .                    . . .. .           .     ..
....................................................................
