..........
..    . X.
..    . ..
.        .
.   .    .
.       ..
.    .   .
.        .
.       ..
.    . . .
.        .
.        .
.  .    ..
.  .  .  .
.        .
.     .  .
.        .
..   .   .
.        .
.    ... .
.   .   ..
.      . .
.  .     .
.        .
.   . .  .
..........
