...........................................................................................................................................
.        .  ..    . .       .      .    .   . .. ..        .         .     .     ..    .   .     ..     .       .        .    .X    .     .
.              .        .                             .  .     ..     .     . ...     ..  . .. .    .              . .   .    .      . .  .
.   .     .  .    ...  .        .    .  ...         .   ..        .   .    ...     .       ..    .   .  .  .      .      .       .  .  .  .
. . ..  .      .  .   .            .    . .  .  ..        .    .     .             .  .    .  .. .                ..               .    . .
.  .          .  .   ...   . .     ..    .      .       .    . . .  .         .     .                  .    .   .  .   .  .               .
..          .     .. . .     .    .   .    ..  ..  . .    ... .           .           ..  . .      .   .   ..  .   . .                    .
.   .    . . ..  .    .. ..  .  .      .  ..           . .   .. .    .   .   .    .          .    . ..  .    . . .   .    . .  . .        .
...........................................................................................................................................
