.................................................................................................................................................
. . ... .   .  . . .   .. .  .. ..   .  .. .  .....    . . .   .  ..   ....   ..     ..   .  . .   .   ... . ..    ...  .... .... .     ..    . .
. .. . . .....  ..     .    .  ...    .. . ..     ...  . ... .   . .. .   .... . ...   .. .  .  . .    ..  .......    . .. ..X .            . . .
. .. .   . ..    . . .     .....   ... .   ..  .. .     .     ...     . .   .  .... ...   ..   .   .. . ....  .    . .    . . . . ....   ..     .
.................................................................................................................................................
