............
..       . .
.   . X .. .
.   ...    .
.   . ..   .
............
