....................................................................................................
. .      .    .. ....   ...   ..  . .  .    ...  ....  .   . ...  . .  .. .         .. ...   . .  ..
.. ... . .  . ...  .... .  .... ..   .  . . .    ...    .   ..   . . .. ..  . . . .. .  . .  . .   .
...  ..   .    . ...  ...   ..    ......   . . .. .  . . ....     .. .    ..  ... ..      .    ... .
...   .  ... ... . .    . .  . .. .....   . .     ....  .. . .  .  ...     . . .   .  ..     ..  ...
.   ... .     . . ..      .. ... .. .. . .      . . .  ..... .  .. ....    ..   ... .   .   ...  . .
..   . . ..  ......  ... .   .. . .. .   . . . ......   ..  ..  .        .....  .... . ......   .  .
. .. .   .   . .   ... ..... . .  ....   . ..  . ...  .. ..  .  .  ... .... ......   .  .  ..  .. ..
.  . ....  . . ..  ..   ......  .. .... . ........ . .     .....   ....   . ..   ...   ...    .... .
..  .... .... . ..  . ... .. .  .      .. ..     . . . .........    . . . .      . .  ... .... ... .
.. .. . ... . .....      . . .  ....        . ...    .  . . ..  .  .   . ..  .    . . .  .    .. . .
.. ... .   .. .  . .   ..   . ..    ..  . . .  .. .    . ... ..... .   .     . ... ... .   . .  .. .
......     ...  .   . .   .. ..... X.. .  .  . ..........  ..  .   ....  . .  . . .. ....   .. .. ..
..    .  ..   . .. .. .. .  ..  . ..  .. .   . .     ...... ..    . .......  ....    ..    .... .. .
....................................................................................................
