.............................................................................................................
.   . .  . .    ..  ...    .. ...   . ..   . .... . .  ..  .  . .  .  .  .  ....   . .. .    . ..  . . ......
.. ....    .    ...  ..  ... . .. . .   .   ..... .    . .   .. ...  .. ...... ..  . ..  ..   .  . .   .  . .
.    .  . .  .  .. .   .   . .. .... .  ..  ..           .  .. .    ....    . .... .  .    . . .   . .   .. .
...  . .  .  .   .. . .    ....  .   . .  .   . .     .   . .... .. ..       .     ..       .  . .  .....   .
.. . .  . ..   . .. .  ..  .      . .   .   .     ...  ...  ....  ..  .     ..  ..  ..   ... .    .... ...  .
.  ..  ....  . . .  ...    ..    ....  . ...   . . .. . .   .  ..  .  ..... ..    .    . . .    . .. .  . . .
.    ...  . .   .. .....   .  .    ...  ....... .. .. . ..  . .  ......  .  ..    .  .. .. ..   .  .  .  .  .
.   .            ...    . ..   .....  .   .. .    ..    ..    ...       .    .    .  ....  ...  . .  .... ...
.... . . . ...  . . .... .. .  .. . ...  . ...  .. .   ...   .  ..  ...    ..    . ... ....  .   .   .   .  .
... . . ...  ...        . .  .. .   . ..        ..  .  . ..        .... . .... .   .. .    .    .   ..  .....
...   .  ... ....    ...   . .     . . .   ..  ...           ..  ....  .. .. ....    .      .. .  . .   .....
.....   .  . . .   .       .  .. ..    .... .. .    . .   .  .. ..     .... .. .     ....  ... ..    .  . . .
..   . .  ...  ... .  ..   . ....  . . .. .    . .... .    .  .   ..  .. ...  .  . ... .. ...      . .. . . .
.. . ... .... .    .  .....    ...   ..    .. .  .....  . . .... .  ..  . . ...  ... .    ..  .. ..      .  .
.. ... ... ..  . . .   ..... .. .... .. .. . . . .  .. . ......   . ..X.    . . . . . .. .  .     .     .   .
.    . .    .    .   .    ...   .. .....  . ... . .. ...  . .....  .      . ... .. ..    .. .   .    ..   ...
.. .  . . .   .   . .   .. . .   ... . .   .  .  ... ..  ...  ..  .  ...   ........ ... .. .. . ...   .. .  .
.  . .    . .         .  .  .. .. ..      ...    .  .... .. . ...  ...  ..  . .  .   . ... .  ... .    . .. .
.  . . .         ..      . .. . ...      . ..      ....   .  ..  .  .  .  .....       .   ..  .    ...    . .
...  ... .   . .   .... ... ..  .  . .  . ... ..  . ..   ...  .   .......  .  ..      .... .   . . .. .. . ..
.  .     . .  . .. .   ... .  . ..  . . ....         . .  . . . . . .       . ...  .. .   .. ..... .. .  .  .
.  ..   . ... ... . . .  .  .     .. ...... .....    .   .... .... .    ..   .      .... . .  ..      .  . ..
.    ...  .. ..   ..   .   .     ..   ..  .....  .  . .     . ..  .  ..  ... .   ..     . ... ..   .  .  . ..
.... . .    . . . .. .. .  . .     .... ..  . .. ..      .    .   .. ..  ..  ... . .. .   .  .  ...  .  .. ..
.      . .  .  . .  . . .  .. .... ..  .         .  ... .   .  .  ..  . . ........ . . ..      .     .  .  ..
. ..  .  . ..  . .   ........ .  . .  ... . .  ... .   ..   . ... .  .  .. ... ...    ..   .     .... . ..  .
.   .  ..  .   ...  . . ....   . ...    .. . .   ..       . ..  .  . .. .. ...  ...  . ....   . . .. .  .. ..
.............................................................................................................
