.................................
.      .      .            .    .
.    .    . .             .     .
. .  .     .     .     .       ..
.    .          .               .
. .                .   X.       .
.   .             .             .
.................................
