....................................................................................................
.               .           ..    .         .     . . ..    .          .                 .      .  .
.           . . .           . .                                 ..          ..                     .
.                           .                 .                          .     .     .             .
..             ..              .              .                          . ...                     .
.     .                  .   .    ....                .. .  ...         .    .                     .
.                                                           .                ..          .       . .
.    .     ..    .                .              ..              . .         .     ..  . .     .   .
.  .           .                   .    .                     ..               .                   .
. .                            .         . .   . .. ..         .  .   ..      .  X . .         .  ..
.    .                          .       .         .       .                       .   .        ..  .
.    .. .    .                 .         .  ..                    .                  .          .  .
.              .    ..                        ..            .      .       ..          .           .
....................................................................................................
