...................................................................................
...         ..         ...      .      .     .      .     .              .   .    .
.    .          .     .     .    .        .  .X....  . .                 .   . .  .
..                .       .     ..          ..        .           .  .       .    .
.    . .        ..            ..   .      .           .   .    .        .         .
.      .   .  .              .     .          .      .    .   .   .   .      ..   .
...................................................................................
