.............................................................................................................................
. . ... . .  ... .  . .   .  ..   .  . ... ..          .    . .. ...    . . .. .   .  ..    . .   .   .  .    . ..        ...
..        ..     .    . . . ......   ..       .. .  ...       ..  .......  X        .   ..  .. . ..  .        .      . ...  .
. ...    . . .  .    ..    ....     . .    .....  .. ....  .     .  .. ... ..   .. ...  .. ..... . ..   . ..  .. .    ...  ..
..    .   ... .. ..     ....  ...    . ..   ...    ...    .. ....   .    .. . . .. .     ....  .. .  . ..  ....        .   ..
.    . ...   .. ..     ..  .  ..     .. .       .. .  .          .. .   .   . .. .... .  .        .    .. .  .....  ..  .   .
.............................................................................................................................
