.......................................................................
.               .. .    .   ..  ..  .  .    .     .  ..     .   .  .. .
. .     .    . .   .      ..  . ..    . .       .  .      ...   ..   ..
.  ...    .  ..  .  .    .  .. . . .      .          .     .  ...     .
.      .    ..  .  .       .     . .   .. .         ..     .  .  .    .
..       .     .        ..   .  . .   .  .   .       .  ..     X .    .
. . .   . . .   .  . . ..     .  .  .  .  ..    .   .    .  . .       .
. .    .       .               . ...   .   .  .   .  .  . ..  .  .  ...
. .   . .. . .. ..   . ..        .       .. .      .  . . . ..   .. . .
..  . .     . .   ..        ...   . .      ...  .      .  . .  .    . .
. .    ..    . .    ..          .      .       ..  .. .          ...  .
. .  . .     .  . ... ..   . .. .  . .    .. .     .      . . .      ..
. .      .   ..  ..    . . . .  ..    .            . .    .           .
..     .   .       ...   ... .  .    .   . .              .   .    .  .
.  ... .  .    .. . .  .        .. .       . . ..      .       .      .
.   ..      . .   .         . ..      .  .  . ..      ...  . .    ..  .
.     .  .. .      ..   . . ..  ..  ..   ..       .   .            .  .
.......................................................................
