.................................................................................
.. ..    ..  .. . .     ... .. .. ..  ..  .    ..  . .  .   .. .      . .     ...
...... ....     ... .  .....   . . .  .  .  ..   . .    ... ..      .   .   . . .
.  . ...   . ..    ....    .   .  .. .. ..  ...... ..    . ..    . .   ..    . ..
. . ..  . .   ...  . .  . .  ...   .   . . .   .  ...    ..      . . .     . ....
.    . .  .    . . .  . . .     ..    .  . . .. .. .  .              . . ...  ...
.  . .   .   .  .. .. . .   .    . .  ..      . . X.  .   ... .. .. .   .   .  ..
.     .      .    .     ...... ....     . . .. . .  .  ..   .. .    ..          .
....   .  .  . . .  .  ....    .  .     ..  ..  . .. ....    .     .. ..   .    .
. .       . . .. . . .. .    ... . .. . ...         ..   ... . ..    .   ..   . .
..... .     .  .   .  ..  ...      . . . ..  . ...  . .. ...  .         ...  ....
.   .   .. .    .. .... . . .  .   ..  .. .    .   ..    .        .   .    ..   .
.   ... ... .  ..    ..      ... .  .  . .   . . ..     ... ....  .. ... . . .. .
.   .  ..    .      ...     . .... . .  ..     . . .  ..    .  .. ....  . . .   .
.................................................................................
