...............
. . . ... . ...
....  ..   .  .
.    .. . . ...
.   ..     .. .
. . ... .. .. .
. . .  ..     .
. .  .. .. .. .
.  ...    . ...
..  X. .   . ..
....   ..  . ..
..   . . ..   .
..      . ..  .
. .   ..   .  .
..    . .     .
...    .  ... .
..  .   ..   ..
.... .   .   ..
..  .  .. ..  .
...............
