................................
.                        ..  . .
..    .        .               .
.     .       .  .  .        . .
.      ..       .   .   . .    .
.            X             .   .
.       . .  .               . .
..       .                .  . .
.    .         .  .    ..      .
................................
