............................................................................................................................................
.      .  .  .                  ..  ..  . ....  .   .                      ..   . .   . .       ..      ..   .    .      .       .  .      .
.    . .        .     .    .      .                  .  .     .  . . .    .  . ..         . . .        .   . ... .. .   . ... ..  ..  .    .
.  .    .     .    .            .          .  .. . .  . .    . . . X   .         . . .  .       .    . .   .    ..        ..    .      .   .
..      .  .     ..   .. .    .  .      . .    .     .              .   . .       . .   . .    .       .  .   .    ..        . .       .   .
.      .     . .        .     .  .       .    .        ..  .   .     ...  .           .    .  .  ..  .      .     ...     .    .         . .
.      .   .      ..     .          .     .  .  .    ...  ..   .  .  .. .    .         .   .       .  .       .    .         . . .         .
.    .   . ..   . .      ... .       . .        ..  .     . .     . .   . .            .     . .  .             . . ..   ..                .
.. .       . ..    .         .      .       .    .  . .   .         .         ..              .           ...         .     .      . .     .
.     .. ... .        .   .     . ...   .    .         .   . ..    ... .     .. . .. .    .           .     . ..           .      . ..     .
. . .          ... .   .  . .        .  ..     .     . ..    .    .        .  ..  .            .  ..   ....   .   . .                 .    .
.  . .    .     ...  .         .     .               ..  .      . .   ...  .          .  .. .    . .       .   .   ..   .    .   .         .
. ..  ..  .   .    . .  .   .      .    .   . . .   .    . .           .  . ..    .  . . . .        . .     ..  .  ..    .  .     .        .
..   .             .  .  .. . .     . ..   .  .            .  .  .    .   ..          .      .      ... . ..     .   ..   .         .     ..
.          .      .   . ..              ..         ..  .       ..       .. .    ..   . ... .  .      .   .  .   .  ..      .   ..     .  . .
. .   ..    ...              .  .        .       .   .  .   .    .    .  .        .....    .. .. . ..           ..    .  .   .       .     .
.  .      . ..  .      ..             .  .    . . .   .. .    .               .    . ..            .         ...       . .    ...  .. .   ..
...  .     .            ..        . .   .  .               . ..       . . ..    . .. .               .  .     .      .. .          .     . .
. .  . . .               ..                     .  .  .  .    . .   .   .  .            . .         . .                    .            .  .
.      .     . .    .  .    .   . .   .      . .   .      ...     ..            .     .. .     .      ..     .    .            .    ..   . .
.       .  .         ..  .  .   .   ...        .       . .   .   . ..  .    .   .           ..     ..  .             .                  . ..
.           . . .    .  . .                 . .   .        ..              .             .    . .                    .        ..           .
.   ..                        . .          . .. .    . .      ..         .   .   .   .  .. ..        .  .  .   ...   .       . .           .
. .   . .            ..      .          . .. ..   .   ..    ..       .      .  . .      .     .    .   ..      .   .        .           .. .
.   .  ...    ..  .      .       .  ..  .    .  . .  .. .  .      . .  .   ..    .  .  . .      .   ..     .      .  .    .      .       . .
.   ..             ..          .          ..       . . ..      . .  ..   .      . . .    . .    .     . .        ...                       .
. .   . .. ..               .    ....     ..    . .            . .   .     ..   .   .      .  . . ...    . .    .  .. .    ..   . .   .    .
.   .  .         .. .     .    .. .. .     .  .           ..    .  .    . . ..   .....      .      .. . ..         .. .    . . .     .   ...
............................................................................................................................................
