.........................................................................................................................................
. ..         .    .  .   ...           . ...   .      .    . ...      . . ..  .  ..       . X    .  .  ..               .  .  .  .      .
.      .       .   .   ..      ..  .       . ..  .  .. .   .. .  .   . .   ... . .. ...     . ... .  ..   . .       . . .   ..    .    ..
.    .       .         ..         .            . . .     ....   ..      ....    .   .  .          .     ..    .. .  . .  ..... . .      .
. .     ..   ..  ... ... .  ... .  . . . ... . .   .   ....  .  ..    .       .  .       .  ..... .   . ..   ..  ...   .  .  .    .  .. .
..  ...     .  ....    ..  ..  . .   .  .  ..  .   .    .. ..     . . .   . . . .      . ...  .       .  .  . ..   .    . ...     . .  ..
.  ... . ... .   . .. ..   .    .       .  ..    .     . .    . ...      .  .  .      .   .... .  ... . ...  .   . . ..  .    ....     ..
.........................................................................................................................................
