............................................
. .    ... . .    .  ......... .  .  .    ..
.     . .   ...  ..     . .  .. . .     . ..
.   . . ..   .. . ...  .   .  X ... ..  .. .
............................................
