............................................................................................................
. ...   . .. ..  ....  .   . . ..   . ... .  . ...  ..   .   ..  ......  .   .    .   .. . .  .   ..  . . ..
.. .. .. ......  .. ..       ..  ... .. .    . .. .  .    ...... .    .. .      ....... .   ...   ....  ....
.   . . .    .  ..      ... . ... .  .. .    ...  .  . .. . .. .  . ...  .. .. ..  . . .......... . . .... .
. .  ...  . ...   .. .....  . ....   ..  .  ..... ..   ...  . ..   .   . ...  . . .... ..  ..   ... .  .....
. .  . . . . .  .... .  ..... .  ....  .........   ..   .... ....  . ..  ..........   .   ...   .  ..... . .
....  .  . ..... .     .  ... . . .   .  . . . .. . . ......   ....   . ....   . .. ....  ...   . .  .  . ..
. ..  ... . .  ..     . ... . . .. .. ...  .. .  ... ...... . .. ..  ... .  .  ...  . .   .... . . .. .  ...
...... .  . . .   .... ...      ...   .. .. .....   ... . .. .. .... ... ...    .   ..     .....  .   .  ...
.  ..... X . . ...   .. . . .    .  ... .. ... ..       ...   .  .   ...... ..  . ... . . . . .  .. . .... .
... . ..  . .  ..    . ..  . .    .. . .. . . . ... ..  . .     .. ..    .    ....    . ........  ........ .
.....  ..  .  . . ..    .. .    ..  .. ....  .....    .. . . .        . .. . .    ..   .   . .. .  ...   ...
..  .. . .....  ......    ... .... .  .    ... ...  ...    . .. . .    .  .   ...  .. ...   . ..   .... ....
..   .. ... . . ..  ... ... ...    ... . . .. . .  .   .  ...... ...  . .. . .   .    .    .  .. .....  . ..
... .   . ... . .. .  . . ...... . . .... . . ... .   .   .. . .   .. . . . .    . ..       .. . ... .   ...
..  . . . .  ...    . ..  . .... .  .. . ...   .  . . ...  .     ..  ... ...   .. ... . .....  ..  ... ..  .
..  ..     .   ... . ...  .....  ..  ....  ..   . .. . ... . ........ . ....  ..   .. .. .     .   . .. .. .
..     .... .      .   ... . .. .. .  .  ....  .. .  .   .. . .... . ....  ... . ... .....    .   .   ...  .
. .  .. ......  .   ..  ..  ...    ......    ..   .  ... ...  .. ... ... .   ..... .  ....  . . . .    . . .
.  ..  .. .. . .  .  .   ... . .   .. . ...  ..   ..  . ..    . .      . ....  . ..   .     .  .  . . ...  .
... .   .  .. ...  .  ......    ... ..  ... . . ....   ..   .....  ...  .. . .. .    .. . . . .    .  ... ..
.. .. .  . .. ... . .. ... .   . .... ..  . .  .  ... .   . . ... . .... .  .  .. .  .... . ..  .. .. .   ..
.. . . .   ...... ...... ...  .. .........    . ..  ..  . . .     .   . .. . .. . .   ... .  . ... .   ..  .
.. . .  ..  . .  . .. .  ...   .. .  ... ... ..  ..   .  ....  .. ....   ... ..  . ..   . .... . ..   ...  .
. .  .   .        .  . ......... .  .  ... .... .     . ...  .....  .. .    . .. . ..       ......     . ...
.... .      .. .  ....   . .  . . . . .   .....  . .....  ..  .  .  .... . .     . .  ..    .  ..  .  ...  .
............................................................................................................
