................................................................
..   .   . .  ...   . .    .   ..    .. .. .  .  . .     .   . .
.     . .  . .     .   .    .  .. .  . ..   . ...  .  . .      .
.   ..  .     .  .     ..        ..  ..     . . .            . .
..         . .         . .  . . ..  .   .     .        ...  .  .
.  .         ..  . ..                   .  .... . ..... .     ..
..      ..           ..       .  .      .      ...       ..    .
.. .        .  ..    .    . ..  .          .  ...     .  .     .
....   .  .   . . .  . .. .                  .           .   . .
.  . .     .  . .           ..   ....  ...    .    . .  . ..   .
.    ... .    .     . .  . .   ..  ...  .    .    . .    . .   .
. ..  . ..   .  ... .           ...            ... .. .    .   .
..  .    .      . .  . . .    .   .. ....      .....      .    .
..    .           .. . ...      .    ...             .     .. ..
.      X  .. ...  .    .   .... .....  ..                . . ...
. .... .       ..     .. . ..     .   ... ...     .            .
.      . ........  .     ..   .  .   . ..       .      .       .
.   . .. .  .     ..  ..      . .. .   ....    . ..  .. .  .   .
.. ..          .. ..   . ..          .. ... .   .. .      .    .
..      .    ....      . .    .   . .          .     ..    .. ..
. .         ..         .... .. .   .. ..    . . .   . .   . . ..
.    ..  . .    .     .      .     .   .   . .         .     . .
.  .   ..  .    . ..  ..     . .. .  .   ...  .   . .    .     .
..       .     . .         .  . .    ..  .   .      .. ...   . .
.    ..  .     ..     .  .  . .   .    .       .    .     .   ..
................................................................
