...........
. .      ..
.  X      .
.         .
.         .
.        ..
.       . .
...........
