....................................................................................
.         . ..                           .                                         .
.        .          .                 .                       .                    .
.     .    .          X .        ..        .                     .    .    .       .
.               .  .                        ..                    .    .      .    .
....................................................................................
