........................................
.. .. .. . . .    .    .. ...   .... ...
.. .       .. ..   .   .        .     ..
. .. .  . ..X  ..          .    ...   ..
. ...     .  ..      .. .     . ..   . .
.  .    ..  . .  .    .   . ..   .   ...
.   .   .   .....   .. . ..  . .   . . .
.. ..  ...     .  . . .   .   . ..  .  .
.    .   . . ..      .   .  .    .   . .
.      ... . . .  . ..     .  . ...   ..
.   . .     ....  . ..  .   ..  .. .   .
..  .    .... . .  .  .   .       .. . .
. .  .     . .  .... . .. .  ...    . ..
..        ..       .  ..     ... .. ....
.   .  ...   .   . .   .     . . ..    .
.   .   ...  ..  .   ...    .  . .  .  .
..  .  . ..      .    .              . .
.  .. ..     .   ..      .       ..  ...
.   ... .    . .. . . .             .. .
.     .       .    .    .  .....  ...  .
.   .  .          . .  .            .  .
.  .. . .. .   .    .. . .        .. ...
. . ..   .. ...    ... .. . .  . .  ....
.       ..  . .. .  ..   .  . .  . .   .
.  . ..   .  .  ..   . . ..   . .      .
.   ...    ..     ..  ..   ..  .      ..
........................................
