.........................
... . . .     .     .....
.... .   . . . .. .  . ..
.   ..  .   ...  . .  . .
.  ....  ...  . .. . .. .
. . . . .  .  . .... ....
... ...  .     ...  .....
.   .      .... .  .    .
. .. .  .  . .. . .   . .
.....  .. .. .  ..  . ...
.... ..    .    .  .    .
...      .  . ..... .. ..
.. ....  .... .. .....  .
.......  .  .. . .  . ...
. . ..       .   .. .....
.       . .   .. . .   ..
.. . .   ..  ...... . . .
.   . X . . ... .  . .  .
.... .. .   ..   . .. . .
. . . ....  ... . .... ..
.  ....   .. ...  .. ....
......  ....   . . ... ..
. .   ..  ..  . ..... ...
.. ... . .... ...   .   .
.........................
