..........................................................
. . .                              .         .   ..      .
.       .                                                .
.    ..            .                     .      ..  .    .
.         .         .              .             .  .    .
..   .    .   .              .  . ..      .       .     ..
.           .               .                 .  .       .
.     .                              . .       X         .
.       .     .    ..  .         .                      ..
.         . .     .   .   .                      .       .
.             ..   .     .            .  .     .         .
.    .                      .   .   .               .    .
.             .                    .                   ...
.                .                  .          .         .
..   .        .         .          ..  . .               .
.  .        .           .         ..               .     .
.                                   .    ..     .        .
.        .                                          .    .
.              .                                      .  .
.         . ..         .         .             .         .
.        . .             .       .   .     .    .        .
.     ..  .   .   .       .  .         .     .   .       .
..........................................................
