..........................................................................................................................
.   .            .                                 .                                          .                          .
..                           .       .  .    X                                              .                            .
..                                                           .            .       .                         .   .        .
.  . .         .                 .       .                                                                .              .
.                                                     .                 . .          .              .       .    .       .
..........................................................................................................................
