..................................................................
. .       . ...    .       ..  . . .                      . ..   .
.   .     ..        . .  .     .    .      ..  .     . ..  .   . .
.     .    .    .  .    . .          .      .                    .
.      .      .. .    .        . .  .         .  .           . . .
.   .  ..  .        ...                .      .   .     .        .
.              .       .  .    ..        .   ...    .      .   . .
..  .    .   .       .. .       .   . .   .  ..           .      .
. . .      . .  .           ..  .  ...   ..  ..              .   .
.  .    .      .  . . .          ..       ..      .          .  ..
.    . .  ..     .           .      .        .  .           X .  .
...   . .   .. .             .      .   .   . .  .   .           .
.         . .          .  .    .       ..  .  ..    .  .     . . .
.    .  .   .    .             .      ..      . .    .      ..   .
.          .              ..    ..    .    .    .     .          .
. .   .      .            . .        .            . .        ..  .
.   .   .  .   .      ....   .   .     .  .         .     .      .
.   ...  .    . . . .    . .     .  . . ...         .        .   .
. .    .             .       ..       .       .         .        .
.    .     .     . .    .  .    .     . ..       .         .   ...
..................................................................
