..................................
. ..   ..        . .  .  ...     .
.  .   .    ...   ...      .    ..
.  . ..   . ....    ...  .. .   ..
.. ..  . .. .. .  ..       .. . ..
. .... ..     ..  ..    .    ..  .
.  ..   .. .   .     . .  .     ..
. ..       ... ...   . ...  . .. .
. ...   .    . .    .    .       .
.. . .   .      ... ..   . .     .
. .  . .    . . .   .     .  . ...
. ... .  .  ..      .  ...  .   ..
.... .... ..  . ...      .      ..
..  .    .  . . . ....  .   .. . .
.. .     .. .  ..     .   .  . . .
.  ... ..   ..     .   .... .    .
. .. .  .. ..    ...  .  .  . .. .
.       . .  ..  . .      .      .
..  .  .    .  ..    .   . ...   .
.    .     .  .. ..... .    .    .
...     .          ..     . .  ...
...   .   ..   . . . . ..  .  . ..
..      .   .  .   . .  .. .  X ..
.       .   ..  ... ...  ..   .  .
.  .        .     . .        ... .
.        ..  .  ..   .  ..       .
.....  . .   .. .. . .    ...  . .
.   .    .... ..    ...  ....  . .
.        .. . ..      .  . ...   .
..................................
