.......................................................................
.      .  .           .    .                                          .
.       .       .    .                     .        .   .   .         .
.                                               .        .            .
...           .                       ..                             ..
.                             .    .                                  .
. .      .                  .    .             ..  .          .       .
.  .                                      .    .        .    .     .  .
.                           . .                . .             .   .  .
.     . .                                ...       ..    .            .
.      .                     .           . .      .   .  .            .
.                       ..    .    .               . .                .
.                                 .           .     .        .    .   .
.               .           .  .          .                . .        .
.   ..                    .       .                               .   .
.       .       .        .                                   .        .
.        .             .             .     .           .        .     .
.  .                     ..    .                         .      .    ..
.                .             .                    X                ..
.         .        .        .                                         .
.                        .                                    .       .
..                                       .                            .
.             .        .   .                                        . .
.   ..    .                            . .    .        .       . ..   .
.                 .  . .                .                ..           .
. .                                            .             .     . ..
.......................................................................
