...................................................................................................................
.          .       .                 .      .     .                 .   . . .     .  .                           ..
..             . .        .       .. .         .         .              .         .       .        .          .   .
.   . .                       .       .  . .           .  .. .      .           . .        .          ..    .     .
.                     .       . .  ..          .                ..   .   .   .     .     .    .   . .       .     .
.      .      ...      .    .         .     .        .                        ..   .   .           .           .  .
.       .           .                .                 .    .   .         .  .X          .       .     . .. .    ..
.                    .   ..               ..     .   .           .              ..                      ..        .
.      .             .     .   .          .        .  . .. .          ..      .   . ..  .         ..              .
.  .   .                .     .   .        . .   .            .  .. ..    . .                      .  .      .    .
.   .  ..   .  .                .   .           .            .      .   .              .   . ..          ..   .  ..
. .  .     .         .    . ..    .                                     .  .      .     .      .   .    . .       .
..                  . ...    .   ..      .         .     ...        .   .                               .         .
.....    .                       .                   .         .             .     .           .          .       .
.           . ..  .                    .  .            ..      .     ..    .     .         .  .   .  .         .  .
..         .     .                   .         ..     .        ..       .             .               .           .
.              .     .  .      .  ...   .. .    .           .         .                         .      .     .    .
.       .                    .  ..                      ..   . .             ..      .        .   .  .        .   .
.             .               ..            .     .                          .       . .   .        .  .  .       .
..         .     .              .      .  .                    ..                     . .   .            ...      .
.                                .             .     . .   .      .    . .     .   .    .           .      ..     .
.    .      .     ..        .   .         . .     .. .            .           . . .         ..                 .. .
.   . .  .                  .           .            .   .     .    .              .       .               . .  . .
.              .    . .  . .       .                         .   .   .              ..           .        .    .  .
.   .       .                  .. .           ..         . .   .      .       . .   .                     .       .
.               .           .      ..    .  ..    .         .                 .               .  .                .
..     .          .                      . .           .                    ..           ..        . ..  .  .     .
..        .               .       . .        ...       .  . .        .                      .  .        .         .
.       .           .    .     ...     .                  . .     .   . ..               .         .   .          .
...................................................................................................................
