............................
.  .     .     .   ... . ...
..  ..    . .  .  . . . . ..
.         ..        . .   ..
.     .  . .   .   . . .. ..
. . .            .  .. . . .
...     .  ...X. ...  .    .
..   . . . .  . .     .    .
..    ..  .   . ..      .  .
..  .. .    .    .         .
.. . ..   .... .          ..
.  .. . ... .   ..  .. ... .
.   .  .  .   .     .. .  ..
. . . .. .   .  ..         .
.  .    ..  ..    .  .  .  .
. ...  ..  . . ..   .   .. .
.    . .. .  .  .     . .. .
.. .  .    ..  ...  .    . .
..      .      ...    .. . .
............................
