..................................................................................................................
.                                                                                    .    .                 .    .
.          .                      .        .                                                        .            .
.   .               .     .        . .      .                  .                         .                    .  .
.              .    .                              ..                    .                     .         ..      .
.                    .                                 .         . .   . .                        .              .
.                                                   .                          .                          .      .
.         .         .   .   .                                        .           .                               .
.                       ..                                             .                   .         .        .  .
.           .                 . .                    .            .            .                    . .          .
.                          . .         .                                               .                         .
.                .              .                          .                       .           .             .   .
. .                .        .                      .            .                                   .    .       .
.                                                                       .                                        .
.   .    .          .       .                          .             .      .        .                .   .      .
.            .            .         .                      .          .   .                                      .
.                 .     .                      .                                                                 .
.          .                                        .      .  .   .     .    .    .          .      .       .   ..
.                                                         .                               .        .          .  .
.    .                .                  .   .       .     .            .     .     .           .                .
.     .  .   .     ... .                   . .                     .                 .          .           .    .
..          .                   X                                       .                                        .
.    .          .      .         .                                 . .                                           .
..................................................................................................................
