...............................
.. ..... . .   .. .. ... . .. .
...       . .   .. .  . .......
... ... .    .  ... ..   .    .
..... . ..  .. .       ...... .
.  . .     . .  ..    .....   .
.. ... ..... ... . . .....  . .
.  . .... . ..  ..    .    .. .
.   . . . .   . . ...   .  .  .
. .  . .     .   .. ... .. . ..
. .   .. .... . . .   ... .X. .
. ..... .    . ... ..   ..  ...
.. .    .  ...  ... .    . .  .
..     ..   .        .    .....
...     ....... .. .  .. .    .
. .  . . .. .  .. ... . ... . .
.  ..  .... . ... .   ....  . .
..  . . .    . ...   .. .... ..
...............................
