..............................................................................................
.    .         . .    .   .        .     . ... .    .                  .    ..  .      .  . ..
.      .     .                ..                                              X .     .     ..
.     ..   . .            .  .       .    .           .       .    .       .                 .
.    .          .  .                   .    .        ..                                ..  . .
..     .                                .         .    .   ..   .              .             .
.      .            .          .       ..  .  .     .   .  ..      .           .        .    .
.       .             .        .      .      .      .               .  .      . ..           .
.    .   . .               .       .   .    .. .    .  .. .        .  .      .     .      .  .
...   .      .        .                                  .               .   .             . .
..............................................................................................
