................
.X      .  .. ..
.  .    ..     .
..   .         .
................
