................
..    ....   ...
. .   .. .. .. .
... . ...   ....
. .. ....   .  .
.....   .....  .
..    .  . . . .
.      ...   ...
.   .   .... . .
.. ..    .. ....
. .  ...   . ...
...  .   ... ...
.. . .X ... ....
. . ... .... ...
..       ...   .
................
