.........................
.   .                   .
.    .            .   . .
.    .      .           .
.        .   . .        .
.  .   .  .             .
.                       .
.                       .
.    ..                 .
.          ...          .
. .    .   .  .     .   .
.                      ..
.     ..       .        .
.   .  .                .
.  .   .       .        .
.            .  X       .
. .     .     .    .. . .
..       .     . . .  . .
.                       .
. .                     .
.  .              ..    .
.             .         .
.          .            .
. .         .  .  .     .
.........................
