...........................................................................................................
.     .                       .                 .                        .        .                       .
.                    X                                  . .       .     .       .                .        .
. .                              .                                              ..             .   .. .   .
.. . .                                                  .                .                .               .
.      .           .           .                               .   ..  .    .                  . .        .
...........................................................................................................
