..............................................................................
. . .  .    . .  . .. .....  . ..... . ....  ....   ..   . ... ...  .    ..  .
. ...... . . ...... . .   .X.     .. ..   .. .     .. ...   .  ...... .  .   .
. .. ..  .. ..  .... ..   .  ...    .. .. .  . . ..  .....    ... . .. ...  ..
. ......... .. .. .. .  ...   ..... ..  ....     ....  ....   ..    .   ..   .
.  . . . ........ ... ... .. . ..   .... ..   ... ..   .  .      .    ...  ...
... ... ... .      ..  .   .         .. .      . ... .. .. ..   . ....... .  .
... .   .     ..... .. .. ...    .  . . ..... . .. .. ...    . .  ...  .  ....
. . . . . .  . .    .  .  .  ..  .  .........  .. . .  . ... .      ...    ...
...   .  .    .  ..   . . ... ..     .... .   ..    . .  .. ..  . .   .  .....
..............................................................................
