..............................................................................................................................
. . .  . ... . ..   ... .. . . .. ... ......  . . .. .   .   ...  ... ..      ...  ..  . .. .  .. . .     . . . ...         ..
. ...   ..    .   . ..... .....  ...  .          ..   ..  . . . . . .   ..... ....  . . ...    .... ...      .. . .      ..  .
.... .  ..    .. ...    ..  .. ..   .   .  ....  .  .. .    .    . ...   . . . ..  . . .   .... . . . ...  ... ..     . ..   .
.      .        .... .. . . .    ..... .... .  .   . ...  ..    ..      . .     ......  . ..  ..  . . .    .  ...  ..  .. .. .
. . . .   ... . .. ....      .. .  ..      .....  .      ..... ..  .  . .. .. ..   .     . . .. ..    .      . .... .. ..   ..
...  . .     .. .   . .     . . . .  .  . .  .      ..    ... .  ..  . .   . ...  . .... .    ..  ....  .... .......    ..  ..
. . .  .. .. ..   ...    . ... ...      .   ..... ..  .  ....  . .. .    ...   .  . ..... . ....  . . .. .. . .  . ...   . . .
..   . .     ... . .. .     . .. . . . .  . .....  .       ...     .. . ..   . ...   . .   ..  . .  .... ..  .   ...  ...  . .
...  ..  . .  ......  ...  . ..   .   .... ...       . . . . .. .   . .. .. . ...  ....   .    ...   .  .....     .      . . .
.. .  .   .   ..   .. ..  .. .. . . . ..       .   ... ..  .... .    ... .   .. ..    . . .... .   . . .... . . .   .  . .   .
... X.. . ..   . .. .   .    .  .. . .  .     .... ... .  ..  . ..   .   . ...... ..... .... ..... .. ...  .. ...  ...     . .
..  ...  . .    .     .. .  ..  .. .   .   ...  . ..    .. . ..   . .    ........    ... . .  .. .  ... ...... . .. ..... ....
..  .. .  ..   ... ...  .. . .   .  ......  .  .  .  ..   . .. . .  . ...   . . ..  .  .. .. .   .      ..... . ..         ...
.. .  .... .    .   ..  . .  .  .     .  ...  . .     . . .   .. .    . ....    ... . . . . . .  .      ...  ...... .. .   . .
.  .  ...  . ..  ...       . . .   ... .. .. . .. .   .... . ....  ...  .    .  .  .  . ..    .. .. .  . . .....  ...   . . ..
... .  .   .  .    .... .  .. ..    ...     .  ...  ..   . .  . .           .  ....    ..   ..   ... ..  .  ...  ..    . . ...
. ... .. .    ..  .. .. ....    ..  ...   ..   .  ..   .  .   ..... .. .   .   ..... ..... .  .   ...   ...     .. .   .. ....
.  .. ..  .. . .   ...  . ... .   .    ..   .... .     . . .    .. . .  ..  . .   ... . ...       ..      .. .. .   .. ...  ..
..............................................................................................................................
