.....................................................................................
.   .  . ..     .   .. .. .  .   ... .  .  ..   .   .  . . ...     . ...  ...      ..
.. .   .  .  .   . .    ...... .. ..   .    ...   ... . .  .X  . .. . . . .  . .  ...
.    ... .      .     . .. .   .. .  .    .    . .....  .    .        . .   ..    . .
.... .  . . .. .  .    .....      .    . .....  ....  ..   .  .        . .   . .  . .
.....................................................................................
