......................................................................................................
.     . .  ..  . .         . . ..      . .       ..       . .        ..       .            .       ...
..         . .  . .        ..    .  .     .     . .      .  .    .   .   .X  .   .   ...  ...        .
.   .       .     .      ..    .        ..       .    .         . .       . ..       .   .   . . ..  .
......................................................................................................
