........................
.              .  X    .
.       ..   .  .   .  .
....      .            .
.        ..   .        .
.   .             .   ..
........................
