............................
.  .          .            .
.                          .
.    X.           .        .
.        .     .           .
.             .  ..        .
.                          .
.                          .
.    .                     .
.                          .
.                          .
............................
