.........................................
.  .   ..  . .       .. .     .. . .  ...
. .  ..X .    .  .     ...       ...    .
.   .. .  . .  .  .  .. . .   .      .  .
..  .  .   ..  ..  .        ..   . .    .
.    . .... .      .. . .    ..  .. .....
. .     .. .  . .   . . .    .      . ...
....  .  .  . ....   .. . .. ... .   .  .
.........................................
