..................
.  .....   . .....
. . ...  .. . . ..
.. .. .     ......
... ...... . .   .
. .      ... .....
.. . . .  ..... ..
.....     . .  ...
.     ........  ..
.. .. . . ... .  .
. .. ..   .... ...
.. . .   ... .  ..
....  .. . .     .
.     .    .  .  .
..    . . . .   ..
.. . . .   . . . .
. ...  .. .. .....
. ..  .     .. ...
.. .. .. ... .. ..
.. .  ..  . .... .
..     .   . .. ..
.    .. . .... ...
. .. ..  .. ... ..
. . . .   ..  .X..
... .   ... . . ..
.   .    ..  .  ..
. ... . .. .......
..................
