...............................................................................................................
.. . . .    . . .. .. .. ..  . . ...   ... . .. .... ..   . ....   . ..  . . ..    .  ..... . . . ...      .  .
.. . .      . .. .  . . ...  ....  . ...  ... .. . ..  .  . ..  ... ...  . .. ....  ...   ..   ...  ..... ... .
..  . ...  .. ......    .       .   . ... ..   .. .  . ...  . .  .. ..  . .  ........ X  .  ..        .       .
...............................................................................................................
