...........................................................
.   .   .    ...  .   . ...    .   ..    .    . .     . . .
.. .          .     ..    .  .      X .... .  .    . .  . .
.   .. . .        .       .. .    ..        ....     .   ..
..    .        .           .. ..    . . .      . .  ...   .
.      .      .. .  ...  .       ... ...... .    .     .  .
.       .  .  .. .  ..    .    .. .   .    .  .  .   ..   .
.  .  .. .     . .  .. .  .    .   .  .   ..       .     ..
.. .  ..   .      .                 .           .  .    . .
...   .  ...  .   .. . . .  .... ...   ..  .  .   .       .
...........................................................
