.......................
..  ..   ....... . ....
.... ..  .   ... .   ..
. .  ..    ..      .. .
. . . .....  . .. .. ..
. .. .   .           ..
.    .. .     .  . .  .
..  ......  .        ..
.  .. . .. . ...  .   .
.   ..  .    .  ... . .
.  ..   .  .... .   . .
..  .. .   ...   .  ...
.  .. ...  .  . .    ..
.   ...     .      .  .
.    . ..      ....   .
.. .    .. ..  . ..  ..
.   .    . . . .  .   .
...     .     . ....  .
.    .               ..
..   . . .     ... .  .
..     .      .. .    .
.  . .    .  .. ....  .
..   .  . ... .     ...
...  .  ..       ...  .
. .      .  . .  .. . .
. .. .       . . .... .
.    ..  . .. .   .   .
. .  X.  .  . .    .. .
... . ..   .     .... .
.......................
