...........................................................................................
.  .    .  . .      .          .    .     ..  .      . . .. .    .    ...    .  ...     . .
.  .            .  ..  .    .   .       .. .  .  ..     .   . .       ..    . .   .     . .
.   ... .  .         .    .  .             .       . .     .    . .       .           .  ..
. .         .     . ..  .    .     . .    . .  .       .      .  .          . .  ..  .    .
..  .. ..  .       .         . ..     .         ..  ..  .       . .       . . . . . ..  . .
. . . . ..     .    ..    .    .      ..             . .....     X     .        .  . .    .
..  .    .  ..       ..      .. .       ..  ..   .   .      ..   ....  .   . ...       .. .
.  . .    .         .        .     .. ... .    . .             . .   .  ...   .         . .
...........................................................................................
