......................................
.  . .. ... .   . ..  . .       ... ..
.  .      ..    ...    .  .      .   .
.   .      ..  .   . .   .. ...     ..
.   ..   .. . .  ...    ...   .    . .
.     .X.. .         ... .  .   .  . .
......................................
