...................................................
.    .   ..       . .                             .
. .                      .      ..               ..
.  .     ..                . .                    .
.    .  .                               .    ..   .
.              ...             .    .. ..         .
. .               .            .           .     ..
..         .        .                             .
.      .                        .      .          .
.                   .  .    .  .              .   .
.                        .                      . .
..       .                             .          .
..                            .              ...  .
.   . .                  . ..    ..      .        .
..    .  .                . ..      .  .  .   .  ..
.         .        .       .                      .
.            .     X                 .   .        .
...................................................
