..................................................................................................................................................
.   . .. .   ..   .   . .. ... . .. . ...  . ..  ...    .. .... ....    . .. .  . .  ..  . .. ...   .   .  ...  ..  . ...   . ..  ... . .   .    .
.  ......  .   . ....    . .. .  .. .   .  ... .      ...   ...   .  .  .    .... ... ..   .  .. .      . .  . ........ .    . .   .   .  .      .
.  .. ..  . .  ...  . ........ .. ...    .. .    ...  ...... .  . ..    .  ..   . .  .  .  .... .. .. ..  . ..  . . ....        ...  .  .. . . . .
.. ....  ....   . .... ..  .  .     . . X ..    . .. ..        .. . .  .. ..  ..  .. .    .. ..    ..... . . .. . .. . ... ..  ....  .   .... ....
.      . ..   .    .. ..   .      .  .. . .. . . .   .   ... . . ..... ..         .  . .. . . .. . ...  . ..  .. . ..   ..     ..   .. ..... .  ..
... .... .   . .  . . . . .      . . .. ..     .  ..  ..  .   .. .  ... .      . . . .. ...  . ..     .. . .       ..        . . .    . .   .    .
.   . . .. ...    .       .    . ...       .  . ...          . . .  .    .     . .. .....   . ..  . ..  . .  ..  . .... .. .    ..  .   ..  ......
. . ...   .   ...   ..   .. ...     .    .. .... .     .   . .. .. .. . ...   ... . . ...  .    ...  .. .  .. .   .    .     ...   .     ..   .  .
. ......   .. .... ...    ..  ....  .....   .  .    .. .  ... ..... . . .     ..   . ... .. ...  ...   .   ...           ..  . .  ..  ..     . ...
.  .  .   ... .  ...  .       . .  . .... . .  ..   .  .. ...    . .    .     . .  . ..  .... .    .. .  ..  ......  . .   . .      ..... .  .   .
..            .  . ...  .  .. . ..  . .. .... ...  ..       . .  .  ..  . .   .  ...   . .  . ...       ....       .. .....   .. ....      ... . .
.. ...   .  ...      . .    .  .. . ..   ..  .   . . ... .     ...    .  ...        .     . ..  .  . . .  .. .. .   ....  .   .  .  ..... ...  . .
.     . ... . ..   . .  ... . .     .     ..   .. .  . ..  ....   ....   ...  ...  . ... . .   ...... . .  ..  .. . .   . ...   .  . .    .....  .
.. ....  . ....  ..  .  .    .  . . .....   .   .     ... . .    . .   . . . . .. . .   .. .  ..    . .    . .. .  . ...  ..   ..  ... . .   .   .
..       .. .    .   .. ..    ..      . .    ....    .    ..  .  .  .. . ..   .....   .. ...... .  .   . ..  .  ..   ...    .   . ..   .  .   .. .
...     ..        . ...      .. . .  .. ..  .. ..   ...  .. .    .     .... ....      .  . .  .. . .  .. .  .  . .    .     .  .. .   ...     .  .
.... ..   .       ..  . .    ...      . ...  .. .  .  .  .     . . .  .    ...    ...  ..  .. .  ...  . .......   .... .  .    . ...  ....   .....
.  ... .  . . .  .   .. .  ..  . .... ... ....  . ..  ...   .  . . ..   .    ..  .. .. ..... .  .   . .    .. .. .   .   ...  ..    . . . ..    ..
..................................................................................................................................................
