..................................
.. .      . .. .... .     .   .  .
.. ..  . . .  .    .       .  .  .
.      .  . .   .. ..  ...  .. . .
..  X .    .    . ..   . .     . .
. .     .... .    .  .      .  . .
.  . . . ..  ..          . .  .  .
..    . ....  .  ..   .... ..   ..
.. .   . ..   .      . .       . .
.   ..   .   ..    .. . ..  .... .
. .. ...    .  .  .    . ... . . .
.  .... ..  ..     .     . .  .. .
.  ....    ...  .  ..           ..
.. .    .. ..  .      .. ...     .
...     . ..  .    .... ..  .   ..
.   .. .. .    . .   . .   .   . .
..    .  .   .........   . . .....
.       ..      ..    . . .  .. ..
.    .  . .. .   .    ..    . .  .
. .    .   .      .  ..         ..
.  . .      .... .. . .  ... . . .
. .. ..    .. .   .    .   .  . ..
..................................
