......................................................................................................................................
. .      . .  . .. .      .    .  . .  . .. . ..    .  .  .....  ...   .  .  .....        .  .. .   . ... . .  ....     .. ....  . . .
. ..  ..         .  .. .  .. .         .  ..   .   . .        ... .. .      . ....   . .      .    ...   . ....   ...   .   .     .  .
. .. .   ..     .    . ..     .     .. ......    .   . ..  .     . .. .... .  .  ...    ... ..      ..  ..  . .. .  .   ..      . .  .
...  .       ..     .   .           . .      .   ... ....   .         .  .     . ... . ..       . .  . .  . .      .      . ... .    .
.. . ...   . .  .  .  . . .    .  . .     ...   ..  .   . ...  . .   .    .        . .  .  .. .  .  .. .   . .  ..  . ....    .   .  .
. .. ....     . ......      . .. .....   .  .   .  .. . . ..     .    .   . .      . .. .  .... . .....  .      .     .  .     . ..  .
.   . .. . .. .. ...  ..  ..  ..  ..   . . .   .  . . ...     .. .  .. . .   .. .. ..     .     .       .  .. ......  .   .  ... .  ..
.  .     . . ..  ..    ....  .....  .... ...  . .. .   . ..       ....    .    .     .  ..   .  ..  ..       . .  .  .  .      . .   .
. .   .... .       ....  .. .     ...  .... ..    . . . . .    ..   . ..    ..  .. . .  .   .  ...   ...  . ..   .   . ..  .  ... . ..
. .   .  . ..    . . .  . .   .. ..  .. .. . .  ..       . ... ..         .  .    .  . .  .   ..       ..   ... . .   ..      ....   .
.      ...  ...   .  . . .. ...   . . .  ..  ....  .        ..   ..      ....  ... ..    ..  ... ..      . .    .  .      ...  .    ..
.. ..     . . . ....      .    .... . .  . ....   ...     .    . . .    .   ... ..    . ...  .   .   . ..     ... ....    .   ..   ...
...  . ... ..  . . .    .    .   ....        .   .  .   ...  .         .  . X    .  .    .  ...     .    ...        . .  .      ...  .
..   . ...    .. .   .      ..   .      . .       . . ...  . .     ..  . . .  ...       .   ...... .   .   . .    .    . ....     .  .
.  .      .  .  .  . ....      .  . .  .... .  .      . . ..  .. .    .      .   . .         ... . .  ... .       ....  ..   .       .
..  .    ..    .... .     .  . .  ..       .  .  . .  . ..   . ..   ... .    .  .. ..  .  .  .    ..  .  ... .   .. .. . ....      ...
...   . . ....   . .... ..  ..  . .      . ..       ..  .. .   . .     .    .      .   ... .   ...  .  . ...  .  ..... .  .  .  . .  .
......................................................................................................................................
