......................
.     .       .   .. .
.  . .               .
.  ..              . .
.. .  .   ..   .     .
.           X        .
.     .   .        . .
.       .  .     .   .
.                  . .
.    .     .   .     .
.             .    . .
.    .        .    . .
.  ..    .       .   .
.     .       .      .
.         ..      .  .
.            . .. .  .
.  .  ..             .
. .  ... .        .  .
.              .   . .
.  .                 .
..             ..   ..
..    .              .
..         .         .
.      .             .
..                   .
..     .  ....    .  .
.                    .
. ..     .  .       ..
......................
