.........................................................................
.       .     .    .                    .              .        .       .
.      .                  .  .                                  .  . . ..
.                    .                                    .      .      .
.   .                                               .     ..  .         .
.        .   .  .   .           .   .   .. .       ..    .         .    .
.               .  .   .           .      .                 .           .
. .  .   . .    .    . ..          .       .             .        .     .
.            .   .  .              .    .         .         .           .
. .. .   .     .       .                        .    .                  .
.                    ..     .      .                                 . ..
.        .            .        .               .                 .     ..
.    .        .. ...      .   .     .                     . .  .       ..
.          .     . .   .                .      .        .   .           .
.   .      . .       .   .     .  .   .          .            .       . .
.... .  .    .  .     .             .       .        .     .            .
.         ..  .  .     .      .                               .       . .
.   .     . . .                         . .       .           .       . .
.                      .    .            .          .              .    .
.  .     ..                              .       ..   ...               .
. ..   .          .         .  .               .      .   .             .
. ..            .. .             . ..       .       .        .   .      .
.     . ..       .                                .              ..  .. .
. .    .   .         .           .     ..           .  .        .    .  .
. .         .   X   .               .    .        .        .  . .    .  .
.. ..     .                      .               .    .   ..   .        .
.........................................................................
