.............................
.X            .      .      .
.    . .  .   .  . ..       .
.     .       .        ..  ..
.............................
