.............................................
. . ...  .    . . .. .       .            . .
.. .   .  ...     .      . .  .             .
. . .    . .  .   .. .        .  .     .  ...
..   .  . . .  .  .   ..  .   ..     .     ..
. ..   ...   . .     ....   .        .    . .
. ...     .        .   .    . ... ..  .. .  .
. .      .      .      .  ..  ....   .     ..
. .  .. .   .          . . ... . ... . . .  .
.  . .       .      .                 .    ..
. .     .  ...    ..   ..  .          ...   .
.       .  .. .  .        ..      ... .     .
.  .  .       .               ..  . . .     .
.     . X  ..    .        .   .   .      .  .
..  . .          ..  . . .  .  ..   ...     .
.     .  ..  ..     .          ....  .      .
.    ....  .   .    .  .       .      ....  .
.     . .... .   .   . .          ..  .. ....
.   ..  . . .    .  .. . .    .  ..  .      .
. . .    .. .    .         .            . . .
.  ...       .  . .     ... .         .  . ..
..       .  . ..     ..  . .  .. ..       . .
.  . ....    ..  . ..     .  .  . ..        .
.   .    .   ...  .   .   .   ...           .
.. ..  .  .    .       .    .   .           .
... . .        .           ..  ..  .  .  ....
.............................................
