.....................
.      . .  . . .   .
.  .   .    .    .. .
...    . .    ..  ...
.... .  ...  ..   . .
.        .  ..    ...
...      . . ..  .  .
.  .   .            .
. .    . ..      .  .
.  . .  ...   .     .
. . .     ...  .  . .
. .    .    . .  .  .
.   ..  ...  .X..   .
... .    .  .       .
..   . ..    . .   ..
. .. .    .         .
.. .   . ...   ...  .
.   . ......   .    .
. . ..   ..        ..
.....................
