................................................................................................................
.        .     .                       .       .        . .    .   .  .                                   .   ..
.               ..               . .                      .                     .                   .       .  .
.                         .               .  .                    .         .  .    . .               .        .
.            . .    . . .                                                           .         . .     .  . .   .
.  .  .                       .   .        . .   ..                .      .    .                ...    ..      .
.        .                                              .         .  .         .               .  .            .
.                      .                        .                .    .         ..     .         .   . .   .   .
.            . .         .                           .                                     .           .    .  .
.               .                    .         .  . .                        .               .        .        .
.      .    .      .         .              .                                                                  .
..        .          .                   .          ..   . .                  .                 .      .       .
.                                .        .   . .                                               .              .
.                   . .       .          .    .                           .               .            .       .
.                                        .                                   .                  .        ..  . .
.                           . .         ..                .           .               .                        .
.                                       .          ..                .               . .  .           .   .    .
.          ..               .    .      .               .   .                 .    .        ..          .      .
.        .         .    .                       .  . .         ..             .              .     .           .
.              .           .                                              X      .                             .
.                .           .       ....                       .                       .                      .
................................................................................................................
