..............................
. .. . . . . .. .  ..  .. .. .
.. . . ...    ...  ... . ... .
..  .   . . .. ..    .   .  ..
. .. .. .. . ..       ....  ..
. . . .  ....  .  ..   .. .  .
..   . .    ... .... ..... ...
. ...       .   . .. . . . ...
..   ....    . . .  ....     .
.    . . . ....... .. .  .  ..
..  ........        . .. ..  .
. .  . ....    ......  ..  ...
..   .X..  ......... .  . . ..
.   ..  .  .. ...  . ....   ..
.... ...  .. ...   . .  . .  .
. ...    .. .  .      . .  ...
.  .   .  .. .   .  .  ....  .
..............................
