.............................................................................................................................................
.. . . . ... . . .  . . ......  .. .   ...   . .  ..... ..  . .. . ... ...   .   .  ..  . .  .  .     .   ...    . .....  .. .    ... . ... .
.  ..  .. ...           .. ... . .. ..  .  . ... ..    ..  . .. .  . . .. .  ...  ...      .. ...  .. .  ..  . . .   . .. .    .. . .. ...  .
.  ... .   . ...  .  .  ... .... ..  ... . . ....    .   .    .    ....... .  ....   . . .  . . ... ....   .  ... .. .  .    .... .... ...  .
........ .. .  .   . .. ....   .   .  ...  .  ... ...   ... .   .  .......      .... ..   ..  ..   .  .... ..   ..      .  ..  .....   .    .
..   .. .   .. ...   . .   .    ....X  .    .. .   . ....   .... ... .........  ... . . ..   . ...   . . ... ..   .  . .    . ... .... ...  .
...   .   . ...         ..    .. . .. . .. ..   .. .  . .   .....    ..    .    . ..  .  . .  .  .   .. .    ..  .  ....  .. ... .   .   .  .
...... .  .  .  . ... .. ..  .....  . .    ..   ..      . ..... ... .  ...     .  .. . .     .. . ... .  ....   . .... .... . .    ... ...  .
. .  ..........   .  . .  . ..  . .. .. . ...   .. .   . ........ .... .  .... ..  . .. ..   . . ..... ....... ..  ....  .  ...   ... ...   .
. .   . . . . . . .... .. ... .   .   .. ..   . ... .. ...    .....  .. . ..  .  . ...   .  ...   . .  ..... .   ...   ..... . . .....     ..
.     .. .  .. ..  . . . . ...  . . . .  .      .. .  .. .  .     . ...    .  .  ...  .   ... .. .  .     ... . . .. . .   ... .  .  ..... ..
.....  .   .. ...  . ..     .. ... .....          ..  ..  ...  .. .  .  .  ..   .   .  ....  .. ....  .   .. ... ..... ... .   ...... .......
.............................................................................................................................................
