.......................................
...    .  .  .           .  .   .     .
.   .       .      . .  .             .
.        .       .      .    .      . .
.    ..       .                       .
.     .   . . ..    .   . . .    .    .
.    . .                .            ..
. ..      .             .             .
. .    .         .    .  ...   .     ..
.             .     . .       .     . .
.    .  .    ..         .    .   .    .
.      .      .        .      ..      .
.         ..                 .      ...
.  .          .    . .      .    ..   .
.    .       .. .        . .          .
. ..                 ..X              .
.            .                ..      .
.       .        .  .              . ..
. .      .    .  ..           .       .
.          .                        . .
.......................................
