.......................................
.                    X                .
.     .                       .  .  ...
.                         ..       .. .
.         .           .     ..        .
.                                     .
.                      .         .    .
.        .  . .      .      .        ..
.......................................
