...............................................................
.   .  .   .        ... .       . ... .   .     .   ..        .
.   . ..  .                        .       .   .     ....     .
.     .  X   .       .  . .     .    ...       .    .         .
...............................................................
