.............................................................................................................
.  .  . .     ...   .  .    ... . . .         .. ...    .  . .    .. .. . ...  .  .. .. .  .  ..  .       ...
...  ... ... ..    . . ...  ....    .    ..  .     . .  ..   .  . .. .  . .. ... . ..   . ..  .   . .  .   ..
.. ...   . . ....... .  .. ..   ..  . .      ... .. .  .... .  . . . ....   .....  .  . .... .  . .   .. ....
..  ..  .  ... .  . .  .. ..    .    .. ...   .. .  .. . . .     ....  . ..  .   ..  .  ...   .. ..  .... . .
....     . .. .  . .. ..  ..... . ...  . ...      .    . .  . . . . . . ... .   .....    ..   ... .... . ....
.   .  .  ..      ...   .  ... .   .  . .  . . . . .    . . .    .        ..  ...   .       . . ..  ...   ...
. .    ...         . .   ..     .     .  .   ..    .. .  . .  .   .  . .  .  .  ..     .. ....   . . .    ...
..    .  ..   . ..  .. ..  . ..  .   ..   ... . .. .   . .    . . . .. . .  .  .  .    ....  .   .  .. .... .
.   ..  ..... ..    . ..  ..   .. ..  . ..  .  .    . . .    . .        . . ..   .     ...     .    ..   . ..
........      .   .. .. .  .. .     .. .  ...   .. ...  ... .  .  . ..  .   .  .   . .. .    ... ..  . .  ...
...  .. . ..  ....  .    ...   . .  ... . ... .   ..........   ....  .    .  .  .  .   . ..  . ....    . ....
. . .    . X     . .. .   ....   .... . ... . .   .    ..   ....   .    . .   ..  .      .  ....   ....     .
.  .    . . . .  . ..... . .  . . ...   . .... ....    ...     ..     .      ..   .  . .   . ....    ... .. .
........ . . .   .  .        .... ....  .  ... . . .   .  .. .       .. .    ..... .   ...     .  . . . ... .
.............................................................................................................
