..............................
. . . .  .. . .   .. . ..... .
.     ..   .    .   .. ..  . .
.  . .  .  . . . . ..  . . ...
.. . . . .. .  ....     .  . .
. ... . ...  ..    .      . ..
.. ..       .  .. . ...  .  ..
. . X . .   ...      .   .   .
.    .  .  . . ... ..... .   .
..    .    . .        ..  .. .
.  .  ...    .  .. ....   .  .
.           ...   . .  ... . .
..............................
