......................................................................................................................
.    ...  . ........ . .. .   .   ... . ..   ..   .. ..   .  . .  .. .       .  ..  .  .  . . ... . .   .   . . . .  .
.  .   .... . ..     ..    .       .      .    ..  ..     ... . ... .   ..  .  . . .   . .  .       . ..  .. ....  ...
.      .  .  .      ...       . . .     .  . .   ..  .     . .      ..      . . ..    . .   .  .  . . .   ..  .  .....
. .. ..X. ..   .  .     .   .     .. .   ..  .    .. .   . .  ..  . .      ..    . .. .. . . .      .    .       ... .
.. .   . .   . . ..... .  . ..  .  .    ..  . .. .  .. .      .. .  .. .    .   .    .  .    .. .  .   .. .      .  ..
.   .     . ..      .   .    .       . .  ..         .     .  . .  .    .  . ... .. .    . .. ..    .. ... ...   ... .
. . . .  .   .          . .   .  . .  .    .   .  .  . .    ...  ...   .    . . .  .   ..   .. .     .  . . ...   . ..
.        .. .  .  .       . .  .     .  ..    . . . . . ..   ..     . .  .. .      .       .  ..    .   ...      ..  .
... . .        .   ..     .   .. ..  ..      ..... ..      .  .       ..     . .    .       . .. ..       ....  . ....
.    . .  .    .    .   .      ....  .. .   .   . .       ... ..  .  . . .     .      ... ... . ..          . .     ..
. ...    . .  .. ..      .. .  .. . . .   .. .  . .    . . .   .              . .   ..     . ... . ..    ..    ... . .
..... ....  .       ..      . . .. .  ...  .      ..      . . . ..... ...     .. .     .  .   .   . ....    .    . . .
.  . . ..    .    ..    .    ..   .   ...    ..... .     .     ... .  .  .      . .        ..              .    . .  .
......................................................................................................................
