.............................................................................................................................
. .          .    .            .      .      .  .   .  .   .. .      .  .  .   .  ..  .   . .    .   .    . .  .  .  . .   ..
. .   X...   .  ..     ...              ..  . .  .   .  . .  . .  .  ...          .      .  .... .    . .       .  .     .  .
.  .  . .          .      . .   .     .        . ..  . .    .      .  .       .   ....         ..        .  ....   .        .
.............................................................................................................................
