......................................
... .... ..      . .     ......      .
.. .  ... ... ..  ...     ..... .. . .
.....    ..  ... .    .    ..... .. ..
. .. ....... .  .. ... . ..   .  X.. .
......................................
