......................................................
.              .            .          .     . .     .
.  .   .              .. .  . X    .              .. .
.         .           .    . .  .       .  .         .
.   .  .. .          .  ..    .    .       .      . ..
.       .  .        .       .     .  . .  .          .
.    .       .        . .   .      .                 .
.  . .  .  .  .    .       .      . . . .   .      . .
.               .    .                      .   .    .
.            .            .           .    .         .
.          .                   .    .      .      . ..
. .  .           .  .   .   .          .       .   . .
.      .            .   .   . . .     .         .    .
.    .              . .   .  .    ..  .     .        .
.    .               .   ..  .  .                    .
.  .       ..              . .       .    .  .       .
..     . ..  .          .    .   .    ..   .         .
.    ..       ..  .    .  ..   .    .  . .  . ..     .
.                       ..     .           . .  .   ..
.. ..   .  .      .       .    .   .                 .
.               .       .   .       .   .            .
..    ..     .                .   ..   .        .    .
. .   .          .  .         .             ..  .    .
.     .     .  .   .            ..   .               .
.                       . .   .             .        .
.     .        ..                      .    . .  ... .
. .     . .    ..  .      .  .    .                 ..
......................................................
