.........................................................
...    . ..  .    .     .. .    . .  .   . .   .      . .
..  .     .   ..    . . .   .   .. .  ..  . .  .. ... . .
. . .. ...  . .  .. . .  . .   ..    ..     .      .   ..
...   .    .. .    ..    .  ..... ...  ..   .     .   . .
...     .  .  .  ..   ..   . .   . .   . .  ... .  ..   .
. .      ...  .  ..  ..    .       ... .  ...  . .. . . .
.. ..  . .        . . .. ... .  .    . .  .. . .    .  ..
.     . ..  .    ...  . .   .. ... ...   ...   ..     ...
.  .  .   .. ..   .. .   . .....       ....  .     . .. .
..  .    . .....   ....  ...  .        ....   .    .  . .
...  .     .  .       ..      ..    .  ..... .   .  .   .
. . ...  . ..  .....        .. . .   .   ...... . . .  ..
..   . ..  .  .  . . .   ..  .. .. . ..     .       .. ..
. .  . . . . ...     . .     .. .    .. ...     . . .....
... ..     ..  ..     . ..  .   .   .. .   .   .     .. .
.. .  .   . ... . . . . ..   .   ...   ..         .  ....
.  . ..    . ....   . .. .  . ... .  .  ..  . ..  ....  .
... .  .   ...  . .  . . . . .  . .     .....  . ..     .
.   .       . ..     ... .. .    ... .   X   . . .. . . .
.   .... ..     ....  .. .  . .  . .  .    ..   .. ..   .
. ..  . .  . .    .. ....   .. ..  . ... .. . ...  ...  .
... .   .. . . . ....    . .    .   .     .  ...  ... . .
.........................................................
