......................................................................................
.  . .                          .        .               .   .. ..    .              .
.      .       ..          . .      .         .    .           .    .    .    .     ..
. .                   .      .        .            .    .          .   . .       .  ..
.               .                ... .                     . . .   ..         . .    .
.   .           ..              .       . .      . .        . .           .          .
.             ..   ..  .         . .               ..          ..            .       .
..          .            .       .  .           .            .   .   . .             .
.                 .     ..   .       .                            .    .  .      .   .
. .         .    .     .       .             . ..             .                      .
.                 .           . ..                 .                    . X.     .   .
.          .  .    .      .     ..    .            .            .     .   .          .
..      ..            .         ..    ..                   .     .                   .
..  .  .              .                      .    ..            . .             .    .
.      . . .          . ..            .     .                . ..       . .          .
. .   .    .                           .     .          ..             .           . .
.     . .       .       ..     ..        . .                 .                       .
......................................................................................
