..................................................................................................................
.       .      .   .   .            .  .        ..      .       .  .  .     .      .      . ..    .  . . .. . .  .
. .             .    ..      . .          .      . .     . ..      .      .      .   .  .    .          ..      ..
. .. . .    . .   .        .    .       .             .  ..   .     .           . .  .         ..        .  .    .
.  .      ..                       .    X       .. . .          .      .   ..  ...  .            .      .   .    .
..................................................................................................................
