...........................................................
.   . X...... . .  . ..  . ..  ... . . . ....   .  ... .  .
.. . .  . ..  ...   ..  .   . .  .....   .... . .  ..     .
. . .. .. .. .  ... . .. .   .  ..  ... .  .. . .    . .  .
... . . .    .  .. ..    .  . .. . ..  . .  ..    ..  . ...
.  .. .....  .  .  .   ...  .     ... .        ... .   .  .
. ...  .  .  .   . . .. .. ..   ..    ..  .  . ..  .... ...
. .. .      . ... ....    .       . .. .. .... . .  ...   .
...........................................................
