..........................................................................................................
.  .  .            ..  .  .   .    .    . .          .   ..    .   . .                  .  .  ..         .
..  .     .  .   .    .      .          .  ..      .   .   .        . .         ..             ...       .
..      ..                                      ..            ..      . .    .   ..      .   ..        . .
..     . .   ..                     .           .        .     ..    . ..     ..     ..     .     .      .
. .   ..  .      ..              ..    . .    ..  .           .  .. .         .  .    .  .       .       .
. .   ...        .           .      . . ..  .     ....   ..         .    .   .    .          .    .      .
.       ..  .  .    .  . ..      .   .     .        .     .         .       .  . . .     .         .. .  .
.  .        .     .                    ....        .     ..      .  ..      .    ...            .        .
..            . . . .    ...                   . .  ..    .     .    ..    .  . ...   ..    ..     ..    .
.    . .  .      .   . ...         .   .       . .         .   .  .  .     .   . .   . .   . .      ..  ..
.    .. .   . .      ..       .        . . .      . .           .    ...    .         ..          .      .
...    .    .           .            .          ..   .              ..      ...  . . ..  .             ...
.  ..       . .     .         .. ..             .       . ..              .     .                       ..
.           .                .   .    ..  .    .  . .       .    ..     .    .     ..   .                .
..  .  ..   .     ..   .            ...  .         .                   .. ...    .    . .  ... .. .      .
.        .    .               . .    .    . .      ..      .   .         .  .                 ..     .   .
. . .       ..      .          .            . ..        ..  . . . .                .  .  .       .       .
.   X   ..    ..      ..         .  .  ..    .   ..         .   .     .    .          .       .    .  . ..
.      .   .   . ..    .    .   ..     ..  .     .  .    .    .  ...     .   .     .               . . . .
..........................................................................................................
