.........................................................
.... ..... .  .    ..  . ....  .  ..  .  .. .    .... ...
.    .   . ..    ..    . .. .....    . . ......      .. .
.. ...... .  . ... . .. ...... ...    .  ..    . . .  . .
.   ..   .. .....   .  . .. ..  .          ...... . . . .
.  .... .  ....  ..  . .... . .. .. .. .     .  . ...   .
.  .       . ...     ..   .   .  .... .       . .  .  . .
.. ..      .   ... . .   .  .. .... ....  . .          ..
.    .  .....   .. .  .   .. .   .  . .. ..   . . . . . .
.  .....  .       .. .   .. ...    . .  .. . ..   .. .  .
.. .    .       . .. .  ... ..  . ...  . .  .  ... . .. .
.. .   .. . . ..   .. . . .  . ..  ..  . .  .. .. .  .. .
...  . . ..    .  ... ..  .  ...  . .    . ..   .    . ..
.  . . ... . ..   ..      .....  .     . ..     .   .   .
. .. .  . . .  ...   .   .   .....  .    .. ..  .. . . ..
.    ....  ..   ...  ....     ....   .  ..     . .X ... .
.  .   ..  ..... ... ...  ...      ..     .   .     . . .
.. .. .  .     ..    .... .. ....     . .      . . .  . .
.........................................................
