.............................................................................................................................................
. ..  ..... ... . .. . ... . ... ..   ... ..     . ......   ... .    . ...   ..... . ..    .. .. .... .....  .. . ..     . ...... .. ... . ..
.   . .. ..  . . .. ...   .. .  ..... ..      .. .. ... . .  . .. .  ..  .  .. ... ... ....  .. .   . . . .  . ....  ...  .   .. ...   ... ..
. .  ..   .. . ..    ...  .... .   .  .  .    .  ..  .    . ...  .. . .. .  ...  .    .  . . ..  ..  . .      .  .. ....  ... .. . ... ..  ..
..  ..  .  . ... .    . .....X.. . . .   .  .    .. . . ...     ... . ...    .. .     .. ... ....  . .... .. .   .  . .... .   .....  . ... .
. ... ...  .  . ...  .  . .  .  ..  .  ..... ..  ... . ...   .......  .  ..  ...    ....    ... ....    .. .  .  . .. ... ..  . .... .   .. .
...   ..... ... .  . .... .. .... ... .  ..   ...   . .  .... . ..  ...   . ..... .. ..  .. ........ .. .. . ... ...... ..  . .......  .... .
....... ...... .  ..  ... ..    . .  . .  ... .  . . ...        . .  . .....     . ...     . . ...... . . .. .. ..  ..   . .  .....    . .  .
.   . .  .. ... .... .    ..  .. . .. ..... . . ..   .  ... . . .     ....  ....  ....  . ......    . . ... ...  ...... .    .      ...    ..
.... . .   ... .  .     ..    . ...     .. .. . ...  ...  . ... ..... ..  ... . .. .  .. ....    .  .   .. .. ...  ..       .  ... . . ......
..  ... ... .. .   .... .  ... . ...    .. ..  . .... . ...    .. . . ... .. . .. . .. .. . .....  ....  .. . .... . .....    . ... . . .. ..
.. ..      . ....  . .   .  .   .. .. .    ..  ... . .  .  ..     ... . .        ..  . ..... . .   .  . .   . .  .   .. . .... .. .. .. .....
.............................................................................................................................................
