..................................................................................
..      . ... ..  .    ..   . . .          .      .  . .  ..   . .   .  . . ..  ..
.   ... .  .   . . .       .  ....       .  .  .  .        .    . .  . ..  ... . .
.  .   ..     .. ... ... .    . ....   ..   .     . .   . ..       .  .  ...  .  .
.  .     .  .  .. .. .....  ....       .  ..     ..      ..    .  .         .    .
.       ..    .     .   . .    ...   . ..    .     .      .  ..  .. .      .... ..
...   .    .  .  . .  ... .   .     ...    .   .   .   ...  . .  ..       .  .....
...  . .   .    .   . ...        .       ..     ..    ..  .  ..           .. . . .
.     .......     ...  . ...   .     .. .   .    . ..  . . .   . .  ..    .     ..
. .  .   . .. .   ... . .     ..  . .    .... ....   .       . .  .. .   ..   ....
. ..  . ..  .  .   . .  . . .    .  .   ..   .     . .     .. .    .  . . . .  ...
..  ..   .  ...       . ...   ..  ..  ..   .  ..      .  .. . .    ..      .  . ..
.   ...      ... .  ..      . . .  .  .                ...   .     .  ...  .  ....
.      .  .. . .. . .. ..    . .   .......   ..   ..  .       ..  .  . . .   ..  .
..   . . .       ...  . . . .. .. . .    .      . . .      .   . . . .  ..  .   ..
.     ... .  .  . .   ...        . .       .       ..X.  . ... . .    . .  . .....
.      .  . .    ..  .. . . .. .  .  ... .    ...  .  .   .. . . ...   . . .   . .
. ..... . .       .  ..      ...  ...  ....   .   ..     .    .   .    ..   ..   .
.   . ...  .     . .. .      .    . . .  . .    .  .   ..  .     .      ..  .    .
.   ... .   . ..   .  ..     .      .    . . .    ..    .         .. .     .    ..
.   .  .  ..    . ...   .   ..      ..   .  .  .         .  . . .  ...... .      .
.  .....    ... . .  .   . . .  ......   ......  ..  ..    .   . . ..   .....  . .
. .     .   .   ...    . .            ..  . ..       .  .   ........ .   ..     ..
..     .    . .  . .   .  . .. ....   .. ..       .         . . .   ....    ..  ..
. . . . .   .    . .  ..        . ....   ....      .. . .    . . . .   . .     . .
..................................................................................
