.............................................................................................................................................
.  .. . .     .. .       .. ... .  .. ... .   . . .   ..   ... ...  . .. .. . . ...... .    . .   . . ....  ...      ..  ...   .     .. .....
.... . ..  .     ....    .   ..   .. ..... . .   . . ..... .. ....  .   .... . ..  ....... ..    .  .    . .  ..    ...   ..  .. . . ..    ..
. ... ..   ........ .. .    .. .. . .  ... .  ..  .  .... . ...      ...     ..      .  .  ... .. .     .   ..  ....  . ... ...   . ...  .. .
.  .   . ...     ... .    .... .. ... . .    ... .    ..... ..   ... .  . . ...   ...   .. .....  . .. .. ..  .. . ..... . .    .  .... .  ..
. . ....  . .... .       .   . . .    .......    . .. ...... .....  ... .. ... ...  .  .... .. .. .  . .. . ... ............. ...  . .      .
. . . ...    ...   .. . .. . ........    .. ....     ...   ..  .... . .... ..X.... ..... . .... . . . ...       .. . .   .   . ....  . .    .
.. .   .    ..... .  .. . ....... .. ..... ... ...   ..  ......  .. .. .  ........   . .. .. .  .  . ....  . ..... . ..     .. ......   . . .
.. . . .  .  ..    . ..   . ..   .. .  ....  .  . . ..  . .... . ... .  .. .   .  . .....  ..  . .....  .  .... . . .....  . . .  .  . . . ..
... ..  .. ..   ..   . .    .   .. ..    .. .  .  .  . . . ..  .  ...  .  . ..  .. . . ..   .  ..   ....  .. .    ....  . ..  . .  .      ...
.  ....  .. . . ....  ... . .  ...   .  .......     ...    .  .....    . . .. .. ...... .. .. .....  .. ..  . . .. . . .  .  .. ..   .. .. ..
.............................................................................................................................................
