.................................................................................................................................................
. ....   .  .   . ..  .... ....  ...  .. .    . .   .... . .       . ... .  .   .    .   ....         ..      .    .   .....     ...   ..   ..  .
.    ..   . .... . .        .  .. ..  .. ...  .  .   . .  .  .  ..  ...... .. .       ... ...   .   . .  ..... .   . ....  .  . ....     ....   .
. .   . .  .. ..X..  . .  .  ..  . .    ...  .... ..  ... .   .  .....      ...  .. ...  ... .. . .  ..  ..           .     .. . . ... . ... .  .
.................................................................................................................................................
