....................
.  . .   . .    .  .
.   .              .
...                .
.       .    . ..  .
.. .     .  X      .
.             . .  .
..      .       .. .
. . .   .  .       .
. ..         .     .
....................
