...............................................................................
.  .   .  .                                           .     .     .       .   .
.         .    .                 .                  .   .       .   ..  .     .
.            .       . ..        .      ..                    .       .       .
.     .       ..  .                 . .         .      .  .                .  .
.                    .    .                     .          ..           .     .
.          . .     ..           .                    ..       .    .          .
.            .    .               .        .     .                  ..        .
.    .                     .                        .     . .  .              .
.            .    .                         .      ..   .    .  .            ..
.    .        .           .  X      .        .              .                 .
.  .             .     .    .  .           .     .   .  .     .       .       .
.                       .           .    .                .               .   .
..             .               .          .               .  .      .         .
.                       .             .       . .      .  .             .  .  .
.  .          .           .         .        .                        .    .  .
.           .                     .                . .  .              . . .  .
.         .         .            .                 .    .        .     .   .  .
..    ...  .    .       .       .          .  .       .          ..           .
.                        .        .          .          .     . ..    .     . .
.                           .      ..   .           .      .         ..      ..
.        .   .             .                             .  .                 .
.  . .            .                 .                .     .  ..            . .
.              ..   .     .   .               .        .               .  .   .
.                     .           .    .                                  . . .
.      .     .      .                     .                 .       . .       .
.   .. .   .      .              .     .                           .  . . .   .
...............................................................................
