.................................
. . . ..  ....   ..   . ... .   .
.  .. .   . ...      ...       ..
.   . .  .     .  . .   ..  .. ..
...  .    ..        .   ...     .
..  . ...  .  .  .   . .  .  . ..
.         ...         . ..  .   .
.  .  .   .    .  ..    ..  .   .
. ...      ... .   ..    .    ...
.        .          ... . ...   .
.  .           ..    ...  .    ..
.     . ..       .....      . ...
.  .        .      .   . ..     .
. .   ... .           .   ...   .
.. .        X . .  .       ..  ..
.. ..   .. .    ..  .    . ..  ..
. . ..   .        . ... .    .. .
.    .     .    .   . .    .   ..
. ..  .   .  .  . . ...    ... ..
..         .    . . .    ...    .
. .    .. . .  ...  .   . ... ...
.          .     .   .   .     ..
..    .  . .   .  .   . ... .   .
...  ..  .  ..  .. .     . .. ...
. .    .         .          ... .
..   .   .   .. .. ..  .   .  ...
......   .....    .   . ... .   .
...    .. ..  . ..   .  .  . . ..
.................................
