........
.    . .
..     .
.      .
.  .....
.  ..  .
.  .   .
..     .
..     .
.. .   .
.   .  .
.  .   .
. .    .
.      .
. ..   .
.   .  .
.     ..
.      .
.X .   .
.      .
.     ..
...    .
.. .   .
.     ..
. ..   .
........
