............................................................
.   .          .          ..       .   .          .  . ..  .
..    .    .    .       .      .     . .     .        .   ..
.  .      .    ..       ..  .     ....      .  .. .        .
.  . .     .     .     ..     .                            .
.  ..   ..      ..    .  ...     ..        . . ..     . .. .
.  .. .       .  . ..     .. .      .    .. .  .  . . ..   .
. .   .  ..  .    ..  . .      .   ..    .    .        ..  .
.    . . .   .  . .     . .        . .    .      ..   ..  ..
.. .  . .          .           . .   .      .      .. .  . .
..  .   .    ..        .     ..    .        .       ..    ..
.    .. . .            ...    .           . ..  .   .   . ..
.  ..       .   .  . .                     .        ..     .
.       ..   .  .  . ....     . .     ..  . .       .  . . .
.   .    . . .      .            . .. . .   .  .  ...  . . .
. . .   . ... ..  .          .   .     .    .      ..  .  ..
.  ...  .         . . .   ..      .      .        . .      .
.          .. .   . . .                  .     .       .   .
. ..    .        .           . .     .     ..           .  .
. .  .    .   .  .    .            .  .  ..    .    .     ..
.. .  . ..  ... .  .     .      .        .. ...    ...  ....
.      . .     .             .X      .      . .    .       .
............................................................
