................................................................
..      . .. .  . ..  .  .  .     ..  .  .  ..     .        .  .
.  .   ..  ...   . . .  .  .      . .. . .      ...  .         .
.       .   .   . .    .. .. .   ....           ..  ...    .   .
.    .. .. . .  .   .  . . ...          . .       ... . .     ..
.. ..  . .... ...   ..    . ... .  .  . X.   . ..    ... ..... .
. .. .. .  . .. . .... .. . .    . .   .. ......    .  .. ......
. .   .  .     .. .   .. ..       .     .. ..  .  .  ..        .
. .  . .   ..  .  . . . ....                  .. .    . . .    .
..   ..              ...  ...      .  .     .  . .  ..       . .
.....     .    . .        .     ..    .    .   .  .  . .. . . ..
.     ..        ..    .      .      .. . . . .      .   ..  .  .
.    ..   . . .       .     .  .      .            ..      .  ..
..  .  .    . .       .  .    . .       . .   .. .     ... .   .
.   . .      .   . ..       .    .     .  ..   .  .. . .  .  . .
.   . . .      .    . .. .       ...  ... .  .    .   .  . . ...
. ... . . .. .     ...  ....   ....  .   .  . .  ..  ..        .
. .     .. .           . ..   .  . .  . . ..  .   .  . .       .
.    .            ....      .   .   .... .  .      ..    .   . .
. . . . .      ..   . . . ..  . ..   .        ...    ..  .    ..
.  . . ..   .  .   .    . . .      .  . ..    .    .   .     ...
.    .   . ..   .   ..  .  ..   ..    ....        ... .  ..... .
................................................................
