.....................................................
.              ..  .     ..  .        .   . . .  .  .
. .    .             . .. .   . .    . .      .     .
.       .      .  .    .     ..  .   .     .   .    .
.                   .  ...    ..  .   ..   .      ...
. . .   ..   . .  . .   .     .       .    .     . ..
. .. .   . . .    .. . .                     . .    .
. . .     ..           .  . .. .       .  .  .    . .
.              .    .      .   .   .         ..     .
.  .        .    .   .             .       X       ..
.            .    .  .    .. .  .  .   .  ..   .   ..
.    .         .      .                     .   .   .
.   .             .           .  . .   .         .. .
.    .   .                   . .   ...         .   ..
.. .     .             .      .          .         ..
.    .         .       ..      .       .    .  . .  .
. .  ..     .      .   .     . ...   .    . ....    .
. .   .           . .   ..   . .   . . .            .
.     .      .                ... .              .  .
.           .    ..  .     .  .     .        . . . ..
..       .   .             .             .      .. ..
.        .  . .  ..   .  .   .  ...    ..    .   . ..
.                     .   .    .. .                ..
.....................................................
