.......................................................................................................................
..  ..    .  . .X  . .  . . . .   . .    .. ..   ..   . . . .  .   .    .. ... .. .. . .. . .  ...  .. . .   .. .... ..
.  . .. .. .  .    .   ...  .. ..... .   .. .    ... ...   . .  ..   .  ...    .. .  .   .   ..   .  .  .. ..   .   ...
.. ... ... . ...  . . .  .  . .         ..  .... .   .    . ...  .   .. .  .. .    ..  .  ..   .. .. ..          .  . .
.......................................................................................................................
