..................................
.             .     .    .     . .
.                                .
.            ..                  .
.                            .   .
.         .   .                  .
.   .      .    .   . ..    .    .
.     .                          .
.   .                            .
. .          .      .    .  .    .
.   .                . .         .
.      X                  .      .
.   .                            .
. . .        . . .          .    .
.     .       .  .   .        .  .
. .                              .
.            ..            .  .  .
.                        .       .
.    .   .    ...           .   ..
. .             .       .     .  .
.                  .           . .
.                .        .      .
.       .       .         .      .
.                                .
..................................
