.............................................................................................................
.. .. ..  . ..  .. ... .    .. . ...     .  . .   ....   ..  ... ..   .   ..  ...   ..      ... ..... .. ....
. ..  .. ..   .. .... . ... .  .  ...   . ..  ..  .  ... . ..  ....              ... .......    ..  . ..   ..
. . . ....... . .. .. . . . ....  .. ..  .. .     . .  ...  .  . ...   . .....   ....  .. ..   . . ..... ....
.. ..   ....  .... . .... ..  . .. . ..    ..     ...  .. ... .. .. ... .  . . .  ... ..  ....... ..  ..    .
. ... ..  .   . ... .......... ..          .  ............ ..  . ..  .... .  ...  .  .       . .. ... ..   ..
. .. . . .... ...... . . ..    .. . .. .  ..     .  .. .  ...  . . . ..  ... .... ...  .....  ... ......    .
.  .. . .  .....   ...  . .  . ......    ... ....    .      ..    ....... .. . ....   .....    . ..  ..  . ..
..  ... ....   .... ..    .. .  ....  ... .      .      ......   . .  . ..  .. ..  .. .  .. .     . .  .. ...
.. .   . ... .... . .  .... . .. .. . ...  ... .    .    .. .  ...   .  .   .. ..   . ... .. ....... .. .. ..
.  . ....   .  . .  .. .. . .  ..... ... .. . . . . .. . ..   .  . .. .. . . .  . ... ... . .  . .. ..   ....
....  .. . .  ....  ..    .. . .. ..  .. ...  ..    ...  ... .....  . . ... ....   ..     .. .. . .......  ..
.  ..   ...  .  .... .  ... ...   .. .   .....    ..... .   .  ..   . ... .   ..    . .  ......    ...... ...
.... . ..   . ...  ....... .  ... .    .       .....    . .    .... ..... .    .    .  .  ..   ... ... .... .
.....  ..... ...  .....   . ...  ...      ......  ... .  . .. .. ... . .. ........   . ... .  .  .... .     .
.     .. ... ...  ..  . . . .. ....  .... . . ... ..   .. ..  . . ... .......  ..   ..... . ... .. . ...  . .
.... ..   . .    ..... ..... . .. .... . .. ...  . .  .... .  ...     .    ..   ...  ..  ....... .... .. ....
..  . .   . ..  ... ... .............      .. .. ..   . .. ..  ..... . .......    .     ..... ....  . .  ....
... . . .. .. . . ..  .  . ..  .... . . ... ..  ..   .. . . .    . . ...... .. ...  ..    X..  ..  . ... .. .
.  .  . .   .  ....   .. ....  .  . .  ....  ...  .......    .  ..  .   .      ... ... .  .... . .... ... . .
.............................................................................................................
