..........................
.   .     ..    .       ..
.    .   .    . .   . . ..
.       .   .    ..  .. ..
.  .X .  .      ... . ....
.  . .. ..   .. ..    .  .
..........................
