..............................................................................................................
.  .. .      . .. ..  . . .    ..  .  .   ..  . .   ...... . . .   . ....     ..    .   . .  .     . .. . ....
. . . . .  ...    ....... ..      . ..   .     . . . . . .. . ..  .. ..     ..  ....    . . . . ..   ..   . ..
.   .   . . .. . .    .     ...... .... .... ... ....  ..  ..  .    . .  .. .. .  . .     ..  .... . X .. .. .
.. ... .  . ..  .. .   ....    .   . . . ..   .. .. ...  ... . .  ....  ... .  ..   . . . ..  . .....    ..  .
..............................................................................................................
