............................
.     .        . .         .
.       .                  .
.          .     .     .   .
.                          .
.  .            .          .
.     . .                  .
.          .              ..
.X         .   .   . .     .
.        . .             . .
.          .             . .
..                 .. .    .
.  .   .  .     .          .
............................
