....................................
.                              .   .
.     .               ..           .
..     .             .      .   .  .
.   .                   .          .
.                .             .   .
.                                  .
.      . .            . .          .
.            .      . .       .    .
.  X .     .    .      .   . .   . .
.        .                   .     .
....................................
