.............................................................................................................................
. .. . ... .    . . . ...   .          ...   .  .  .   .  ... ... .. . . .  .... .         ..  .    .. . .. ....     .     ..
.. .. .   .. .... . .. .  . .  ... ....   .  .    . ..  .. ..   ..  .        .... . .  . . ......  .... .. . . .. . .   .....
..     . ..  . .   .. .  .. .   . ........ .. .. . .. ... ... . . ..  . . ..   ... ..    . . ..   ... . .. .  .. .  ..... . .
...  ....  .     ... .    .... . . ...  . .. .   .... . ....  ..    . . ..X . ....      . . ....... . . . . . .. .   . .. ...
. . . ... .....      ..   . ... .  .  . .. .   ..   ... ..  ..  . .. ..  . .. .    . . .....  . ..   ..      . ... .  . . . .
.    .  ... .. .   ......  .    .. .  ... .    . ..... .    ..   .  ....  ...   . . . .   . . .  .... .     .      ..... ....
.. ..... ..     ... .. . ...     ...  . .. ... ..... .. ... . . .. ...  .   ..  ..  .....   .. . ..   .  .   ..  . .   .   ..
.............................................................................................................................
