..............
..   . ..  ...
. . .. .  .. .
. . . . ..  ..
. . ..      ..
. .       .  .
.   ..  .  X..
...  .  ..  ..
. ..... .  ...
..  . ... .  .
. . . .. .....
. .... .     .
.  .... .    .
.     .  .. ..
.     .   .. .
.....    ... .
.  ..  . . ...
.. ...... .  .
. . ..  . .. .
..............
