.............................................................................................................................
. .....  ... ....   .   . .......   .  ..   ..   .  ..... .. .  .    . ..   .. .. .   .. .. .   . .   ..  ..  ..  . .. .. . .
..  ......    . . .. .       . . ....   .   .  ...  ..   ..  . .... ...   .  .     .     . .     ... .. ..   .  ....   ...  .
.. ........ .   ..    ..  ....  ...  .   . .  ....    .. ..  .. ....   ...... .  ..     . ..  . .   .... ....  . .. .  . .. .
. . .   . .. .. .. .  .......   ..         . ..    .....   .  . ..  . . ..   ..  .... ..   .. . .   . . . ..   . . .   . .. .
. ... ..    .   .. . ...... .   ..  .  .   .. .        . .     ..    .   . . .    . .... . . ..   . . .. .   .... .   .    ..
.  .  ...   .    .. . .. ... .     .    . . .    .      .. . . ..         ...   . .    .  .  . .  .. ..   ..... .  .. . .   .
... .  .   .. ..  . . .   ...  ...  .    . ..  . . .  ..  .   ......  .. .      . .. .......    .  .     . ..   ... .... ....
... .....  .    .     .    .  .. ... .. .  .. .    .    .. . .        ..     .    . .. .. ..   . .   ... . ..   .  . ... ....
. . ..   ...   ..   . ...  . .... X. .... .... .   .   .. .  . ....  ... . ... . ...  . . . .....   .  . ... ...... .. ..   .
..    .  ... . .. .  . ..  .. ..    .. .. .     ..  .   .. ..       .        ...     .. .. . ...... .   .  .    .  .. ...   .
.. . . .    .. .....    .. .   ...      ..  ......  ....    ......  . .. ...... . .     .    ......   .. ..  .. . ...  ...  .
. . ..  .... ..    ...  .   .. . . ..  ..  ..       . ..   .  ... .. .. . ..    . .  .  .. .... .. . .. .... . .... . ..   ..
.............................................................................................................................
