.............................................................................................................
.... ..       . ... .  .... .. ... ... . .    ...  ..  .  ... ...   ..    . .. .... ..  ....   . . . . .... .
.. ..        .   .   . .   .    .. . .       ...  .  .    ...   .  . ... .  ...    . .    . . . X    . .    .
..   .. . .      .. ...  .. . .. ...     .   .    .    .. . .. .   . . .. ..... ... . . ...  . .  .... ......
.    .. .  .. . .  . ..   . .  .  .. .  .   ......  .  ... . . . .....  . ..  .. ..   . .....    .      .   .
....  .. . .  ..  .  ...  .    ..  ...  . .    .  . ..     ...  ..  ...  ....  ..   .    .. .  ....  ... .  .
...  ..        ... ... . ....   ...... .  .. .      .. ... ..  ... ....   .  ...   ... ... .   . .  .. . . ..
. ..... ..... ....  . ..   . . ..  . .... .. .  ...... ....   .. .   . . .  .   .. ..    ..... ....   . . ...
.    ..    .... ..  ..  ... .. ..... .  .  ... ..   ... . .  ...  .. ..  .    .  . .....   . .  ....   .    .
....   . . .  .    . ...  .  ...   .. ...  . ... ....  ...  . . . .   . .   . . . .. ..  . . .....    .. ....
.. ..  .  .   . .. ..   . .. . ....  ..  . .   . .  .      .. .          .  ...      .. ...  .. .   ... .....
.............................................................................................................
