.......................................................................................
..  . ..  ..  .     .                            .   .   .   .      .                ..
.       .     .  .       . .   .   .  .           .  ...         ..        . .   ..   .
.    .      .    .  . .         .    .  .           .  . ..  .  . .          ..   .  ..
... . ...   .        .. .          .    ..  . . . .        .   .  . . .      .        .
.       .      . .  . ..   .      ..                        .. ..   ...  .  .  ... .  .
.  .           .       .     .   ..  ..       . .                 .  .     . ..       .
. .                             .  .   ... .   ..    . . .     .       .   .    ....  .
.   .  ..   ..             . .       .. . .  . .       .   .  .   .  .. .           . .
. . . .    .             . .   .   ..      ..    . ...        .       .   .       .....
.                           ..     ..        .     . .      . ..             .  ..    .
. .. .  ...           ..        .      ..   .. .      . .   .....           .      ....
.          ..  .      .            . . ..    .        .    .  . .          .     .    .
.              .    .   .      ..  .  .  .    .   .      .       ..  .     .   . X . ..
.  .   .             ..          .  .     .       . . . . .     .   .. ..    .   ...  .
. . .  .     . .   .  .   ..             .     . . .    .       ..  . ... .   .. .  . .
.  ..  .       .        .       .          .  .   .  . ..   ..    .  .            .   .
.    .  . ...     .     ..  ..   . .                  .   .           .              ..
.... .   .   .  .            .   . . .    .   .  .  . .    . . . .  .  .      .. .    .
.       ...     .. .  . ..   .         . . .  ..      ... .    . .          .         .
.       .     ..    .  .. .      .       ...    .  .   .  .     .  . ..  .. .   ..  . .
...    .          . .   .    ..     . .                . . ...   .  ..  .        .    .
.    ...       .   .. .  .           .  . .  . . .                  .     . . .    .  .
.              .  .    .    . .     .             .  .  .         .     .       .   . .
.               .. .   ..            .  . .        .    . .     .   .    .     ..   . .
. ..  ..    ..    .      .    . .  . .  .  .         . ..      .                .     .
.   .. .      .    .    .   .      .  .    .     .    .  .     .  ..      .  .   .   ..
.   .   .      . .                        .  .     .    ..  .  .  .      .  ...     . .
.......................................................................................
