..............................................................................
..    .  . .    .              .... .   .    .     .       . . ..   .  .  ....
.. ..    .              .     .      .   .  .    . .            .       .   ..
. .. .  ...  ...    .      .  .          .  ...     ..    .  .   .   .  .. . .
.        ..  .    . . .  .              .. .. .         ..   . . . .   . .   .
.      .  .          .  . . . . ... ..  .    .        ..    . .   .       .  .
. ....  .  .   .   .  .    . .  ..         . . .             .    .. . .    ..
.  .     .   . . .   .   ..     . .  .   .  . ..   X. .   .      .  .      ...
. .    ..  .            .                . .              . . . ...   .  .   .
.         .       .         ..   .       .             .    .              . .
..............................................................................
