.....................................................................................................................
..   .               .              . .    .         .         .. .    . .       ..                               . .
..        . .  .      . .       .       ..    .                          .   ...         ..    .   .   .  .         .
.              ..    .. .                .   ..  .      .  .      .           . .     .                   .         .
..               .   .     .  .      . ..      ..  .   .    . .                ..    .    .      .  .               .
.               .    .  .      .    .         .    . .    .  .    .                   .  .    .            .   .    .
.                  .      . . .   .           . . .    .                  .                  .       .  ..      .   .
.           .. .                 .   ..             ...        .           .       .    . .  .  .           .      ..
.              .       ...       .        ..       .          .  . .  .  ..        ..     .  . .    . .             .
..    . ...  .        .  .    .     .     .      .            .      .                       .     ..   ..  .       .
.    .    .    .        .   . ..   .   .       .   .    .   .    .          .       . . . .  . ..        .          .
.            . ..        .    .                 ..          . ..   .      .            ..        .   .   .X     .   .
.....  .  .. .     .     .      . .          .              .  .        .. .          .       .              . ..  ..
.....................................................................................................................
