................................................................................................................
.. .... . . .  ....   .  ...  ... . .....    . ... ......   ..  ..  .. . ..  .. .  ...  ...   .  . ..   .. ... .
..  . .      . . .  ...     . .... .  ..  .. .. .   .... ...... ... ....   ..... . . .... ..     .. .  ......  .
.  .  . . ..   ....  .  .. .... .  ..   ..  ... . . .. .  ...   . .    .  .  .............   .. . .  . ......  .
......   . .... ...   .    .  . . ...     . .  ........  . . .  .... ....  ..... ..   . .  .. . .. ..  .. . ....
. .... .  . .. ... . ....   ... ..... .......... ..   .. .  .  .. ..    ........... .  .. . .  . .  ..   .......
.  .. ...    .  ... ....  ... .... ..   ... ..    ..  .    .  . . ....  ... ....  .. ...   ...    . .   . . .. .
.   ..... . .. .. .  .    . .. .. . .   ... ..  .  .   . ....   ..   . . . ...    ..  .     .  .....  .   ... ..
.  ... . . .  . ....   ......... ...   .  . . ..   . . . .  .....  ..  . ..  ..  ..  ..    ... .      . X . .. .
.. . . .... .... . .. ..    .. . . ...  ....... . ....      .. ... .. .   .   ..   . ..    .   ... . .... .  ...
. ... .. ....    ..  .............  . .  .. .. ..    ..        ...   . .  .   .. . .   .      . ...   .    ... .
. ..... .  ..... .. ... ..  . . ..  .. ... ... .  . ...  . .  ..  .   . . .... ... .       . ..  ..   ... . . ..
..  .  .. .. ....  .   ..   ...  .........     .    .  .     ......      ....     . ......  .  .   .  ...... . .
.....  . . . .. . . .... ...       .  ..   ...   . . .  ..........   .   . .   ...  ...... ... . . .  .......  .
. .. . ..    . .   . .   ..  . .... . . .  ...  . . ... .... .....      .... .....   .... . .. ..  . . .........
....   .  ..... .... .  ......  ... . .    . . ..  ..  ..   ....     ...   .    ..   ...  . ..    . ..... . .  .
.  .... .  .. .   .   ..  ..........  . ..... ..  . . ..  ..  .... . .. ... ....  . .. ..... ... ...  .. . . . .
. .  ..... .   ..  .  .  . .  ....  . .. .  .    . .... ....... ........ .  ..  . .. . .  .    .  . . .  . .. ..
. .   .. . ... .  ..  .. . ..  . . ... ....  ... . .... . .  .. . ...  .. .. .. .. ... ....   . ..  .....  .   .
...  .  . .. ..  ..  . ....... ..   . . .. .   . .   ...  . . ....  ...  .   . . .... ..  .  ... . .. .. .   . .
. ..  . .. ...   .  ... .. .   .. . .  ... . .     .. . .. ...   ..    ..  ....  ... ... . . ....    .. .. ... .
...  ....   ..   . .   ....  . . .       ...   ..... ....  .. .. ... . . .. ... .  ..  ........ .  . . .  ......
..   . . ....... .. ... .. ...  .. . ..... .   .   ....... . .  ... .  .  ..   .    ...  ... .  .    ..  . .  ..
........ ..   ......... .. .   .... ..  .  .. ..  .  ... . ..   .. .. ... ..  .. .....  .. . .. ......   .. . ..
.. .. .  ....  . .  .  .  ....... . ...  .    ...  ... ...  ..  ..  .  ..... ... ....  ..  ...  ...      . .   .
..    .  .   ... ..   ...  ... .  .....  .. . ..      ..   .. . . .... ..... ..    .  ..  .  .. .......    .. ..
................................................................................................................
