........................
.. ...... ....   ..   ..
... .  ...  ....  ......
. . . ...... ... ....  .
..  . .  .    .  .   ...
.......   .....  . ..  .
.   ...    . .  .. .....
.  ... .  .     .   .. .
.  ..  .. ..   .. . . ..
.. .   ....... .   .....
..   ..   ..   ...   X..
.   ... .. . .... ... ..
..   .. ...  .. ........
.. ... . . .   . .. .  .
. ...... .  . .  ..... .
. .. ..  ..  .  ....   .
.. .  .....    ....  ...
.  . ....   .  . ..    .
. .  . ..  .  . ..... ..
.. .    .    .    ..   .
.  .... .   .    .  .. .
...   . .   ... .  . . .
... ...           .... .
.  ..  ...  . . .. .. ..
.  .     .   .     .. ..
.. ..      ..  ..    ...
.   .....    ..  .. .  .
........................
