...........
.. . .  ...
.. . .. ...
.  .  .....
.. .  .  ..
... .  .. .
. ..   .  .
.      ....
.      . ..
..... X....
..  .... ..
. .  .   ..
.... . ....
.   . . . .
... . .. ..
.. .... ...
.   . ... .
...........
