.........
.   . . .
.. . .  .
. .   . .
. . . . .
. .  X  .
. .   . .
.   .  ..
..  .....
.       .
... . ...
. .   ...
...  .. .
.  .  ...
.........
