.............
. .     .  ..
.  X   .    .
. .      .. .
.............
