.......................................................................
.    X  .     .  .. .  .                     .           .  . .     . .
.          .   .         .      . .   ..               . .        .   .
.. ..              .   .  .  .  .              . . .       .    ..   ..
.          . ...    . .     .. .      . ..   .   .     .   .       ....
..   .  ...    .             . .   .   . .   .. . .   .  .       .   ..
. .      .     .            .  .     .   . .   .      .  ..  . .. ..  .
.        . .   .      .   ..  ...  ..    .  ..              . .   .   .
.    .    ...       . .  .   .     ...     .  ..  . .. .   .  .     . .
.      .. ..             .  .       ..      . ....              .     .
..             .                .  ..      .  .         . . ..  .     .
.......................................................................
