..................................................................................................................................................
.         .             .   .         ..                         .        .           .    .                  .                 .    .           .
. .        .            .  .     .        .                                                             .                               .     .. .
. .              .       .                     .   . .         .             .          X              ..    .                   .             . .
.                     .. .       .  .      .                          . .    .        .                        .     .          .  .  .          .
.     .  .                     ..          .  .         .    .  .                                    . .                      .  .               .
.   .   .                 ..      .                                 .  .                                          .     . .                     ..
..................................................................................................................................................
