........
.      .
.  .   .
. ...  .
.    . .
.      .
.  . . .
.     ..
.   .. .
.   . ..
...    .
.   .. .
. . . ..
. X.. ..
.      .
..     .
.. . . .
. .    .
. .    .
.    ...
.  ..  .
. .   ..
.. .   .
.      .
........
