......................................................................................................................
..     ..             ..       .  .        .   . ..          .    .. .         . .   .  ....  .  ... .       .       .
.    .    . ..           .  . .      .      ..    .    . ..          .     ....   . .  ..      .    ...    . .       .
.   .         . .          . ..       .  ..  .         .   . ..   . .     . .            .  ...        . .   ..      .
..    . .  . . . ..         . .    .    .   ...    . .  ...     ..       .   .....  .   .    .   ... ..       .  .   .
.  .  .  . . ..    ..  . .  .     .     . ..      .  .           . ..      ...        . .. .  .  .  .     .   .     ..
. .     .     . .       .. ..  .    .   .  .  ..  ..    . .    .    .   ..  .  ..  .              .      .  .. . .   .
...    .  .             .  .  .      . .. ..     . ..   .       ... .   ... .          .   ...    . .         . . .. .
.   .      ...    .   .  ..       ..   . ..         .     .. .   .  ....         .     .  .  ..   .  . .   .      .  .
.   ..  ..          . .  . .     .. . ...          ..   .  .  .     .      .     .      . ...     ..            . . ..
.   .  ..  .           .      ..   ..      .   .     ..   ..    . ..     .  .  .     .. .       .      .      ....  ..
. ... . .. .    .     .   .    ...   .     .. .   . .   . . .    .  .      .       .       ..   . .     .     . .  . .
.      .     .     .      .      .      .   .      ..    .   ..        ..  ... .    .     ..    ..   . ...      .    .
.   .X       .  ..    . . .   . .   .         .   .   ...  .  . ... . . .    .          .               .   .        .
.       . ...     . . ..      .         . .    .. .    . .   ..        .. .    ....  . .      . .     ..    ..  .    .
......................................................................................................................
