.................................................................................................................
.             .         .  ..             . .  .                            .         .    .    .            .  .
.     .                 ..   .         .                                         .       .                     ..
.              .      ..                                                           .                .           .
.            .                 . . .     .  .                   . .    .      .    .     .                      .
. .  .    . .   .               .        .                       .      .            .             .   .        .
.                                  .                                             ..            . .             ..
.          .  .                                                                       .      .           ..     .
. .    .            .         .                   . .           .                  . .            .      .      .
.                          . .                        .    .  .  .                 .                            .
.                 ..   .                                 ...                           .      ..           .  . .
.      . .                .                .                .                                .      .    .  .  ..
.        .     ..       .            .                      . .  .               .         .                    .
.           .                     .              .           . X  .    .            .              .          . .
..   .                 .                  . .                .         .        .      .   .         .          .
.                ..                   .      .   ..  .     .                    .                              ..
.           .       .                               .  . .       .                .       .              .      .
..                        .                                        .                                         .  .
.          .             .     .         .   .     .     .                 .  .    . .                         ..
.       .    .                      .           .                          .                              .     .
.    .                   .                       . .  .                                            .       .    .
.    . .    .                 .                          .              .        .            . .     .         .
.                                              .      .                                                     .   .
.        .            .             .        .   .         .                  ..                          .     .
..          .           .. .  .      .  . .            .     .            .                 .     .            ..
.................................................................................................................
