............................................
...     . ..      .                .    .  .
.             ..          .  ..       .    .
.      .. .        .                .    . .
.         ..                           .   .
.                    .     .               .
..   .     .     .      .         .        .
.     .            .                 .     .
. ..                          .            .
..   ..           ..   .              . .  .
.  .     .        .      .            .    .
. .    .      .     .              .   . . .
..                             .           .
.          .          .   .  .          .  .
.    ..    .   X   .             .     .   .
............................................
