..........................................................................................................................................
.                . . ..     ..    ...   . .   .....   ..    .    .    .   . ..  .  ...   . ..... .... . ....   .. . .. . .     .   .    ..
..   .. .. .    . .  . ..   . ..  ...   .   .   ..   .  ..  .. . . .   ..       . . . ..... ..... .        ..  . . ..      ...    .     ..
....    . . ...    .  .. . .  .  .   ..  .. .  . ..   .  . ..      .. . ... ..   .    . .     .    .... .   ...       .  . .  ... .   ....
. ....  .  .   . ..    .  ..   ..   .   ... ..         .     . ..  . .  ... . .   . .     .  . ..  ....  .....    ..   . .  ..   ..  ... .
.. . .   . . ..  .     . .... .. ... . .  ...  . .  ... .. .   .. .... ..  . .   ..  . . .  ..... .  . .  . ..  .   .... ..     .  ...   .
..   . .    . .    .   ...   . ..   .  ..... . .  ..  .... .. .  .  .  ..    .  .. ..   .. ..  .   . .  .. . ..     .  ..  ..       .    .
..   . ... .    ..  .. .          . .  .. .      ..  . . .    ..             ..        .     .           .. ... .    ..   .     .. .. . ..
.  . .      .     . .   ..   ..    ... .    .    .    . . ...    . .   . .      . ..    .    . .      .  X    ...... .    . . . .. .   . .
... . ...   . .    . ..... .  .  . ..  .. . .      ....      ..     ....    .. . .  .. .....   .   ...  .. .  .    ...    . ..    ...    .
. ..  .  . . .... . .    . .      . .  ..  .    .. . .   .   .. ... .   . .    . .         .... .. .  .    .  .. .        .  ..... . ..  .
.. . . . ..... .... . .. . ... ..    ... . .. . ....   ..  .  ....  .......... . .  . .     ....   . ... . .     .  . .  ... . .  . ......
..........................................................................................................................................
