.............................
.  ..   .  .        .  . . ..
.     .       . .   .       .
.   .  .      ..    X    .  .
.. ....    .   .. .. .. .   .
.. .  ...   .  .  ..       ..
.. ..    ....   .. . . .  ...
...     . .     ..         ..
..  . ......         .. ..  .
. ... ... ..  .   .         .
.            . . .   ..  .  .
..    ..   .... . . ..   .  .
. ..    . ..       .  ..    .
.............................
