................................................................................
... ... . . .... .. .... ... .   . .... .   .. . .      .. .. .. . .  .. . ..  .
..     ....  . .  ....  . .. . . . .. .... .. . .... .. ......  ... .  . ..... .
.. ..   ........ . . .......X ....      . .  . ..  . .    .......  ...  ..     .
...  ..... . .... . .    . . ......   .  ...  . ...  .. . ..  . ..  ...      ...
. .. .. .. .   . ... ...   .... ...  .  .. .. .. . .   .. .. ... .  . .....   ..
.. .  .  .   ...  ..   ... .. .. . .  .  . . ... ...  .. .. .    ...  . .  .. ..
. .    . ..........  . . . .....   ... ....   ... ..   ... .. .. . . . .  .... .
.. .........  . ..  .. ..... . .. .   . ..   . .  .  .... ..  .  . ...  . ..  ..
. .  .  . .. .... . ..   .    .. .   ... .. .. .......   ... .    ..  .....  . .
..... ...    . ....... . . .  ..  . ..    ..  .. .. .... . .  ..  ....  ..  . ..
.... . ....  ....  . ...... ....    . . .  . . . . .. . .    . ..... .   . .. ..
.. . .   . . . ...... ..........     ..   .. ......  . .. .......   ....... ....
...   .. ...   ... . ... . .. . .... . ...     .. .    ....   ... .  . ....  ...
.  ...  . ...  ..  . .  ...  .  . .... .  .. .  ..   ..  ..  .  .... . . . ... .
..  ..     ..  .  .    . . ..  . ... .. ....  .. .   . ......  ........ .  .  ..
....  .   . . . ..  .. ...   .     .. ..... . . . .. .. .  . ...  .  ....   ....
.. .  . .   .  . .... . .  . .... .  ...      . .   .....  . . . ...    . ..  ..
..  .   .. . . . ...  . .. . ..   ...  .  . .....  .. ...... ...    .     ... ..
.    .  .. ...  .. ....  .  ...  . .. . . .... . . .......... .  ..   . ..    ..
. ..   .. ...... ...    ... .   .  . ....  . .  ............ .. .     .  .     .
. .  .......   ..... ... . ..   .... .. ..... ..    ..... .   .    . ..     .. .
. .   . .  .. . ...... .  ......... ....    . .. .    .. . ..   . .  . .  .. ...
. ...  ... ..  .... ... .   ..   .     . .. ..... ... .. ...    . . .... .. .  .
................................................................................
