...................................................................................................
.             .        .                 .     . . . .           .        .              .       ..
.         .        .         . .               .   .            .                              . ..
.             .     .         .           .            .             .      .                     .
. .               ..         .   .            X      .       . .  .     . .. .   .   .            .
...................................................................................................
