.............................................
.    .  .         .        .   ...          .
.   .            .. .         ..        . . .
.  .  .  . .    .                  .  .    ..
.           . .       .   . . .         .   .
.    .    .. .       . .. .     .  .     .. .
.   ..                     .       .. X   . .
.     .    .    ..      .   .     .  ..     .
.       ..        .        ...   .        . .
.  ...          .    .  .  .   .  .       ...
.   . .    ..    .  .  . .  .     ..        .
.          ...          .          .   ..   .
.       .   ...    .  . .    ..   ..    . . .
.                 . ..  . . .         .  .  .
.   .            .   .    ..            .....
.  .      .                  .    .   .  . ..
.    .         ..  ...     ...   .    .    ..
.    . ....   . ..  ..  ..      .     .     .
. .      .      . .. .. ..   .     .  .     .
.  .    . . .     . .  ..            . ..   .
.                 . .     .. . .         .. .
. ..   .   .     . . . .    . . .   .       .
.  .        .  .  . . .  .     .    .       .
..     .   . .  .  .              .  . .    .
.        .  .  .     ..  . .  .             .
.. . .    ..            .           . .     .
. ...       .    .  .  .. .   ..      ... ...
. .     . ..  . . .  .       .   . .. .    ..
.............................................
