.............................................................................
.  . . .. . .. .  ...  .   ... . .            .     .. .    .  . ..    ......
.. ...   .   .  ... .. . .   .  ..   ..  . ..   ..  ....  .. ... . . .   .. .
. .   .    ..   .  .    .  .  .  ....... .   . .. ..  .. . .... .. ...   .  .
...  .  .  .. .  ..  .  ..  ... .        .  .  . ....   . ... .....  ...    .
..  .  .        .. . . . ..   .    . . .. .  . .  ... ....  ..      .. .    .
.     .  .     .    .  .. ..  .       ... ....      ....     . .      .  .. .
.  ..     .     ..    . .......      .   . .   ....   ..   .  . . . .    .  .
...  .  .  ....          ..  ..   . .   ...  . ..      . ..  ....          ..
. ....  ...    .  .    ....  ..  .    . ..   ..  . .   ..  . ..        . . ..
..     .   . .   .. ..  .       ..  ...... ....        ...      . .  .  .. ..
.  .  .  . . ..   ..  .. .  .    ... . . .  ..  .      ..  ..  ..    .  ..  .
.    .  .  ..  . .    .   . ..     . X.    . ... . ..  ... ..   . .... .    .
... . ..   ..  .. .. . .. .... .    ...    . . ..   .  ..    .. .  ... . .  .
.  .     ..  .. ...  .    . . .   ..  . .. ...  .. .  ..  ...  ........  .. .
. ...  ..  .   . ...   ...... ... .. .       ..   ... ...    ...            .
.............................................................................
