.................
...  . .  .     .
.. .   ..   . ...
. . ....    ... .
.    .  ...  . ..
..      .   . . .
.. .     . .. . .
.  ...  . ..  ...
..        . .   .
.  .. . .. .  . .
....  .    .    .
. . .    .     ..
.  .        .   .
..   ....    .  .
.  ..      . .. .
.      .      . .
.. . . . . ..   .
.. .      .......
.  ..   .  .   ..
. .   .  .... ...
.. . . ... ......
.X.  .   .   .. .
.   . . .       .
..  .       . . .
.  .   .       ..
.................
