................................................................................................................................
..  . .. ..    .  ....  ..      ......   .   . .. .. ..     X  . .   .          .  ...   .    .     ...  ..                  . .
. . .  ..         .  .   .. .     ..    ..        . .          . . . .  . . . . .   ..      . .      .    ...   .   . ..       .
. .  .   ..     ....           . ..  .. .  .. . ......       . ..    .  .. .   . .. ..  .    .  ... . ...  . .        . .     ..
..  .    . .   .   . .   .    .         .   . ...  ...        . .    .    ..       ..  .         ..    . ... . .     ..    .   .
.   .    ....              ..  .     .      .    .  .   .     . .   . ..  .     .. .    .   . ..     .  . . . .   ..  .   ..   .
.  ..     .     ...   . ....     . . .         . . ..      .. . ..      .    .  .   ..          .  . .          .   .       . ..
.   .     . ... .   .   .    .  .   .    .             .  ... .           .. . .  .    .         .       .  .  ..  . .    .    .
.   . .  ..         . .  .      ...    ...   .   .               .      .   . .  ... ..                  ..  .. ... .     . . ..
.. ..  .....     .  .  . .       ..    .  . ..        . .. ..             .    . .   ..       ..    .    ......         .. .   .
.  . .     .   ..    .. .    . .        .. .          .. .  .   .  . . .  .   .     .. . .... .        . .  .  .  ..      .    .
. .   .             ...                    .   ..  ..  .   . .. . .    .     .  .        .   .      .. .   .        .         ..
.    ..        ...    .       ..       .  ....     . .    .        .         .  .  .   .  .       ..     .   .  .   ..    ...  .
.. .  .  ...   .    .     . . .  . . .     .   . .    . .     ... .   .    .      .  ..   ...  .       .      .     ..  ..   . .
.       ..    .    .  ..   ... .   . .     .   . .     . .  ..            .    .    .   ..       ..         ... . . .     .  ...
.              . ..  .   ...                     ..      .        .     . . .. .... .        .   . .   . . ..    ..  .. ...  . .
. .    ..        ..     ....    .            . .  .      .  ..          .  .       .           . ...   .      .....    .  .    .
................................................................................................................................
