........................................................................
..     .        .        .      .          . .   . . ..  .  . .  .     .
..         .     .    .  .   . ..     ..                   ...   .     .
.       ..      .                           ..  .     .. ..     .  .   .
..X  . .    .      .      ..     .        .  .  ..  .              .   .
.      .      .  .     .. .      .   ..      .  .             .     .  .
.    . ..            . .   .  .  .       .....   .       .      ..    ..
.   ..    .      .         ..     .      .  .. .         .      .     ..
.  .   .      .       .  .    .    .           .  .    .       .       .
.    .   .    . . .  . .    .  . ..      .     ..          .       .   .
.        .   . .  .  .  .. .  .               .       . .     .       ..
.. .           . .     ..      .    .     .    ..  .          .     .  .
.     . ...    .  .  .  ..  .  .       .      .  .     .  .   .     .  .
.            .         .         .    .              .     . .         .
. . ... .     . ...        ... .    .....                     ..       .
.  .   .. .            .         .                    .          .     .
.       .          .             .    . ..   .   . .  ..               .
.              .         ... .. .   . ..  .    .  .. .     . .  .   . ..
.   .            ..  ..        .  .     .        .            . .      .
........................................................................
