.............................
..  . ..    ..  .....   ... .
... .   .    ..  .  ..   .. .
.... ..    .    .....     ...
.. ......  .. . .....   . . .
. .   .. .. . ..... ..      .
.  ...     .. ..  . ..   .. .
... .    . .  .  . ... .. ...
. ...  ... . . .    . ..... .
. ..  .  ..     .. . . ..   .
.  . .. ...    . ........  ..
.   . .   . ...    .. . . . .
. ..  . . .. .  .  .     . ..
..       ...     .. ...  . ..
..     . .  ... .     ....  .
. ..   .. .      .X. . .  ...
.............................
