................................................
. .          .     .   ...   .  . ....   .    ..
.X.     .    .   .     .  ....  .      .  .  . .
.. .  ... ..  .  .    . ..             .   .   .
.     .    .  . .      .     .  .        ..    .
.        ... .  .. .     ..  ... ..   .   .    .
. .   .   .     .   .   . ... .     . . .   . ..
...  . . .. .  ..     .     .        ..    .   .
..   .    . ..     .. .. .      .  . .. ...    .
.     .     . .  ..      ..      .. .   .   ....
.      . .     ... . . .   .   . ..        .. ..
.   ..    ...   .      ..  ..   . ...      .  ..
..     .      .. . ..      .  .   .         . ..
. .  ...    . .  .             .     .   .     .
.       ..     .     .     ...  .   .         ..
................................................
