..............................................
..... .  . . .     ..    ....... ..  ... .. ..
. .  . . .  .... .. .    ...  ..  .. .   . ...
..  ...  ..   . . ..    .   ..   . ..... .   .
.. . ......... .  .  ...   . .  .   .    .. ..
.    ... .  .....  .. .  .  .. . . ........  .
.       ..   ...     .   .  .   ....     ..  .
.        .. ...    .      .... .... ...  ..  .
.. . ..  .. .   ... .. ..         ... ...  ...
. . . ....   .. ...... ..       ..    ...  ...
..    ...  ..    .  ...   .  .  . .   .... . .
... .   .  .... .. . ..        ..   .    . . .
.   .  .  . . ...    .      ..  ...   .  ... .
.  ....... .    .    .  ... . ..  ...        .
.    . ..  .    .    .... ..  .... . . .  . ..
.. . .    .. ..    .. ....X...  ..    . .   ..
.. .... .  . .  .....        . ....  ... .. ..
.. .. . .. ... ..  . ...  .. . .  ... . ..  ..
.  .  .. .. .   .... .. .   ..   . . .    .. .
.. . .   . . .... .  ...  .. ..  .   . ..   ..
. . .  .  .. .. .. .. .... .  ..... ...    ...
.. . ...  .. .  ...  .  .. ... ... ..  .......
..      . . ..... . ..  . . .  ...    .. . . .
.. . ...  ...  ..   . .  . ..... ... .... ....
.    ..  .. ... ... .. ... ..    .   . . . ...
.. . ..    .. .   .. ..  ... ...  ..... . ....
..............................................
