.....................................................................................................................................
.. .    ..   ..    .  . . .         . . ... ...   ... . .   .. . ..     ..          .     .      .   .        ..     ..    .   .   ..
.    . .  .      .. .. .        .     .         . ....  .. ... .   . .   ..      ..   . . .. . ...   .. .          .  .         .   .
.      ..           . .      .  .   . . .      .    .      .... .   .  .  . ..  . .        ..  . . .   .      ..  ..  . .  .  .   . .
. . . .     ..   ....   .     .              ..     . ....    ..   . .. .    .     . .    ..   X.     ..    .        . .  .       . .
.   .   .       ....      .   .       .    .  .     .     .  .   ... . .   ...    .  ..   . .  .  .  .  ....   .    .       ..  .. ..
.   ...  .   .  .      .     . .. ... .  .    .  .  .        .  .  . . .  .  .      .     .   .         .       ..   ..   ..   . .. .
.        ..        .   .  .  .   .... .  . .  . ...   .      .    ....   .  .  .       .  ... .    .. ..       .   ...      .     ...
... . .  ... .. .             . ....    .      . .   .   ....  ..   .. . .  . .    . ..   .   .    . .     ..   .  ...  ...  .. . . .
. .     .       .  .   ...    .  . ..   ...  .  .   .   .  .    .    ..      .. ..      ..    .   .     .            ..  ..  .     ..
.    .  . .. .   .       .    .  ..   .. .  .      .    .   . .       . ..    .  . .   .. .. .. .. . .           . . .  . ....      .
...    . ...   .  .. ..   . . .  ....    .. .   . .   .     .     . . ..     .     .....    .    . . .  .   .   .   . . .          ..
...      .. . . ..  ..      .  ..    .    .     . .    ...    . .  .. ... .           . .. . . .   .            .   ....   .. . .   .
.. .. .    . .   .    .  .    .. . .     . .. .. . .      .. .     . .. . . .   ..  .     .  . . ..  ...     .   ..   .   .  .  .   .
...   .   .  .    .  ...  ... ...  ....    ..    .     .   ..     .. ..   .  ..    ..     .. . ..  .  .  . .. . .      ..   .    ....
..  ..    ..  .      .....      .  .      .. . .    . .   .   .. ..    . .  .  ..... ... .. .    ..  .    .. .   .   .     ..      ..
..   .  ..    ..  ....       .  ..  .         ...         .  .....   .   . . . .  .. .  ..  .    ... ... .. .    .       . ...    ...
.. ..    ...     .  .      ...     .     ..     .   .       . . .  ..   .         . ..    . .      .     .    .         ..     ......
. . .   .   .  .      .    . ..  .  . ... . .  ..   ..      ..    .  . . .   .. .....  ... .. ..  ..     ..   .        .  .  ..  .  .
. . .     .      .  ..    . . .     . . .  .    . .    . . ... ..  ..    ..           . .  ... . . ..  .    .  .        .   .   ... .
.....................................................................................................................................
