...........................................................................................................................
..  .   ..        .       .... .  ...  .   .    . . .    . .  ..  .    ....     ...     .  .   .    .  ...   .      . .....
...   . .   . .  ....      . .  . .   .. ... .    .    . ....  .....   . ..  .   . .. ...     ..    .  ...  .. .  ...  ....
. .     .      .   ......  .. . ..  ..  ...   .   .. ....  .    . . .       .. ..    ....     ..  ... ..     .  . . ..  ...
..    ...  .  . ... . . ... . ..  .  ....  . . ....   .. .   . . ... ....   .    .  .  . ....... ....  ...  ..    .. . ....
. ..          .       ...   ....  ... ..  . . .....   . .. ...     .   . ... ...       ...    .......  ..   .... ..  . . ..
. .  .....        .. ... .. ..    .    ... ..   . ..    .  .....   .  ... .  .... .    . ..   . . .....     .. .  . .  .. .
.  .. .  ..  ....  ...  .      .........   .. . ...... .. .   .  ..   . ..    .     . .. . .. ....     .. .    .  . .. ....
. ....... .....       ....  . .. . .. ..  . .  ...  ... .  .... .. .   . .  ... .  ...... . .        ... .. ..  . .  .. . .
..  ... . .  . ......   .     ..    .      .  .   . .  .     ...     . ...  ... .  .. .    . ..  ..  . . ...     . ..   . .
. ..   . ..  .. . . . .. . ....  .   ..  ..  ...  .  .. .  ..    .. . .. .    . .  . .     ..  .  ..   ..... .   .   . .  .
..  ...... .        .   ..... ....   .  . . ... .  .. .. ..    .  ..  . ..  ..         ..   ... ... .    .  ..   .....  ...
. .   ...    . .. ...  . ... ....     .      . .          .... .   . .      ...  ...  ...           .  .. .  .  ... ...  ..
..    . . ..  ... . .... ....    .. .   .. ..   .  .   ..    ..   . .... ....... .   . .    .....  ..    .      ...   .   .
..       . . .  . ..     ... ..   . .  .. ... ..  ..  ..  ..  .   ..  ..   .  ..  ....    .  . .....   .  .   . .   ...  ..
..  ..   ... . .. .   .  .. . . .  . .. .  .. . ...  ..     .    ... . .  ... .. . .  . .  ... ...  .. .. . ..  .  ....  ..
... .     .  .   ... ... . .     .  . . ....  . .  .. . ... ..... ..   .  .... .    .  .   . . .  . ..  . . . ...  . ..  ..
.  .   ..... .....  ..   .    .  .....  ... ..... . .   .. ..     ... ..... .  ..  . .  .... ... ... ....  ..  .   ....  ..
... . . .. ...  .   . .   . . ..    ... ... . .... ...  .      .    .. . .         . .. . .... . . .. . .. .   .   .   .. .
.    .    .   .. .  ..     .  .... .   .. .... .... .. . .  .  ..    .....  . .  .. ... .  ..  ..  . .    . .... ... .    .
.... .. . ...   . . ....   . . ..    .......   . .. .   ...   . .. .    .   .   . .. .. ... . .  . .......  . .  .  .......
.     .. ...  .... ..   . . . .   .   ..  .... .   ..  .   ....  . .... ..  . ... ..       .. ..  . .  .  . ..   .  .  .  .
... ... ....   ..      .. .    ......     . ....  . ..  . .     ..        ....  ..  ..   .. . ...  ... .. .   . . ...... ..
...   .  . ..... .   ... .   .. .     . ..   . .  .    .... ..   .     ....  .....  .. ...     .. .       . .. ...        .
....     .  ..  . .   .  . .. .   ... .  ...    .  .  .. .. .  ..... .     . . ..   . ...  .   .  .... . .  .     .. .  ...
.  ..   .  .    . .  . ..   .   . . .... . . ..... ..  ....   .    . ..... ...  ...  . .  . ... .. . .  ..  .. .  . . . . .
. ... .  ...    ...  .. .....  .    .    .  . . . .     . ..   .  .X . .. . .  ...   ...    ..  .  . ..   .... . . . ......
....... .  . .  ....  .   . .. ... ....  .  .. .    ..... .... . .....  .   .  .. . . ... .    .. .. .  ... ...  .  .   . .
...........................................................................................................................
