......................................................................................................
..  .... ...   ..  .. .  . ...   .. .  ..      ..   .       .  .  .    . .  ..      .....    .   .. ..
.  .... .  .. ... .. . ..     ..... ... ...   . .  . . . . . . .   .. ...   . .... . . ... .   .. . ..
...      . .    ...  ......     .    .         ...   .          ..    .  . .    ..  ..... .. . ....  .
..     ...   . .    .. ..... . . .  ..       . ..     . ..    . . ... .    ..... ....   .. . ....  . .
.  . ..... .  ... .  . ..    . ...     . ... .  . .   .   .. . .. . . . . .... . .   . ....     . . ..
... ....  ..  ... . .. .. .....     . ...    .    .     ..  .  . .  ....   .      . ... .    .   .....
. ..    ..  ..     ..   .    . . .... . .   .  ....  ..   ..  .. . .       .  .  .  . X      .   ..  .
...     .     .  .  ..   .....  ... .   . ...  .... ... ....   .       .     .  .  .. ..   .......   .
. .   .    ..  . .   ..    ..         ...  .. .         . ..   . ..   ..      .  ... .  . ..  .  . . .
. .   .  .  .    ....        ..    .   . . ... . ..    . .   ...  . ..  ....    ... ... ..  . . .  ...
.  ...... . ..       . ..  .   .. ... .. ...  ..   .   .  ....     ...  .   . . ...  ..   ..        ..
..  ....   . .   ... ..  ....  .. .  .  ... .      ..  . .... ..           . ...... .            .. ..
... .  . . . ...  ..    .. .....  ....   .   .  ..   .    . ..  ..  . ... .  .     .      .    .   ...
.   . . ..   .. .  .    .... .. .. . . .  .... ..     . ... .     .    .. ....  ..  ....    .  .  .  .
.   ..   .  .   .     ..     ..    ..     ... . .    ... .. .. . .. ......  .   .. . ..    ..  .   ...
.....  ...  ..  . . .   .    .. . . .      .  .  . .  ... . .    .  ..  .    .  .    .. .  . .       .
..  ....  .   .   .       ..  .   .  .....  . ... . .   .   . .... .  ..  .  .  ..   ....       . .. .
..      .   . ...      . .  .  ......     .   .. . ....  . . . .   . .  ..       .      ....    . .. .
. .. .  . ...     .  ..  ..   .  ..    .    . .  .   .   .    .. ..  . ...  ..  . ...  . .   .  ..   .
.    .    .. ..  .  . ...  ... ..      .... ... .   .  . .   .    . ... .     .. .        .   .    . .
... . ... .  ..   ..    .   .   ..   . ....      ......  .       ..     .     .. ..    ..      .  .. .
....  .  . .   ... .  . ... .   . ..   . ..   ..  .  ..   .  ...   .       ... . . ... .   .. .  .   .
. ...    .  .. . ......    .  . ... .. . .. .    ...   .   .      .     ... . ... ... . .     .. ... .
. ....  .  .. ...  .. .    ... ...  .. ... .  ..  ...  . . ..     .   .. ... ...     . .... .. .......
......................................................................................................
