..............
.           ..
.            .
..         X .
..............
