............................................
.    ... ... ..   ..  .. . . .   . .  .  . .
....    .    ....  .. .. .  ....  .     .. .
.   ...      .  . ...  . X  ...  ..  ... ...
... .. .     .  ..    .          ..  . .   .
..  ... ..  . . .. .  ..   .. . .     .    .
.  .  . .    .. ..  ..  .     ..      .. ...
.  ........  .. . .. .  ....       .     ...
. .  .. .  ....  ... . . ... ..      ... . .
.  .... . . . . .        .        . ... . ..
.  .  .  . .  .. .   . .    .  ...   .. .. .
............................................
