............................................................................................................
.     .      .                      .       ..   .   .                                      .              .
.                  .                     .                        .  . .  .        .       ..    .      .  .
.   .                                                   .                .   .              .          .   .
.           .      .              .    .              .     . . .     ...       .   .   .                  .
.           .. . .      .       .        ..      .      .   .          .             . .     ..            .
.  .         .         .                   .                     .      .    .            ..         .     .
.     .        . .             .   .         X     .      .              .            .       .. .   .     .
............................................................................................................
