................................................
.  . .    .  .         ..    . .               .
.       .   X.  .       . . . .        .. .    .
.     .     . ...  .   ..     . .  .          ..
.       .    .  .        .  ..     . . .  .    .
...           .    .  .   .    .            .  .
.     .   . ...     .    .               .    ..
.  .            . . ..   ..      . .    ..   . .
. .     .  . .  .   .     . .  ..      ..     ..
..          .. .      .. ..       .  . .  .    .
................................................
