.....................................................................................................................................
..             .       .          .                                       .          .             .              .      .          .
.    .            .      .            .      ...            ..       . ..      .        .           .         .                     .
.  .                              .        .     .              . .     .       .                               .     .     ..      .
.                      ..   .                ..         .  . .                      .       ..         .                            .
.   .      ..        .        .                      .          ..  .       .                    .                                  .
.             .      .                                                   .                            .             ..        .   . .
.        .          .                                   . ..                                .      .  .                . .          .
. .                                        .      .            .                  .                                .   .            .
.   .                 .             .       .    X             .  .                   .                       ..                    .
.      .          .  . .        .                .        .                       .                   .                             .
.       .        .         .      .               .       .                     .  .     .                           . .     .      .
.        .                         .         .               .  .        .                   .                                .     .
.       .     .                        .                    . .                  .    .  .               .      . .                 .
.     .                                            .             .   .            .  .          .               .             .     .
.   .     .        .   ..   ..   .      .  .      .       .      .     .               . .  .          .                 .          .
.                        .            ..                                                             ..         .        .   .      .
.....................................................................................................................................
