.........................................................................
.   . . .   ... .... ...   .  .   .    . ..    ..  .  .  .       .. ..  .
.  .... .    ..    .   . .   ..        .. .   .     ... ..   .  .    .. .
.   .  . .     . .  ...     ..        . ..  ....   ..  ..        . . .  .
. . .          .. ... .  .  .  .   ... . . . . . . .. . . .  ..  .. .   .
.. ..  .           .  .    . X.  .  .  ...  .          .       . ..     .
..  . . .   ..  .   .    .   .   .   .    .   . ..  .     .    .    . ...
..      .....       ..  . ...  ....    . ..      .   .   ....  ..   ... .
.........................................................................
