....................................................
. .. .  .  . . . .     .    ... .  . .... . ..  . ..
.   ..  .. .   .        .. . ..   .   .   ..... .. .
.  .... . ......  . . . ..  ..  . . ..  ...... .  ..
..   ..   ............ . .. . .  .     .. . . .  . .
.... .    .  . .  ..... .  ..  .. ...  ..     .    .
. ....   ... .  .. . .... .   ...  . .. . .  ...   .
... .  .... ..   .... . .      ..   ... ... .... . .
... ... ..   ... .... .. . ....  . . .   .  ........
.   . ... ..     ....    . .. .....  . . . ..      .
... ... . . . . .. .  .. . . ... .   . . ....... ...
. .      .. .. ... .....    .. . .... ... . ........
.. .. .. .. . . ...  ....   . .. ....   .....  .  ..
.... . .. .  .  .  .... .    .    . ...... ...  ....
.......   .  .. ... . .. .. . . .......    . .  ....
.       . .....   .      ..   .. .. . .. . ... .  ..
.....  ..     ....... ..  ... ....  . .   . ...  . .
...  .   ...  ..  ....  ... ... . .   .. . ... . ...
. .. ..  . .  . .  .  . ...  .    ..... .. . . .   .
.  . . .....  ....  . . . . .... .   .. ..  .. ... .
.... ....   .....  ..  . ..... ..   .  .   ..   ....
.. . .... ...  X. . .  . . .  . . .  . ....  ..  ...
.. ....  .......  .... ...   .     .... . .  .  ....
..  .......  . ..... .... .. .... .. .....  .. . . .
. . .. ..  .....  .  . ... . . ....     ..... .  ...
....................................................
