....................................................................................
...          . ..  . ... . .  ... . . ... .. .   .  ..   ....... .   .  ...  . . ...
. . X .   . . . . .  . .. .. .  . ...  ....  .  ...  .  .   . .     .. ... . .... ..
.  . ..  .....  . . ........        .... . .    ...... ....  ...   .... .  .  .  ...
.....  . ... . . .... . . . .   ..  . .. .... .......... .. .. .       . .. . .  . .
. .... .. .   ..  .. ..  . .. ...   ... . .. . .. . ...  ....      .... .   . ..  ..
. . .   .  .. . .     ..  . ..... ......  ... ..    . .    ..   ..    ..  ... .   ..
.. ....  .   ... .  ... ..     .... . . .....  .  .  .......    .  ..   ... . .    .
..  . . ...  . .  .  ...... .. ..   ...  .           .. ... .... .      ...... ..  .
. .. .    .  .... . . .. .. .      ... .  .....   .   .      . .. . .     . . .... .
.    . .  .   .    . .    . ..    .  . ...  ..   . .  ..  . ..  .     . . ....  ....
....................................................................................
