..........................................................................................................
.   ..                          .            .       .          .    ...     ..            ..  .     .   .
.       .    .      .    .   .         ..    .     . ..  .      .  .           .     .                   .
.   .   .  .     . .  .              .        . .              .   .       .      ..          .  . X    ..
.   .                       .   . . ....         ..      ..                    .     .    ..  .          .
.           ..      . .   .         .  .       .    .    .. . . . .  . .         .       . .  .  . .     .
. .            .         .   .       .        .           .  ..   .     .       .             .          .
.      ..        ..                      .        ..          ..    .              .                    ..
.      .  . .      . .                                            .   . ..            .         .        .
.              ..    .        ..    .             .        .     ..     .               .    ..     ..   .
.  ..   .             . .           .             .            .          .                    .   .  .. .
.            .   . .    .    . . .. .   . .  .  .                       .              .   .  . . .      .
.               .      .    ..  .       .   . .                .     . .            .                .   .
..........................................................................................................
