..............................................................................
. . . .  .   .                .  . . . . . ..        .....  .  .        .  . .
.  . .    ... .. .. .     .  ....  ..      .      .  ..    .   .. . ..       .
. .. . . .   .... .    ..  . .     .. .     ...       ..   .. .         .   ..
....   .     .     . .       ..  ..  . .  ...     .    X    . .  .. . . ...  .
.  .         . . .    .    ... .  . . . . .   .   . ..          .  .  .. ..  .
.  . .   ...       . .   .. ..  ...    .  . ..     .  .        .     . .    ..
. ...          .    . .. ..  .  .   . ...   ...  ..  .  .  . ..    .   .... ..
.. .    ..     . . .      ..   .   .  ..     . .. .          . .   .  .  .   .
.   . . .     . .      .   ..     ..     .....  .   .   .. ...        .  .   .
.      .  ..    .       .          ..      ..     .. ...   ..   ..     . .   .
.   .. ..  . .   . .    . ..  .     .   . ..       .    .    .       .     . .
.    . .   . ..    .. . ..   .      .     .    .. .     ..     .    . .    ...
.       .  ..   .. .. . .   ..  ... . ....  ... .    .    ...    ... . .. .  .
..............................................................................
