................................................................................
.     .    .         ..    .                  .  ..            . X             .
.       .            . ..  .       .        .     .     .   . .                .
.       .         . .            .   .       . .                   . . .       .
................................................................................
