.......................
.                   . .
.     ..      .   .   .
.     . .     .       .
.          ..      .. .
.                     .
.        .          . .
.             .       .
.             .       .
.        .            .
.    .       .        .
.     .           ..  .
.     .               .
.          .         ..
.         .          ..
. .         .         .
.                   . .
.   .         .. .    .
.         .    .     ..
.    .  .           . .
.     .    .          .
.                  .  .
.       .  . .  .    ..
.   .        . . .  . .
.   .           X     .
.......................
