..........................................................
....    .  .  . .   .  .. .  . ..  .  .. .... ..  .   .. .
. ..  .  ..     . ..... . .... ..  .  .. ...  . .... .  ..
...  . . .  X  .  .  . ......  .. ..  ..  ..   .   ... . .
.... . .   . .. ...   . . ...    ....  . ... .. . . . . ..
.......  ..  .. . ...    ...    . .. ..  . .... . ..    ..
..........................................................
