..................................................................................
.   ..... .      ...      X ......   .                 ..  .  ...   .... .  ..   .
.  .  .  ..    .    .    .            ... .  .  .  . ..   . .   ..  . .. ...  .  .
. .  ..   .  . .   .   .         .     .  .. .      . .     . .. ...   .  .    ...
.  . .    .   .  . .. . ..   .  . . .... ..   . ..   . . ..      . ..   .   . ....
.  . .. .   .... . .  .  ... .. .   .   . .  . .   ..     .   . .  .  .  ..     ..
..  .  .       .  ....      .         .   .  .    ..   .      . ..   . .  .      .
.  ..          ..         .   . .    .  . .      ..  . .  .    .    .  .   .. .  .
.   .    .    .        .      .. .   .    .  .   .   .  .       .   . ..        ..
.. ..           . . ..  .. ..   .  . .     . .                  . .     .    .  ..
..    . . ..  ...  ..  . ..    .     .   ..      .    .   ..   .    ...         ..
..................................................................................
