................
..     .    .  .
.. . . ..   .. .
.   .  .     . .
...     ...   ..
. . .  .. . .  .
..       .    ..
.    .  . .. . .
... . ..       .
..    .. . . . .
.   . . ..    ..
.   .. .       .
.  ..  .   .   .
....  .        .
..    .  .    ..
.   ...     .  .
.         ..   .
.   . .        .
...    .  .    .
.   ..        ..
..  ..  . .X   .
. .     . . . ..
.  .    .  .   .
................
