.................................................................................................................................
..      .           .                               .      .         .                                     .                    .
. .         . .          .  .                             .    ..                                       .   .     .             .
..   .          .           .     .  .                             .                .                  .    .           .       .
.                           .        .          .                       .        .         ..        .                          .
.   .                 .     .  .          .          .      . .         .  .    . .     .                                  ..   .
.                  .  .   .      .                    . .              .                  .      .      .                       .
.      ..     . .                     .                          .    ..    ..  .                                               .
.              .          .                .                  .    .               . .      .                                   .
.         .            .    .          .           .       . .                 .       . .        .  .                          .
.    .                                                 .                 .             .       .     .            . .  .        .
.           .       .  .                               .            .            .        .      .                    .         .
.          .  .           . .                   .     .            .                    .             .          . .          . .
. .         .         .       .    .      .    .            .         .                            .  .                         .
.     .     .              .         .                                 .                    .  ..                  .           ..
.          .. ..   .                     .        .  .  .              .              .       .           .    .         .  ..  .
.      .      .    .                      .  .      .                     .              .                                     ..
.       . ..                                  .  .            .                .      .   .              . .               .    .
.        ..                                          .           .  .              .     .                         .            .
. .        .  .   .  .    .        .    .    .           .   .              .X.            .         .               ..         .
.................................................................................................................................
