..................................
....  X. . ..    .   ... .  . ....
. ...  .   . . .. .  ..  .  .    .
..  . .  .    .  .. ... .  . .   .
..          .    . . ..   ..     .
...   . .      ....  ...  ..  . ..
..................................
