..............................................................
. .   . .   .  .  ..      ..    . .    .  ...  ..   .X      ..
.  .. . .      .    . ....    . ..    .     ..    . . . .    .
. . ..  . . .   .   ...   .     .. .  ..         .. .   ..   .
. . ..  .   .  .     .    . .    .     . ..  .     .   ..  . .
..............................................................
