.....................................................................................
..  .    .   .             .             .   .    .            .         .    .     .
...       .            .  .             .     ..    .                               .
.    .          .   .  .     ..         .         ..         .             . ..     .
.    . ..              ..            .  ...                              ..         .
.      . .               .     .         . . .     .          .      . .         .  .
.      ..     .          .         .  .                       .                .    .
.     ..     .      ..           ..   ..     .  .   .     .               ..    .   .
.          .    .             ..  .          .  .. .  .   .     .        .          .
. .         .                  .                  . .                   .           .
.     .  .  ..  .        .     .  .                  .              .             . .
.    ...                               .   . .   .    .              . . . .        .
.  .     .             .     .      .      .           .          .         .   X   .
.   .                    .    .     .      . .          .  .                        .
.                         .          ..  .         .      .         .               .
.   .        . .  .                    .            .. .       .          .     .   .
.           .         .        .          .   ..   .     .     .            .    .  .
.  .                      .                          .     .    .     ..     .  .   .
.  .        .                      .  .. .           .              .  .            .
.  . ..                   . .             .               ...      .             .  .
.....................................................................................
