.............
..     . .. .
...   .  . ..
. .  .... ...
. . .. . .  .
.    .  ..  .
. . ... .. ..
. .. ..     .
... .  . . ..
. ..  . .  ..
. . . . . ...
....  ..  ...
... ..  .   .
. ....   .  .
. X...   . ..
..    . .   .
. ... .  ....
. ..  .  . ..
...  ..  . ..
. ..  . .....
...      .. .
. .   . .   .
.. ... .  . .
.  .    ..  .
. . .... .. .
.............
