....................................................................................................................................
..    .   ..   .           .  .  .         ....          .    .            . .  .    .  .       .      .     .. . .  ..    . ..   ..
.   . .            .        . . .  .     . .     ... .  . .    .  . .  .. ...             ..  ..        .   .   . . .  .     .  .. .
..        .   .    ... ..        . .  .   .   .   .   .           .     .   .  .  . .                  .     ..    .    ..  .  .   .
. . . .    .. .            .  ..    . .   .  .   ..         . ... ..     .  . .    .    .    .  .  . .      .  .   .   .  .   .    .
.  ..            .    .  . .        .   . .  .    . .  .      .. .   ...  . ....     .    .. .  . .      .  .  .  .           .    .
.     .   .  ..     . .     ..      .  .      .... .      .   .    .             .     .  .  .  .   .       .    .       ...      ..
.        .  ..   .   .  ...         .        .    .   .     . .   . . . . .  .       .     .      .  .. . .  .   ...   .  .   .    .
..   .  .       ... ..                ..        .. .....    .. ... . ..          ..    . ..           .   . .    .         .       .
.    ..     ...  .     .  . ..... ......   .   .     .  .               ....        . .... .         .   . .     .. .  . ..        .
..   .    ..  .   .. .       . ..   .    . .          .   . .  .    .  ..      .        .       ..  .     . . .       .. . ... .  ..
.  .              .  ..    . .        .       .   . .  ..     .     .   .  ..  .  ..   ... .   . . .  .    .. .      .   .   .  .. .
.    ...       .     . ..   .  ...  . .     ..           . .    .  .  .  . .. .   .       .        . .      .  .      .  ..   . .  .
.   .. . . .  . .  .    .        ...       .. .. ..          . .  .       .      ...   .    . . .   . ..      ...   . .. ..    ..  .
..  .    .     ..  ..  ..    ..  .... . .   .    . ... .     .           . ..    .           ..   .   .  .   .  . .    .   . .  .. .
.    ..  ..   .       .  .  .  .    .   .   .. .  ..          .. .   .      ... .         .     . .         . ..    .  .  . ..     .
...  .  .   ..        .                 .          .....  . .        . .    .    .    .     .  .  ..  .X      .  .    . ....  .    .
..    .    ..     .        .. ..     .     .       . .      ..            ..   .    .              ..         .  .    ..  .  .  .  .
.            . .. .    .   . .. . .       .                     .. .     ......   .    . . .            . . .  .   .  .           ..
.  ..    . .. ..     ..  .         .. .  . .  .        ..   ...    .. . .   . . ...   ....   ..       .            . . .      .    .
.   .  .         .....     .  .         .     .       .   .. .         ..    . .  . ..        ..  . ... .  . ....  ..         ..   .
....................................................................................................................................
