.....................................................................................
.    ..  .   .   .   ..  . ..   .  .       . .     . .         .           ..      ..
..   .  .     .    .          .   .    .         ..   .   .  .  . .      ..  ..     .
..       . . ..    .   .     .         . ...     .  ..      .  .   ..        ..     .
.     .              .      ..       ..  .. .                 .             .       .
.   ..     .  ..   .  .  .     .  . ..      ..       .           .  .  .    .   ..  .
.      .     ...   .     .      .    . .       ...  ..     .     .. ..       . .    .
. . .. . .  .     .. .     .            .     . .    ..  .   .  .              .   ..
.     . .  ..      X.   ..         . .   . .  .    . .    .   ...  . .    . .  .    .
. . . .     .   .   .    .       . .     . .         ..       .   .    .. .   ..    .
. ..     .              .. . .     .      .    . ..            ..    ..   .       ...
.   .. .             .    ..   .   ..        . .       .  .  . ..        ..       ...
. . ...  . .     . .  .              .          .  .  .        .  .       .     .   .
..   . ..    .        ..  .   ..   ...    .. .    .      .   .       .     .    ... .
.         .    .  ..         . .           .           . ..          .    .  .     ..
. .     .. .   ..           .        .. .      .         .  .    .       .  .       .
.  .  .  .   .   .       .  ..  .    ..    .    ... .  .   ..   . ..   .       .    .
.          .       .  .      .    ..       .      ... .     .  .  . ..     .  . .. ..
....     .        . .     .    .   .  ... ..    .     . ...      . .        . .  .  .
.   ..    .. ..       . ..   . .  . . . .         ...          .       .       .    .
.        . ..     .   .    .          ..  .     . .  .  .      .  ...    .      . . .
.         ..       .     .     ..    .          . .    .  .   . ...   .. .    . . . .
.  .   .     ..  .   . .      .           ..   ..        . .    .    .   .    .     .
. ...   . .         .    .. ..      .            .   . .  .  .    .  .   .  ..      .
.      .  .  . .      ..     . ..  .  .. .. .                 .        . ...        .
. ..  .            ..             .  . .  .          .  .         ..          .     .
.    .  .    .    .  .      ..   .  ..       .   . .      .          . ..  .     .  .
.....................................................................................
