........................................................................................................
.. . .    .  ..              . .    .     .  .           .      .      . .   . .  ..  . ...  .  .      .
.     .      .        . .   .       .    .    .         .       .    .   ..      . .           ... .   .
.      .                .         .    ..    ..      . .    . .    .   .              . . ..           .
..      .   . X         .  .          .  .                . .  ..  .  .     .           . .  ..        .
.     .     .      ..   .   .   .   .. .      . .  .      .     .    .  .  .  .         . ...      .  ..
. .    . .         .          . .    .             .    ..                 .    .                      .
.           .       . .    .    ..   .    ..          ..     ..  .          . .        .        . . .. .
. .   ...            .  .   .      .    . .      . . .            .       .    ..     ..  .      .     .
..     .   . .          .        .  ..       ...          .  ..    .           . .              ..     .
.            .               ..    .     .  . .S .   . .   . .         .            .       ..         .
.   .    .  ..    .          .   .  .. .  .  .          ... ..  .                 .      .  .          .
.     .    ...     .           .    .  .          . .   . .       .          ...   .         .. .     ..
.   .           ..    .      .       . .     ...   . .   .    .      .          .   .  .     .    ..   .
. .   .  .         . .      .  .            . .  .   .        . ...   .   .      ..                .   .
.        . .  .. .   .     ..  .        .        .           .      ..   ..              .          . ..
.   ..        . .         .  .   .   . .     .   ..            .    ....       .   . .       .     ..  .
..            .          .         . . .  .  .    ..            .  .  ..     .   .    ....         .   .
........................................................................................................
