....................................................................
.    .    ...            .    ..  .     .    .            ..      ..
.  .    .     .  ..   ..   .        ..  .                          .
.         .  .           . .    .   . .    .     .   .      .. .   .
.   ..           .    .      .     .   .  .. .             . .   . .
.  .          ...         .     ..           . .        .          .
. .  .  .        ..             . .   .   .     .. .               .
. .   ..         .             . .        .   .             ..     .
.     X     .        S   .          .                  .           .
.   . .                  .    .                    .  .   .        .
.         .      .      .      ..           . .     .           .  .
.        .                           .   ...  .  .   .     .  . .  .
..    .                 .  .          ..                     .  .  .
....................................................................
