..................................................................................................................................
.    .       .      .  .. . .   .. ..       ..  . .   .. ...  . .            .   .   ..   .   .  .         .  .           ..    ..
.....      .        .  ..     . ..     .    . . . ....     ..  . .   .   . . .   . . .. .  .    .... . .    .S .       .  . ..  ..
. ..  .     ..     ... .. ..    .     .        .    . ..    .   ..     . .. .  .   ...  .. ..     .      .      .               ..
.     . .    .    .  .....     . ..         .   .. .  .     . .  ....   .    .  .  .. .  .   .     .       .   .. .      .   .  ..
.... .  .        .   .    .    ..    .   . .    .      .    .  .. . ....   ..   ..        ...       .  . ...     .. .          ...
.    ...  ....       .     ...   .    ..     . . .  .     .   .  .. . . .. ...   . .    .    .       ..   ..  .          ..  .....
.   . . . .  .  ... .        .  . .   .               .. .  .  .. ..  .     .  .. .    .   . .     .    ...   ...  .      .   .  .
. .. .   ..... ..             .  .  ....  .    ..  .         . ..   . .  ..   .  .       .   ..   ....  .      .  .  .          ..
.  .   .. .  .  .         ..    . .  . .....   ...    ... . X ..  .   ..          . .  . ..   .   .  .     ..  ...     .     .   .
.   ..         .         .    ...  .  . . .  ..    .     .   .. ...  . .    .. .   ..   . ..           .... .   .. .  . ... .   ..
..   . .       .  .   . ..  . .       . . .  ...      .    ..  .     .. .    ... ..    .  . . . .    .     . . .    .     . .    .
.  . ..      . .  . .                ...   .  . .  ..          .. . ..  .  .. .  . .....    .  . .... .     .. .  .  .    .    . .
..    ..           . ..  .     .  .     .  . .  .  .    .   ..   ..   . .... . .  .. ..    .                     . .  . .   .   ..
.   ..  . .. .   .  . .    . .. ..    . .    .      . .. .   .. .    . ..    ..     .  .      .       .  .      . .  .     .   ...
..     . ..   .        .   .             .   .     .. .  .      .      .   .       ..  .     .     . .  .    .   ..   .        . .
..       ..  . .     .   . .   . .  ..   ... .. .   .  .  .    ..  ... ..          . .  .... ...           .     .  .  .   .  .  .
..              ... . . ..  ..      . ..  .          . .   ...      .    .    ...   . .  .   .   ..  .  . .    . .  .  ..  ..   ..
. ...  .  .    .   .  .  .  .  .    . .   . .    .    .  ..       .                        ..         ..   .      ..  . .    . ...
.      .      ...               .      ...   . ..  .   .      .    .      . . ..       . ..  .    .  ...    ..  . ...  .   .   ...
.   . .. ..  .   ..       .    . .  ...    . .   . .. .  ...      .   .     .       .     .. .... .     .         .       ...    .
.   ..   .       . ..        .     .       ..    .  . .     .  . .   .   . .   .....                             .     .. .   .  .
.  .      .. . .          ...   ..   .    . .    . .   .    .. .   ..     . .      .  .. .      ...         .  .      ..   .    ..
.  .. ...  ......  ..  .  .  ..  . . .       . ..       . .  ...   .... .. .   .    . .   .    .      . ...   .    .  .  . ....  .
... . .. .      ..       . .. . .     .      .  .  ..    ..     . .   ..  .     . .          .. ..    .         .. .   .        ..
..................................................................................................................................
