............................................................................................................................
.   ..  .     .    .  .        ..    .     .. .    .    .  ...  .    .    .      .     .       ..     ..    .  .   .  .    .
...    S     .    ..  .   .... ..    . .    ....    . .   .   . ..    .    .      .   . . . .  . ... .    . .. .   . .   . .
.    . .      ..      . .     .     .       . .   .  . ..   .   ..             .    .   . .   . ..  .    .  .    .. . .  ...
. ...    .    .    ...     .     .  ..   .  . .          .         .                    . .. ...     ..     ...          . .
..  .     .       . ....   .     ..  ...    .               . ....   .     .    .  ..  .      ..        .  .  .   .        .
.   .       .    .    .       .  .        .. .         .. .    .   .       ..     . .   . ..   ...   . .      .  .     ..  .
..  ...     .         .  .  .  .   ..   ..        .     .  ..  .   . ..  .  ....   . .  ...   .     . .   .   . . .      . .
.     .              ...     .  .. .      . .       .  . . . ...    ..        .        .  .   .      .     .    . .  .  .  .
.     . .  ...   . .      .  . ... ... .  .        .   ..       .     .       . .                ...... .  . .      .   .  .
.  .  .   .   . . .    .  .     ..     .              .. .. . . .. .      .       .      .     ..   . . .  . .  ..   .    ..
.. ..                .. ..      .        . .   .. .    ... ..  .   . .      .   .      ...   .       .     .  .  .   .    ..
.         .. .       . . .  . .  .. . ..    ..    .     X.    .     .   .        .    . ..       . . .  . . ...   . . .  . .
. ...     . . . .. ..  .  .  .               . .     . . .  .                    .  . .  . .     .       ..   . .     ...  .
..   . .   .   .        .    .          ..             .      .      ..  .  .. .       ..  . .  .. .... .    ..    .    .. .
..  .         .   ..     .     .   .     ..  ..    .. ..    .     ...        . .. . .      ..   .      .  ...    .     . . .
............................................................................................................................
