...........................................................................................................................................
.              . .  .       .        .                 .  .            .. .   .  .         ..       .     .        ..                 .   .
. ..            .  ..   .    .                 .        .      .        . .  .              .  .  . . .  .      .              .    .     .
.                              .   . .        . .          .    .   .   .            .   .            . .    .     X ..   . .     .       .
..                           . .  .          .         ..   . .          .      ..   .    .                 .   ..           .  .     .   .
. .      . .            .   . ..            .     .                   ..          .  . .                         .    .        .        . .
.  .                    .   .  .                .              .         . .. .          ..    .  .   .     ..                . .         .
.                ..   .   .       .   .       .     .  .      ..                 .                 .      .       .   .     .  .  .  . .. .
.    ..   .  .   .     .    ...                                .         ..   .   .      .       .   .    . ..         ..                 .
.                                .   .         .   .          .  .    .   ..       . .    .     .      .                   .       .    . .
.       .  .          .       .                .      .         .              .     ..            .         ...    .                     .
..            .  .     .                              . .     .      ..           ...              .       .   ..    .         .          .
.                         . .   .          .    .     .             .                                  .. .  .         . ..      .  . .   .
.      .          ..       ..     ..      .      .  .    . .  .   .    . .      .      .       .       .            .          . .      . .
.       .      .            ...             .    . .        .    .        .             .         .  .      .      .                      .
.   .                         .   .                            .           .   .    .                ...   .      .   .  .   .            .
.   .   .    .      .             .  .   .         ..              .       .   .   .                 .     .  ..   .    .      .          .
.   .         .                    .       .     . .          .            .        .    .              . .        . .      .       . .   .
..  .         .       .   .       .              .  .                  ..    .        .     ..                        .   .       .       .
.       .          .      .       .    .      ..                   .     .             .                    .       . .    .              .
.  .  .    .   .              .                       .  .       .     .                        ..          .S   ..           .     .     .
.       .           .                     . .            .     .    .         .        . .  .            .        .                .      .
...  .             .    .            .         . .                          .            .  . .      .     .                      .       .
.          .       .  .          .   ..     .  . .  .         .                           . .   ..     .            ..    ..   .          .
.       . ..   . .  ..         .            .  .               .       .      .                                                  .      ...
.   .     .           .                    .     ..             .  . .    .         .   .   . .   .  .            ..                      .
...........................................................................................................................................
