.................................................................................
..          . . .   .           .           . .  .    . ..         . .  . .     .
. . . .        ..X.   .  .     . .             . .  .      .      .        .    .
.   ..         .    .   .  .    .             .    .       ..  . . .  .  .  . . .
..          ..  .    .         .       .. .  .     .   .   .    . ..   .        .
. . .           . .                . .   .  .            ..     ..     .        .
.   ..       .    .  .  .. . .                  . . .   ....  .          .   .  .
. .        .    .      .  . ..  .      .  .  .     .  . .    .  ...        .    .
.     . .        .         .  .    .  ...      .  .  . .     .  .      .        .
. .. .      .                        . .     .  .   .         .                 .
.    .  . ..   . .     .  .  .       .   .    ..  . .        .      .     .. .  .
... .. .   .         .    .      ...    . .   .  ..    .             . .  .     .
. .  .   .   .   .  .  .  .    . ..       .  .   ..   .   .. .. . ..      .  .  .
.     .   . ..    ...             .    ..      . .   .   . .     . .            .
.     .      ..       ..  .        . .  .  .   .        .         . .        .  .
.      ..          .         ..     .  .      .    ...  ..          .        .  .
...   .          . . .      . .          .. .  .     .            .  .  .  ..   .
.       .        . .        .                 . . .. .  .   .            . .    .
.        .  ..  .     .         .   .        .  .            .    . .        . ..
.      ...   ..  .     .       . .    . .  .     .                     ...     ..
.            ..        ...      .          . .          . .         .           .
. .    .     .  .  . .     .  .       .   ...  .    .   .      . ... .    .     .
. . .   ..                    .       .    .      .           .    .       .    .
..         .      .   . .  .     .  .     .   ..      .           ..    S       .
. ..       .  .            .  .     . .       . .            .. . ...           .
.  .         .           . .        .           ..   .          . . .  .     .  .
.................................................................................
