........................................................................................................................................
.                             .  .   ...                      .     .                                             ..   .   .      ..  ..
. .           .            . .                                        ..                                       .              ..     . .
.. . ..               .           .  .    .    .           . .                      .          ..                . .  ..            .. .
.  .            . .  .   .   . . ..           . .            . .  .    .             ..    ..                            .  .          .
.          .         .                .     .      .  ..  . .                     .           .                       .          .   . .
..         .                        .            .      .       .               .     .    .. .  .                  .      .           .
.    .   ..                        .   .      .    .                               .                   .              .      .  . ..   .
.    .             .   ..       .                                    .    .           .      .                     .    .    ..   ..   .
.   .   .          .    .   .        .   .     .     .. .              ..       .       ..      .         ..   .        ..    . .   .  .
.          . .                          .                     .           .              .     . .              .     ..      ..       .
.                                        .   .       . ..  .    .      .  .          .                       . .           ..          .
.       . . .      ....                 .                        .    .                      .    ..                    .  .S          .
. . .      .    .         .  .            ...     .                                 . .....     .         .  .         .       .    .  .
.  .  .      ..   . .   .         .            .  .          .      .             . .   .. .       ..  .          .     . .  .         .
.                  .    .    ..                            .                          . .            .              .   .    . . .     .
..      . .                     .           .    .                                .         .      .        .  .  .    .         .    ..
..  .            .                           .  .                                   .         .                         .   . .      . .
.     . .  .  .   .  .           .      .    .  .        ..            .    .           ..   .  .     ..            .                 ..
.   .    .  .     .       .        .   ..          ..          . . .         ..       .    .     ..      ..        . ...   ..      . . .
.    ..    .   .              .                .        .              .              .     .    .. . .  .     .   ..         ..       .
.  . .          .           .   .   .     .            .      ..       .       X        . .                           .      .         .
.                             .     ..      .  ..    .      .                              .            .       .              .    .  .
. .   .       .   .      .     .      .            .       .   .     ..     .   ..  .        .           .          .               .. .
.              .      ...    .       ..           . .                         .  .                                            .      ...
........................................................................................................................................
