...........................................................
..       .  .   .    .  . .   .             .     . . .. ..
.  . ....  .          .            . .  X .         ..   ..
.. . .  .  .      .       . .   .           . .   .  .    .
..  .   .              .          .    .  .      .        .
.                         .   .         .              . ..
.    . .      .   ..   .          .   .                   .
.      .  ...       . .            .. .    .    .       ...
.  .         .            .     ...       .     S         .
.        ..  .    .                .          .   .       .
.                          .   .     .  .                 .
...........................................................
