..............................................................................................................................
.          .      .   .       . .                .               .   .                         .       .        ..    .      .
.              .    .   .          .             .            .     ..             .         .  .                 .    .     .
.   .    . .     .                                  .              .   ..      .        .                .          ..   .   .
..                          ..              .                                 .                 .  .                 .     . .
.           .   .         .   .           ..           .                                             .   .        .     .   ..
.  .           .  .                  .                        .  .              .     .     .       ..   .  .   .  . .       .
.       .  .         .       .     .      ..             .                     .    .         .           .     .   .       ..
.                                          .   .    ..                       .                     . .          ..  . .  .   .
.   .       . .       .  .         .        .       .         .           .. .  .      .              .                 .   ..
.  .        .                      .   .     .                                  .  .           .   .                  .      .
. .             . .        .      .    .     ..      .           .      .      .        .      .                             .
.     .    .        .            ..        .            .                           ..      . .         ..                   .
.      .                  .        . . .                                     .  . ..  ..    ..                    .          .
.                      .   .                          .  .. . .    .   .          .        .        .          . .      .    .
..  .      .                 .   .                    . .                           .     ..      .                    .     .
.                    .    .               .    .     .  .    S    .        .  .                        .         .     X     .
.   .               .                  .   .   .      .         . .  .                .    .             . .  .          .   .
.                   .              .  .      .                   .  .   .     .              .                     .    .    .
.          .  .        .   . .      . .  .                                       .  .   . .               .    .             .
. ..      ..    . .  .        ..       ...    .  .        .               .    .  ..                        .                .
.   .             .                        .       . .                    .  ..    ..                 .         .            .
.   .    .   .    .                            .      .    .      .  .      .       ..                . .     .          .   .
.            .   .    ...              .    .   .          .        .       .    .   .  .  .  .   .          .           .   .
..     .       .                                       ...          .         .   .                  .          .   . .      .
.  .              .                .  ..                  .             .   .                         .               .      .
.       ...  .           .                    .     .                          .      .                          .. .        .
..............................................................................................................................
