....................................................
.  .  ..            .  . .        .  .        .    .
.        .  .           .   ...          .        ..
..  .     .     .      .          ...      .       .
.       ..    ..  . .         .             .      .
.          .    .      . .   . .    .              .
. .   .       .. .     .  . .. ..   .       .  .   .
. .     .  . .     .. .       .      .  .     .   ..
.          .     . ..             . .             ..
. .        .  .        .      .  . .  . .       .  .
.    ..     .       . .        .    . .     . .. . .
..       .          .     .  .  .   .      ..  .  ..
. .  . .       .     .      .       .           .  .
..           .       .. .   .            .    .  . .
.. .            .                .            .    .
.                         ..   ..             .    .
.      ..        S. .         .   .   .      .     .
.  .        .   .          .   .    ..         .   .
..       .           .  .       .      .         . .
.    X  .        .  .              .     .    .   ..
.      .        .        ..        .. .         .  .
. .      .  .       .       ... .                  .
....................................................
