...........................................
. ..                 .    . .  .. . ..    .
.                            .        .   .
. . .    X.           .       .  ..     . .
.    .  .     .   . ..  .   .. .          .
..   .  .. .         .         .. ... .   .
. .       .     . . . .      ..  .        .
. .  .        .     .  ..   .            ..
. .      ..   . ... .      . . .          .
. ..  . .     ..   ..   .   .       .    ..
..  .  . .               .  .         .   .
.    .          .       . .  . . . ..  .  .
.  .  ..            .      . .  .  ..    ..
...     .  .        .        . . .   .    .
.                    .      .         . . .
.    .     ....        ... .    .         .
... .   .    . .  .       ...  ..     .   .
.   .   .      . .         .. .   .   .   .
. .. .     . .           . .   .  S     . .
.    . . .    .     .     .. .     .    ...
.       .... . ..     .     ....   . ...  .
.       . .   . .      . . .   ..  .      .
. .        .        ..   .   ..           .
.      .      .    .  .          .   . ....
.     .     .        .     . .    ..  .  ..
.   . . ..   . .             .        .   .
.                .               .    .   .
.    . .        ...         .      .      .
...........................................
