....................................................................................................................
.  .   .       .            .        .    .          .       .   .   .   .   .     .           .              .    .
.                           . ..   .      .  .           .       . .  .    .      ..         .  .     ..       ..  .
.   . . .   ..   .  .  .          ..        ..     .        . . .              .      .       . ..    . .   .      .
.  .  .     .          .    .      .       .            .      .        .. ..      .. .  .           .   .  .   .  .
.    ....                .   .                   .      .  .  .  .        ..  ..         .      .. .  .            .
.   ..        .       .      . .     . .  .        .     ..    .    .   . .         .   .     . ..    .   ..       .
.   . .   . ...       .   .             . .   ..      .       .. .     ..        .         .    .      .        .. .
.        ....      .  .. .  .   .     .          ..   .      . .   .          .        ... .             .       ...
.     .  . ..            .     . .  .    . .. .                    . .    ..  ..          ..          .   ..       .
.       .     ..  .        .             .              . . .   .  .   ..      .  ..        .     .            . ...
..        . .  .   .      . .       .           .               ..   .     ..... .   .           .       .   .  .. .
.     . .    ...            ..  .                .                            .        .   .   .     .     .       .
...   S  . . .. .  .          .  . .   .   . ... .   .         .  .  .. ..  .       . .   ..     . .. .   .        .
.    .    . .  .     .       .   .                            ..  .    . . .  .  ..      ..   .    .  . .          .
. .     .        .  .             .  . .    .  .        .     .        ..         .              .. .         .    .
.      .  .       .      ...  .  . ...       . .   . .     . .  . .                 .    .  .         .     .      .
. . X   .      .       .. . .      ..   . .     .         . .   .       ..  .   .  .             . .       . .    ..
.        ..       .           .       .      .             .                 ..                 ..              . ..
....................................................................................................................
