..............................................................................
.       .       .                .       .     .                .   .        .
.   .            S .. .        . .   .     .      . .            .           .
.         .  .     ...       .         .    ...  .   .       .      .   ..   .
..   . .    .   .         .           .       .   .        .    .  . . ..    .
.    . .  .    .. .              .                          .     ..  .   .  .
. .   .             ..... ..  .  .  ...  .     ....    .   .   ..   .        .
.  .    . ..   . .           . .       .           .     .  .      . ..      .
. .    ...         .               .       .       .          ..     .       .
..      .              .                        .    .  ..     .  . .    .   .
.         .    .         .   .    .                           .    .       . .
..   . .              .        .   . .     .. ..                     . .   ...
.          .     . .       . .     ...          . . .  .      .   .    .  . ..
. X      . .    .     .      .   . .          .               ..    .  ....  .
...                       ... .            .     ... .     . .  . .        . .
.         . . .     ...  .         ..    . .           .            ..   .....
.  .    .  .   .      .  .   .     .   ..    ..          . ..               ..
..............................................................................
