..................................................................................................................................................
.       .       .. .  .    .   .   .      .          . .     .    ..    .                      .   .   .    .   .                    .          ..
.         .   .    .       .          ..    .             .   .    . .      .        .       .    .         .  ..                    .  . ..    ..
.  .           .                                                     ..        . .. ..          .         .   .        .   .        .            .
..           ..      .            .   .  ..        .    .       .        . .                .    .     . .   .   ..        .   .     ...  .     ..
. .   ..      .     . .    .            .     . .  .  .         .      .                       .            .           .          ..  .      .. .
. .  ..        ..  .                       ..    . .       .    .              . .    .       . .        .   . .    .    .   .  ..              ..
.      . ... .        .    .     .     .      .    .      . .       . .  .  .    . .    . ..  .         .  .      .           . . .      .    .  .
..         .   . ..         .  ..           .                .      .  .   .          .                      . ..     .    .      .   .   .      .
.             .     .  .   . .      .       .. .          .    .    . .    .   .               .  .   .        ..       .       .      ...    ....
. .                      .   ..       .      .         .    .     ...              .  ..  .       .                      .  .        .           .
.     . .  .              . . .   .  ..        .            .                      .   .             .      .   .               ..       . ..    .
. .    .     .   ....           .                               .  .   .         ..              .   .   .       .  .      .    .  ..        .   .
.  . .      .       ..                  .    .         .   ..   .    .       .    .                 .    . .           .        .        .   . ...
.   .   .   ..    .            .          .   .  .     . .      . .. .           . ..   .    . .      .        .  ..     ..   .      . . .  .  . .
.                               .      . .       .           .                      .      .  . .             .   . ..    .     .        .     . .
.  .           .        . .           .  .   .        .       .                        .    .      X           ..  .       .           . . .     .
.  .  .   .   .         .  .     . . . .  .  .  . . S..     ..      .    . ...        . . .   .   .                       .  .   .  .            .
..   .  .  .      ..  . ..               ..      . .                 ..   .    . .    .  .     .            .  ..        . .      .      ..    . .
..................................................................................................................................................
