................................................................
.  .  ..    . ..      . . .. .   . . .     .  .       .    . ...
.           .         . .    . .   ..   .     . . .  .         .
..    .       . .           .   .         .              ..   ..
.. .       .   ..   .       .     .       . .              .  ..
. .  .  ..  .       .    .     .          .  .     .  .   .  ...
. ..   .   .   . .         .    .    .  .   .         .    .   .
.       .   .          .      ..  ..       . . .  .        .   .
.  .                 .  . .      .     .       ..      . .   . .
.   .    .  ...  .  .      .   .  .      .      .   ..      .  .
.   .   ..  .     .     .     X     .                     .  . .
..  .        .  ...     ..        .   .    .        .       .  .
.  . .   ...    .   .  .  ..  ..   .     . .    .  .    .      .
.  ..     .   .   .    .   . .   .     .    ..         . .    ..
..S            ..    ...                     ....              .
..      .       . .     .     .   ..  .    .       . . . .    ..
. .    ..      .    .         .             .     ..      .. ...
.                .        .  ....      .  .   ....          .  .
.    .   .       .     ..        . .    .     .   .   .      . .
...   ...           .      .    .        .  . .      .       . .
.   .   ..       .      .             .      .    .   . .   .  .
.  . .  .       .       .      .         .  .                 ..
................................................................
