......................................................................................................
.    .    .  .         . . .               .      . .     ...  .     ..  .       .      .. .   .     .
.          . ..    .   .. .     .   .   .. ...   .  . . . .        .   .             .   .           .
... ...     . ...  . .   . .      .    . . .    .  .       . . .     .   .  .  .                     .
.   .    ...          ..   .   .    ..         . . .  .    .S .....   ...  .. .          ..      . . .
.            .  .          .              .     .  ..    .   .. . .    .  ..    .     .       .      .
.     .  . . .    .   .. .   .      . . .        .       ...  ....   .    .  ..    ..   .            .
.. .   .     ...  .   .   . .    .  .   .   . .. .    . .    . .. .  . .. . .  .      .    .    . . ..
.  .       .  . . .   . .     . ..  ...          .      .   ...  ...        .   ...  ... ...     . . .
...   .       ... .   . .                   .    .  . . .  .          ...     .    .      ..       . .
.     . .      .  .     ..      .            . .      .  .     .  .        . .  .. .  ..  . . .      .
.   . .                     ..    .    . ...  .        .         . . . .    .  .   .    ...       .. .
. .   .            .. .    ...    .     .   . .. ...       ...     .      ..  .   .  .  .       . .. .
.  ..  ..    ..   ..  .    .  .  ..      .        .               .  .      .  .     .   ..  . .     .
..      ..   . . . .. . ....             ... ..  .   . .    .      .      ....     .    ... .        .
..      .  .. .         .  . .        .           .     ..      .     .     .   .. .      .  .  .  . .
.   .    .  .  .. .     ..  .  .           ..      . .    .  .   .   .   .  ..    ..  .    .         .
..   .  .       .  .    ....  . .  .    ..     ...        .    ..        ... ..   ..    .   .  ....  .
.    .  ..    ..   .....   . .   . ..  ...   .     .  ..     . .   .  . .         . .    ..    .     .
.   ..     .     ..  .      .     ..           ..       .   ..        ..       .      .    ... . .  ..
.   .     ..  ..     ..       .  .        .             ...  .  . .              .    .        .  .  .
. . .. .  .. .     .  ..   .   .       .. ..     .     .   .        ..      ..   .   .   .     . .   .
.  ..              ..    .. .     . . .  .      .        .   .          .......   . X.      ..       .
.. ..   .    . .. ..              .     .   ..         .                .    . ..        . ..        .
.  ..    .   .   . .      . .   .. .   . .    .    ..    . .  .   .     . .. ..      .   .  .        .
......................................................................................................
