................................................................................................
.            ..         .                                                    .           .     .
.            .   ..    .  .      .     ..    . .                 .        .   .                .
... .          .        .   .                      .   .   .  .          .   ..  .             .
.          .     . ..      .   .             .             . .   .      .                      .
.                      . .        .               ..         .   .    .           .            .
. .          .                    .  . .   .  .     . .                             .   .      .
.                 .     .                         .             .          .                   .
.              .     .   ..       . . .         ..           .          . .      .      .      .
.         ..   .  .          .        .  ..     .               .        .       .          .  .
.    .              .            .  .                 .      .        .      . .           . . .
..  .                                                       .          . .               .     .
.  . .   .         .            .               ..         ..       .    .    .                .
.                 .           . .                         .. .                    . .     .   ..
.     .              . .   .         .           .                   .                 .  .    .
.         .           .    .    .   . .      .    .             ..          .   .  .      .    .
.                    .              .         .              .               .      .          .
.         . . .    .   .      .               .                        .             .     .   .
.                    .        .  .          .                   .     . .  .   . .       ..    .
.        .                  .                  .   .     .                                     .
.     . .      ..   .  ..  .               . .              .     .     .           .          .
.    .             .           . .       X  .  . .      .   .            .                    ..
.                   .      .       .     .   ..                                                .
.           .              .   ..                                 .         S      .      .    .
.                        .              .      .           .     .     .             .  . .    .
................................................................................................
