.................................................
.        .  .     .    .              ... .   . .
. ..      .           ...  .      .     . .    ..
.          .    .           .                   .
.     . . .           .      .         .     .  .
.  .          . . . . .      ..     .           .
.   .    .  .   . .                      .      .
.                   . .    ..   S .    .      . .
.  .    .    ...           .  .  .              .
.     .  .        ..  .  .  . .   .        . .  .
. .   . .     .     .        .            .     .
.         .    ..      .      .   ..  .   .   . .
.  .           . .   ..          .     .    .....
. ..   .    .             .   ..            .   .
. .  .  ...            .        .    .  .  .    .
. . .        .   .    .         .        .      .
. .     .   .                ..      .    .     .
..   .               .  . .     ..   .          .
.      X                     .          ..      .
.         ..         .      .   . .     .      ..
. .   .      .   .   .         .   .            .
..               .   .   . .  . .               .
.................................................
