....................................................................................
.    . .     .  .                     .       . .  .. .          . .    .   ...    .
. .   .    . .  .. .  ..       .     .. .        .       . . . . ..  .           . .
. .       .  .       ..   .  .      .      .  . .   ..    . .    . .    .   .. .  ..
.  .  ..           .. . .    ..  .. ...  . .    .  .      .    .      . . . ...    .
... . . . .. . ..    .       .  .. .       .   . .S    ..    .       . . .      .  .
.  .    X .        .         .      .     .   .  . .  .. ..   .     .  .  . ..     .
.        .    . .   .   ..  .   ..  .   . .   ..   .  ...  .   ...  . .. .  ..     .
.      .  .   .  .    ..        .  .. ...           .   ..   .  ..          .  .   .
. . .   .   ..   . .  .     .. ....         ..  .                      .        .. .
.        .  .        .    .  .        ..        .  ..                 . ... ...  . .
.      .         .          ..     ...    . .           .         .    .  .. .    ..
.   .         .  . .. . ...  .   .   .      .      .    .. .         .. .     . .  .
. .........  ..      .  .           ..  . .   .      .      .   .     .    . .     .
..  .      .   .      .     . .  . .  .      .           . .    . .....      .     .
.             . .  . .           ..      .. .    ...    .     .      .     . . ..  .
..   ..      . . .  .   . . . . . . .   . .   . .       .       .. .    .      . . .
.      .. ..                .      .  . ..   ..     . .    .       . . .      . .  .
. .       .      ...  . .  .  .      .   . .  .  .   .  ..  ....     .    .       ..
...     .            .         . . .   ..  .   .  .   . .    .     ..    . . .  .  .
...  ..        .    ..    .   ...      .   . ..   ... . .   .    .  .     .        .
.  . .    .  .  . ..   .. ..       . .        . .   . .   ....     ..    ..    ... .
.  .       .  . ..         ..       .. ..    . . .  .    .. .    . . . ..  .      ..
.  .    .    .   . .  ...  .        .   .. ..    ... ..     .   . .... .     ..  . .
.       .     .  .     . .       .    .     .  . ..         . . .            ..    .
.    .  .  .  .  .  ..                 ..  .. .     .           . .      . ..      .
. .  .  ...   .  . . ..    .  ..                ..  . .   ..    .   ..  .   . . .  .
. .  .         ..           . .         . ..      .  ..         .     .            .
....................................................................................
