...................................................................................................................................................
.  .  .     .   ..      ..  .  .   .   . ..  .  .     .. ...       .   .   .      .   .  .  .      .     ..  .   .   .           .     . ..      ..
.   .   . .  .       .    ..   .    .  . ..  . .    ..   .   .       .       .     . ..        ...   .  .  .. .    .  .        .   .             ..
..  .    . .                 .    .  .           .    .  ..         .    .            . .   . X  . .  .. .          .     .        . . .     .  . .
..   .       .  .  . ....     .  .    .. .      .   .      . ...   .    . .. . .  .  ....   .              .   .  . ..       ..  .  .     ...    ..
.     . . . .    .  .   ...        . .     .             .   .  .    ..       . .  .  . . ..  .. .   ..      .             . ..    . .    .       .
.             .   .     .  .   .    .                  .   .               .     .  . ..        .   ..     ...   .   ..  .     . .    .          ..
. . . .     ..    .    .   .   . .                  ..              .. .       .         .  .         .    .   ..       .  . . .     .   .  .     .
.  ..  ....  .. . .         ..    .     .. .    .         .   .   .         .       .. .    . .            . ..       .  . .    . .. . .         ..
.      .           . ..   .    .      . ..    .    .  . .         . ..  .  .    ... .    .   .    .. .              .        .   . .. ..          .
.          ..                    .  ..       . ..     . .   ..   . .    .     .   .     .        .  .     . .     .   ..   . .    .  .            .
.  .    .. . .    .      .    .. . .      . .  .          .      ..    .     . .    .      .    ..     .  ..      .  . .   .  .       ..   ... .  .
.  .   ..  .    ..  ..     . .           . S ...  .  . .. .       .  ..  .         .         ..    .   .       ..       .       .  ..     .. .   ..
.  ..  .         .   ...  .        .. .         .   .    .  . . ...   .   .   .       . .    .   ..  .  .   .      ..   .      .                 ..
.    . .          ..   ..         .          .   ... .  .    .    .. .  .  .         .   .. . .      ..   .       ..           .   .     . ...    .
.   .. .    ..   ..           .   ...         ..      . . .   . . ..  .     ..   .           .     .   .. .. . . ..  .     .  .  .         .      .
.   .  ..      .            ..   . .   .  . .        .  .. .  .   ...         .        .      . ...  .  .     . .   . .. . .                  .  ..
. . .     .   ..    . . .     . .  .  ..       .        .         . .              . . .               .  .   . ..    .       .   .  .       .    .
...................................................................................................................................................
