............................................................
..  .      . ..                         ...   .. .     ..  .
. .       .  .  .  . .                .  . .  .   .  .     .
.                .    .                         .        ...
..  . .      ..   .           . ..              . .    S   .
.    .   .     .               ..       . .    .         ...
.        .       .   . .    .. .    .                      .
.    .  .. .     .  .       ..         .  .  .   .   .     .
.  . . ..  .          .                       .  .         .
...  . ..    .           .. .      ..   ...  . .    ..    ..
.  X  . ..      . .   ..  . .            .    .    .   .. ..
.      ..       .   .  .           .. .             . . .  .
............................................................
