........................................................................
.. .   .   .    ..        .   .      ..    . ..      .  .. .        .  .
..       .     .    . .  ..   .  .. .  ..  .          .  . .  .      . .
.  .     .   . .   S.      .        .     ...       .  . ..      .   ...
...    .    ..  .      ..    . ..   ..     .     .   .    X            .
.                 .      .               .  .   .       .      .    .  .
..    .     .  ..   .      .  .             . .        ...      .    . .
.  . .. .   .    .        ..     .      .   .   ..                     .
.    ..      .  .         .  . .. .  .           . .  . .  .  .       ..
.              . .         .   .   .     .    .     ..  ..  . .   .  ...
.      .        .        . .   ..      .    . .        .   ..  ..     ..
........................................................................
