............................................
. . .  .. ..    . ..     . .         ...   .
.. ..   .. . X   ..        ..       .   .. .
.  .       .     . .  ..  ..  . .    . .   .
.   .       .       ..    .    .           .
.     .   .      .  .   .      .    .      .
.  .      .   . . .  .. . .     . . S     ..
.    ..  ... . .      ...   .     .   .    .
. .   .    .  ..       .  .     .    . .   .
.        .         ..   . .  .      .  . . .
. .          .  .  .       .         .     .
..      .. .                .   .    .    ..
.  .   .       ..  ....      .    . .    . .
.   .   . .                  ...   . ..    .
.    .  .   .  .  .   .    .       ..  .....
...      .   .       . .      .         .  .
.  .   .          .       .      .      . ..
.  .  .    .        . .           .        .
.    ..  .   . .. . .     .  .        .    .
.   .   .     .     .  ..         ..    .  .
.....     .. ..       . .  ..      .    .  .
.     . ....    .      .        .   .      .
.   .   .   .  .  .  .       ..    .   .   .
.                 .  .        .    .       .
.         ..                    ..         .
.       .     .   ... .     .      ..     ..
.. .. .     . .  .         .     . .       .
.              .....      .     .     .    .
............................................
