..............................................
..    .         .     .   . .    .   .     ...
.  .   .    .  .       .              .   . ..
...         .      .  ..      .  .. . .     ..
..    .  . . ...   . .  .   .  .. .  .     . .
..   . . ..     ....   ..     .            ...
.. .   ... ..       .     . .  ..  .       ...
.   .           .......  . . .         ...  ..
.  .     ..   . ..   .   S         .     .   .
.        .   ..   . .           . . .  X    ..
.    . .         .         ..  .     .     . .
.      .   .        .    . .  ..        . . ..
.  .      .     .        .     ...    .  .. ..
..............................................
