.................................
.      ...                .     .
.  .     . .      .   X       . .
.  .. .. .                     ..
. . ..    ..   .     .          .
.      . .    .   . . .    .   ..
. .   .  . .               .    .
.  .   .        .  .  ..        .
.     .     .            .  .   .
.            .            . ..  .
.         .     ...   .      .  .
.     .S     .  .     .   ..    .
. .      . .     .     .        .
.    .  .. .      .    .     .  .
.      ..   .    ...  .     .   .
. .       ..     .     ..  .    .
.  .             . . .          .
.   .       ..            ..    .
.................................
