.................................................................................................................
..                     ..             . .   .    ... .             .      .        . .      .               . . .
.    . .           . .  ..    .      .         .           .. ..    ..           . .  .     .      ..           .
. .                     .             ..     . ..       .      .                               .           .  ...
..      .        .          ..                    .   .        .      .        .       .  . .          .        .
.                    . .                       .  .   .            .      . .                        . ..       .
.            ..            .       .         .       . .   ..    ...  . .             .                    .   ..
.          ..  .      . ..     .           .                         .    ..       ..          .   .            .
..     .             ... .  .       . . .          . S.       .   . .  .    .              .         . .   . .  .
. .   ..   .         .                   .                           .  .   ..         ..   .  ... ..   .   .   .
. .. .            .                             .  . .        .   .              .           .    .     .       .
.  . .          .  .                    .     .. .     .    .  .  .         . ..         .              .   .   .
.  .   ...        .          .       .  . . .   .    .. ..    .    .        . .                    ..   .    .  .
.        .         . ..                  .  .  .        .                       .                 .             .
...                    .  .      .          .             .                    ..     . . .   .            . .. .
..  .   .     ..   ..      .        .    . .         .              .      .          .  .      .        .      .
.     .      .  . . . .                 .       .        .  .         .     .  .         .                      .
. .            .    .   .   .                       .       .. .       .    ..      .     .   . . .             .
.          ... .   .    .   .   . . .     .  ..   .    .  .   .    .               .                   .       ..
. .           ..      .                        .             .   .               .    .        . .             ..
.      .      . .        .    . . .          .           .   .                .     .    .     .                .
.  .  ..       .     . .      .               . .           .     .  .     .       .           .          .     .
.                   . .   ..         .  .  . .                 .   .      .                  ..                 .
.      .    .    .    .           .   ..      .     .       .      . ..   .. .   .  .    ..        .   .       ..
.       ..          . ...    .          .          .                   . .                 .       .    .      ..
.           .         . .    X            .        .        .   .             .  .   .  .  ..     .  .   .. . . .
.   .    .         . . .                            .            .  .         .  .      .    .   .     . ...    .
.   ..        .          . .    .      . . .   .    ..              .                     .            .    .   .
.  .         .           .    .        .. .    .  .   . .                 .             .         .   .    .    .
.................................................................................................................
