..............................................................
.  ..                                    . ..        . .     .
.       .           . .       .      .     .          . X    .
..     . .      .                                          . .
...  .        .    .  .    .     .  . ..  .               .  .
.           .          . .  .    .         .            . .. .
..                              .    .                       .
.  .    .           .         .     .             .  .   . . .
.   ...      .   . .        ... .           .        ..  .   .
..             .    .    . ..          .   .  . .    .       .
.     .         ..      .   .  .                  .          .
.        .             .. .        .            . .  ..     ..
. . .                          .     .   .  .   .     . .    .
.             .   . .               . .   . . .        .     .
.        . .         .  ..  ..  .    .   .  ..   .  .    .   .
.        ...          .    .     .           ..    .         .
.    .                         . .    .       .    .         .
. .    ...         .        .       ..     . .       .   .   .
.            .    .        .                         .       .
.         . .        .   .  . .    . .  . ..      .       .. .
.                         .       ..      .     .          ...
.             . .            .         .           . .  S .  .
..  .        .                .  .    .  .              .    .
.        .      .  .   . .          .   .   . .        .     .
.    . .. .      .               .     . .   .  .   . .     ..
..............................................................
