......................................................
..      .         .   ....    ...      .           . .
.      .  .     .. .   .. ....  ..    .    .  .      .
.   ..   . .. . . ..  ..   .  ..  .    . .. . .  .   .
...... ..       .       . .  .  . . .      . .   . . .
. .. .   .   .  .   . .   .  .      ..     .. . . .  .
. ..   . .....   .   .      .    ..    ..  .    X  . .
. . ....        ...  . .      .   .     .   . . ..  ..
.  ... .        .   .   . .     ...   .. .   . .   ...
. .      . ...  .. ... ..        .. .      .  ..  .. .
.   .. . .     ..            .....    . . . .  .  .. .
.    .  .   .    ..    S.    .     ..  .  .   .      .
.   .   .   .      .     .    .   .  ... ..  ...   . .
.   .   .    . .          ..    ...       . ..      ..
..     .    ..  .     .   .  .   .  . .    .   .  .  .
. .       .   . .  . .         ..    .   ...  .. ..  .
.             .       ...       . .   ...  .    ..   .
. .         . .      .   .. .. ..         .     .   ..
..     .   .     .    .      .   .     . .  .       ..
......................................................
