............................................................................................................
.  .       .  .   . .  .   .      .      .      .    . ..  .      .              .   . .    .   .    .  . ..
.   .  .     ..  . . .  .    .        .  ..      .           . .      .  .    . ..        ...     . ..     .
.   . .    .      .    .  ..      . .   .  .      .  ... ..                ..   .. .  .     . . .    .. .. .
.     . ..    .   ..  .     .             .  ...   . .          .  .   .                      .         ....
.    ..    .    ..  .   .  ..         .  . ...             .          .    ..  .. .   . . .           .   ..
..   .  .     . ..   .   .         .             . .    ....  .             .   . .  .   .         .    .. .
.    .    .       .... . ...        .  .  .    .        .  . .   . .       .    .    ..     .  .     .     .
..   .  .   ..     .  .  .    ..  ... .    .         . .     .     .   .  . .  .          .     .   .     ..
. .    ..                .        ...  .    .  .   . .  ..                    .               .. .   S. .  .
.     .        ..         .      .  ..    .  .      .       .  . .  . ..     ... . . . .   . .         ... .
.             .     .. . ... .              .            .       .      .. ...                     . .     .
..     .. .  . .  .               .      .   .   .         .    .   .  ....  .    .   .. . .        .      .
.    .          .     . .. . ..  . .  .     .    .      .  . . .            .    .. .     . . .            .
..  .. . .  . .  .   .  .. .  .  .    .       . .      .    .   . .        .. .    .        .     .   . .  .
.      . .    .     .  .          .  .. .             ..   ..       X      ...    .    .  .   .. . .       .
.      ..     ..  .  .    .    . ..     . . .      .. .   .      .       .           ..   . . .       .   ..
.     .  . ... .  . . ..  .     . .    .      ..     ..               . .      .    .   .       .   .. .   .
.    .     .     .     ..  .    .       . .       .     .   .    .    .     .    .     . ... . .     .  .  .
.           .            .     ... . .           .         ..      .          ..    .         .      .     .
.      . .. .    .  ..  .                       .            . .. ....    ..       .    .   .   ..       . .
.       ..   .  .      .    .             .    .     .    . .   ..    .      .. .. .  .      .. .    ..  . .
.     .    .       .    .    . . .   ..  ..              .   .     .   .    .    .  ..    .   .       .  ...
............................................................................................................
