........................................................
.     ..  .     . ..  .    . ..     .     .. .  .  .   .
.      . ..  ..    .  .   ..    .  .      . .     ...  .
.    ..    .    . .    .      . ..      .          .   .
. .      .            ..      . ..       .. .   .      .
. . .  .   .     .     ...   . . ..                .   .
.     .      .   .               ...   . .           . .
.     . . ...  . ... . .      .       .         . .    .
.        . . ..       ...                .             .
.  .     .            . .   ..  ..             . .  .  .
...      ...     . ..      . ..      .           ..   ..
.       .  .        . .  . . ... .       .             .
.      .      .. .. .  . ... X  .           .  .   . . .
.           ... .      .    . . .    .     .     . ... .
.    . S  . .....    . ..   ..  ..   .  .              .
.                .     .       .   .   .     .   ..    .
. .    ..        .  .. .    . .  .  ..             . . .
..  .   .      .   .  .        .   .. ..   .  .       ..
.. . .    . . .   .        .            .   . ...      .
.  .      .. .        .      .   . .  .   .  .. . .   ..
...     .  ..  .  . ...       .              .  ..  ....
..  .  ...    . . .. .     .   .           .     . ... .
..     . . . .      .  ....     . .     ..  .  .   .  ..
....       ... . .     . ...    .                .     .
........................................................
