............................................................................................................
.         .                 .  .  .  .       .                                    ..         ..   .. .     .
.   .     .   .    .     .                         .  .           .               .    . .                 .
. .             .       .                .         . ..  . ...  ..       .           . .      .     . .    .
. ..          .     ..              .   .  . .   .  .        .        ..   .       .           .        . ..
.   . . .  ..    ..   .  .. .                             .   . .  .  .       .   .    .     .         .   .
.      .        .                 .  .       . ....            .   .                     . .      .  .    ..
.           .                . .     .         .                   .  .    .         .                 .   .
.      .  .      .       .      .              .                        .     .     .  . .        . . .    .
.      .    .   .         ..                          .           . .     ..                         .  .  .
.            .  .        .. .      .   ..                             .. ..         . .   .      .         .
.  .     .          .      .       .  .    .      .  .    . .. .            . .                   .      . .
. .          X   ..   . .                   .  .         .    .  .                     ...               ...
.    ..                .         .            .   .         . .      .    ..          .                    .
.  S    .    ..       .          .               .                   .        .    .           . .  .  .   .
.          ...                 .            .               ..   .    .    .    .           .      .       .
.  .                  .           .    .          .                                        .        .   . ..
.         .                          .          . .   .        .                  .              .         .
..  .   .    .   .      ..                .       . .         .                                          . .
.    .           .                                         .        .        .  .   ..     .           .   .
............................................................................................................
