...................................................
.        .            .   . . .            .   .  .
.    .   ..       .   ..       ..                 .
. .   . ...     .      ..                    .    .
.  .   .   .                       .              .
.      .    .   .       .   .  .         .        .
.       .    .  .       .           . .  S.  .  . .
.     .         .  .   .  .. .          X   .  .  .
.        .             ..    ...      . .     ... .
.                 .  .        ..                  .
...................................................
