.................................................................................................
.  ..   .       . .             ..       .  .        .   .  .  ...     .             .  . . ..  .
.    .              .   .   . .             .         .   .        .                       .    .
. ..          .                   . .       .    .   .  .       . . ..               .      . . .
.  .  .                .    .      ...           .    ..  .    .          . .. .   .     .. .   .
.  . ..     .      .            .      ..      .     .            . .       .         ... . .   .
.            . . . .    .      .   .   .      . .                        . .         . .       ..
.   .    .     . .            .          .             .    .  .      .       .      .    .     .
.    . ....  .    .     . .  . .     ..  ...  . .  .            .   ... .                     ...
. ..            . . .     .          .        . .               .                ..      S .    .
.      .           .   .    . . .     .      X   . .. .            ...         ..       .     . .
.     ..         .          .             .          .     .                .. .     .  .   .   .
.. . .     .            .   ...  .     .  .   .    .   .  . .             ..    .      .    .   .
. . .  .      .  .. .  . .. .   .      .  .    .           . .    .    ..              ..       .
. .  .    .  .               .             .        .                . .  .. .  .   . .         .
. . .    ..     .   .      ..    .      .      ..                ..  ..   .       .. .   .      .
. .    . ..      .    .   .     .     .       .           .     .       .     .              .  .
..        . .    .               .    ..             . ..   .    .. ...        .    ..     .    .
.             .              .     . .   .   .  ..   ..  ..    .. ..   .     .. .       .    .  .
.................................................................................................
