.......................................
. .  ....      .   .  ..   ....       .
. .    .   .  ..      .     .  . . .  .
. .       ..    .....  .    .    .    .
. . .  .       .  .       .   .  .  ...
.    .    . .  .                .     .
.     . . .  .         .. .  ..    . ..
.   ..  . .  .    .        .  . .. .  .
. .  . ..   .. .            . ..      .
. ..     . ...  .    ..   .  .  .     .
.   .  .      ..        ..   .. . .S  .
.  . .   .. . .               . .    ..
. .        . .   .. ..   . .    .     .
.    .       .  ...       ... .    .. .
. ...X      .     .   . .     .. ...  .
..      . .   .. .                 .  .
. . .. .  .  . ..      ...  . .  .   ..
.  .    . .. . .  .    ..  .      .  ..
.......................................
