..................................................................................................................
.       .        ..    ... . .   . .. ..           .         ..      .  . .        .  .. ..   ..   .   ...    .. .
.  . ..        .         .        .   . .  .   X ...      ...    .. .  . ..   .    .    .       .    .. .  ..  . .
.. .      .       . .  .         .    .    .       .    .. .     . .. ..  . .    . .    ..   .       .     . .   .
. .. .  ..   . ...   .   ..   .          . .  ..   ..  .   .      ..      .. .           .    ..  ..       .  .  .
.....                  .   ..  ..   S.      ...  .    ..  ..    .    .   .    .  . .       ..   .  . .  ..  .    .
.    . ...      .      . . . .      ..  .  .  . . .  .         . .   .   ..    .   .             .   ..    .   . .
.  .   ... .    .    .    . . ....   ... ..    . .     .        .  .     .  .   ..     .      ... . .         .  .
...         ..    .  .    .       ..      ..  .     . .    . .   . ..      .    ...  .              . .         ..
..   .   .   .     ..               .      .   .   .       . ..   .    . .  . .     .  .. .  .   .  .     .   .  .
.  .   .  .   ..  .         .     .  .     .    ..  .   .        .   .  .      .   .          . . . .  ..  .    ..
..................................................................................................................
