..........................................................
.  ...       . ..     .       . ..    . .     .  . ....  .
.       .    ..   . .X .    .    .  .S       ..    ..    .
.             ..  . .   .    .   . .   ..   .    ....    .
..   . ..   .  ....      . . . .   .     .         .  . ..
.. . .  .  .      .   ..           .   .         .       .
.        .   .    .       .   .. ..    ..  . .  .    .   .
.    ..    ..  .. .. . .      .    .     .         .  . ..
. .  . .    .   .   . ...         .   . .  .   .    . .. .
.   . . .        ..     .   .       .          .  .   .  .
..  .     ..       .  ...  .   . ..  .  .     .    .    ..
. .         ... . ..   .  .   .     . .     . ..    .    .
. ... ..   .       ..        . .       .        .  ..    .
..........................................................
