...............................................
.      .  . .       .        ...  .  .        .
.   . .     .            .    . .      .      .
.       .    .      .            ..      . .  .
. .   . .  . .         . .              ..  . .
. . .          . .    .        .         .  . .
.   .. .    .   .      .  .. .   . .  .      ..
.   ..  . .. ..   ..               .      .   .
.    .      ..    ..    .      . .   .  .     .
.. .  . .      .      .       ..      .  . .  .
.    . .   .             ..    .      .   . . .
.... .          ..  . . ..   .    .           .
.   .    ....S   .         .     .   . .   . ..
.         .               .. .  .    .. .     .
.  .        . .    .    ..   .  .    X ..    ..
. ...      .      .   .    .    ..         .  .
..   . .    .   . .     .. .     . ..        ..
..     ..   .   .   .                  . . .  .
.         . .   .      .   .   .    .     .  ..
.         .  .      ..    ..         .  . .  ..
.      .    . .         ..    .            .  .
.. .       .       .   ..   . .   .      .    .
...............................................
