..................................................................................
.  .   .    .  .          ..             .        .        .          .          .
.              ..                                . .      .   .. .        .  .   .
.   .      .        .     .    .      .           .  .   . . .     . .           .
.     .              .           . .    .      .  . .        .                   .
.                        .          ..                   .         .             .
.        .          .    ..    . .              . .         .  .        .        .
.           .. .   .       .   .    .              . ..  . .  ...           .    .
.. .      .  .    .      .            .     . .  .    .  .      .           ..   .
. .     .  .                    . .          ..       ..                      S. .
.       .     . .             .  .              .    .  .         .      .     . .
.  .. . .            .  .  .         .     X .           . ..  ..                .
.    .   .                . ..       . .     . .. .                      .     . .
.      .      .               .   .                           .    .      .      .
.        .      ..      .      .   .  .        .           .  .   ..           . .
..................................................................................
