............................................................................................................
. .   .   .  .            .      .   . . .         ..              .     .        ..        .        .     .
. .    .. .      .. .   ..  .           .   .  .   .   .      .              .       . .       ..    .   . .
..         ..       . .    . .              .             .        .  .                     ..             .
. .               .    .    .         .           ..        . . .  .    .    ..       .  .  .         .    .
.   .               . .          . .   .        ...    .         .        ..              . .   . ...  ..  .
.  .             .   .    .     .           ..    .        ...  .        . ..    . .  ..   .    .  .     . .
.  .  .  ..      .  .               ..    .          . .  ..     .         .         . .    .    .      .  .
. . .   .         .      . .      .           .     .   .  .  .  . ..      .           .   .  .        . . .
..            .           .     . ..         .   .    .        .           .    .     .. . . . .           .
.      .    .        . . ..        ..        .. ...    .   ..              .     .    .       ..  ..      ..
.  .    .  .         ..                 ..  .               .               .         . ..   .          .  .
.           . .      .. .  .  .                  .    . .        .    . .   .  .    .     .                .
.                   .  ..  .      .     .  .            .          .      . .   .   .   ..   . ..   ..     .
.       ..     .   .  . ..      .  .. .  .        .          .     .   .       .           .               .
. .       . ..  . .  ..  . .. ...        .   .            .      .. .              . .   . .    . .  ..    .
. .  ... .     .                 . .    . . .     .                                         .    ..        .
.   .       .    ..  .          ..         . . .     . .                 ..               ... ..  .   .    .
.   ..        .   .     .      . .         . .       .           .   . .            .   .      .  S   . .  .
. .           .   .     .      . .          .  .  .           . .   .    .    .      . ... .   ..   ..  .  .
. .   .     .  . .       .                 .       . .         .    .   . .   ...           .. .           .
.              .      .             .     .  .. X    .  .     .   . .      . .  .     .        . .    .    .
. .  .    .     .          .         . .    ...  .  .. .       .         .         .  .             .    . .
............................................................................................................
