...............................................................................................................................
.   ..           . .      .  .    .            .  . . .  . .  .       .  .      .  ..      .    ..   .   .  .  .. . .   .. ....
.   . .. .                     . ...    . .   ..      . .  .    .. ...     .    . .   .. .  .  .  ..  . . . .   .    .      ...
..  . ..          ..       .    . .   . . ..     ..   ....                    . . . .  ..       .  .    . .             ...  ..
..  .. .     . . .         .  .  ..   .  .  ..   .... .        .   .  .          .      . .  . ..   ..   .   .    .           .
..   .   ..   ..        .  . .        ..       .   .  . .   .     .           ...  . .  ...        .         ...          . ...
.     .                   . . .              ....     .   ....  .. .  ..   .      .        ...     .  .   .   .   .  . . .   ..
.  .   .  . ..             . ....     .. ..     ..... .       ..   .  .. .  .. . .   .  .  ..   .       ...       ..  .       .
.. .    . . .  .  .  .. .. .  .  ..  X.     .    .      . ..  .      .   .. ..    .  ..    . .     .           . .  .    .    .
.  ... .   .     .   . .   .  .     .  .  .    .   .. .   .       .        .       . .     .      . .  .  . .          ..   . .
.  .  ..                . .    . .     ..  .  .       .   . .     ..    ..    ....       .  ..    .    . ..  .   .       . . ..
.   .   .       .     .  .      ..    ....  .    ..   .   .       . .  .. .                 ..   . .    .    S.   .  .  .  .. .
.   .  . .      .. . .  .     .. ..   .   .     . .   ... . ..    .  .  .  .   . ..       .      .      . .   .    . .      . .
.. .  . .  .    . ..      ..        .    . .            ....           ..    .   .     .   ...       .  .   .       .  .    ...
.               ..        .  ..   . ...     ..     . .   . . .     .  . . .   ..        . .  .       .       ..  ...          .
...............................................................................................................................
