.......................................................................
.. .        ..      . ..    .. ...      ..    .      .     .    ..    .
... ..      .   .         . .. .       ..  . ..      .      ..   .   ..
.  .        . . . ...  .       .    .     .... .      .  .  .   .     .
. . .   .    ..  .    .    ..  . .     .    . . ...  .  ..  .        ..
..  ..  .    .           . .  . . .           .  .    .   .S ..   . . .
.      .   .        ... ..  .   .       .  .    ..     .     .    .   .
.        X   ..   . ..  ..  . . . .  . ..   .              .       .  .
.. . .   .        . .    . .         . .. .  ..  .    .  ...   . .  ...
.    .           .       .  ...   .  .       .         .     .   . . ..
.   ..  .       . . .....       .   .    ..  .         . .   .      . .
.      . .    . .      .          .         .    . .  .            .. .
.  .  .   ...  .   ..        .       .  ...  .. . ......    .         .
..  .. . .  . .  .    .    .   .  .. .         .  .   ..     .   .    .
.  .  .. .  .. .  .     . ..   .       . . ..        .     . .     .  .
.      .         ..    . . .   .. ..           ...       .  . ..  ..  .
.       .  .    . .    . .. . .      .   . ... .     . .       .    . .
. .        .       .  .  ... .     ..   .. ...    ..   ..  . .  .   . .
.    . . ... ..    .   .             .   .  .    . .      .     ..    .
.   .  .   .  ...  .     ..  .    .           .  .      .     . ..    .
.  .     ..   .    ..   .                . .   . . .              .   .
.......................................................................
