..............................................................................................
.  .  .    .   .    .   .    . .    .  ...    .  .           ..     ..          . .     .    .
.     . .   . .              ....    . . .       ....       .  . .. ...  ...                 .
.  . . . .        .  . .     ...   .      .        .. .   . .   . . .   .            .       .
..   ..    .   . . .   S       ..  . . .   . .     ..             .        .  . ..  .  .     .
.  ..     ...           .    .    ..           .     . .        .          ..  .             .
.   . .    .    ..      ..  ..    . .  ..      .  .   X  .        ... .              .     . .
.     .     .     ...  .    .          .                   .     .   .     . .        ..    ..
.. ...   .   .    .           .  .     .     .. .     .   .  .     .. .  .    ..  .          .
.    .  .   .     .    ..  . .       ..  ..  .   ..      .      .    .      .   . .   .  .  ..
.            .  . .   . .  .   .   .     .        . .  ..          .   ...  ...           . ..
.        .        .    .  . . .  .    . .       . .     ..        . .               .  .. .. .
..............................................................................................
