..................................................................
.               .    .           .            .. .  .     .   .  .
.  .         . .    .         .         .   .        .           .
..            ..       .  .                    ..     .   .     ..
.   .       .     .                .          .     ..      .    .
.    .          .          . .      .             .           .  .
.  .    . .       . .            .   .    .  .           S       .
.. .   .      .       .         . .   .. .  .        .       .   .
..       .      ..  . . .  . .           .     .      .    .     .
.      .   .             .     .    .     .       ..             .
.    ..                             .         .    . . .   .     .
.     .      .     .   .   .   . .  .            .    .        . .
.        .               .   . .  .                  .   .       .
.              .    .  .    . .         .    .             .  .  .
.   .    . ..        . .      . .   .      .        .  . . .   . .
..      .          .   . . . ..    .       .  .  .  . .  .    . ..
. .          .   . .   .                   .   .            .    .
.  .    .  .                           .          .           .  .
.             .      . .                   .  .      ...         .
.    .    ..                  .     .           .                .
.      .           .       .   .    ..           .    ..         .
.    .   .               ..  .    . . .     .                .   .
.     .      ..   .  ..      X      .  .     .        .        . .
.  ..   .  .       .         .     .  .         .       .   .    .
..................................................................
