..................................................................................................................
.   ....    .. .   .  .   .      .  . . .    .....      ....   .  ..       .   .    .  .   . .   ..          .   .
. . .   .   ..    .   . .   .    .   .      .  .  . .     . .   .           .  .      . .  .        . .   .   . ..
.. .   .     .  .   .    .   . ..           .       . . .     .     ... .      . .          .   . . .        ... .
...   .   .            . ..   .         .. .      ..  .. .       .  ...        .         ...   .   ..  .    .    .
.  .. .    X         .    ...   .     ..   S.. .        .  .  ..  .  .     .  .  .     . .        .   .        . .
.    .   .    ..               . ...   .      . . ..   . ..      .   .  . .   . .  ...     .        . .... ..  . .
..    . .   . .  .. . .. . .      .  .....   .   .  ..  .    . .    . .   .          ..  ....  .    . ..        ..
. .       .   ...  .    .  .  .   .  . .  .    .   .    .  . ...                        .    .     ...    . .    .
..  . .    .     ..     .    . . .       .  .. .    . . .  .               . . .           .   ..   . .   . .    .
. .   ..  .    .   .        .. ..        . .. .  . .  ... . . .  . ..  .           . .     . ..  . ..        .  ..
.   .  ...  ...     .       .      .  .        .   .       ..  .   .  .   .    .   .. .    .    ..       .. .    .
.     .   .     .   .. . .  ... .    .... ...     ..     .. .  . . .    . .. . . .   . .    .                 .. .
. .  .  .     .             .        .    .. .  . .              .      . .     ... .  . .      .       ..  .  . .
. .  .     .    ..         .    ...     ..  . .  .  .   .. ..  ..   .    .     .  . . .. ..      .  ...   . ... ..
.       . .      .. .  .      .   .   ..       . . . ...     ...    . ..     .  .    .....   ..    .     .  .  ...
..   .     . ..   .  .      .. .     .        . . ..  .   .. ..   .  .         . ..   . . ..  .        .         .
. ...           .    . .. .. ...  . .      ..    . . .  .    .     . . .   .      ...  ..      ..                .
. ..    ..           .      . ..        .  .  . .   .. . ..       ..     .     .     . .... ...  .  .    . ..    .
..................................................................................................................
