...............................................................................................................................................
.    .  . .   .   .   .            .  .   . .   .           .  ..         .   .  .      .   .    . .    .           . .            .     .    .
. .     .  .         .  .. .       .. . ..       .                  ...   .  ..        .          .    .  .      ..   ..                 .    .
..      .  .          .       . . .   . ...           ..       .     .   .  ...     .   .       ...       .     .       .  .     . . .        .
.        .               .  .            . .    .      .   .. .    .      .  .  .. . .        . .   .        .               S .   .        . .
..  .   .. ..    . .  .  .         .      ..        .                      .    .     .       .        . ..      .   . . .         ...  .     .
. .           ..  ..   . .       .  .  .    .. .        .. .  .    .  . . .                      .  .  ..  ..               . . .  .    .     .
. .     .    .  .. X   ...          .  .     .        .      .  .    ..      ..    .               .                     .                    .
..      .    .  .  .      .                    .          ..  .     . ..   ..                          .     .       .          .. .          .
.      .   .    .      .   . ..      . . .        . .  .   . .  .   . .         .   .           .  .  .     . .      .               .  .     .
.   . .       ..       ...   .   .     .  . ..  .  ..                    ..       .           .    .  .       .                  . .          .
.               ..         .     .   .    ..        .  .     .                 .       .  . .        .   .             .     .       ...  .   .
.     .      .  .   .            ..   ... .    .       .    .   . .      .  .   .   .       .   .    .                     .                . .
. .    .       .        .      . .    ..        .          .      .       .            ..  ..       .           . .       .    . .   .   .    .
.        .    ..  .    .      . .   . .      .       .             . .              .  .    .    .       .   .     .. .     ..           .    .
.      .   .   ..            .      .  . .                 .    .  .      . .     .   .                ..    .     .  .      .               ..
.  .  .          . .   .    . .  .  .      .      . .      . .     .                        .     . .... .   .     .  ...                 .  ..
. .. .              .      .     .   ..         .. ...   .  .               .  ..    .      ...      .  ....                 . . .         .  .
.   .             ..   .      ..                   . .       . .  .    .        .       .              .  . ..  .      .   .   .           . ..
.       .            .      . .    .        .    .  .        .      .. ...    . .     . ..  .   .        ..    .  .     .     ...             .
...............................................................................................................................................
