........................................................................................................................
..     .  .   . .     .     .             .       .  .     .      X     .  .  ..              . . .          . .  .    .
.        .   ..  .      . ..   ..   . .     .        .  .                 ..    .      .. . .    .  .  S         .     .
.     ..         . . . .            .           .                        . .    .  .                         ..        .
.         . .    .    .  .                   .    .            .   . . .. .             ..    ..    ..         .    .  .
.      .      .    . ..    .     .   . .. ..      ..  .            ..  .         .   .       .          .   .. .    .  .
..       .  ..  . ...      ..          .        .          .    .  .                     .    .      .  .      .       .
.      ..   .       .  .    .     ...      .    ... .          .     .  .  .    .   ..    .      .              .    . .
.  .      .               .  ...     ..      .  .           .  .  .   .      ..     .     .    .  .         .. .     . .
.  .     .   .    .      ..          .  .    .  .             .    .       .                ..      . .   .   .  .   . .
.  .  . ..           .  .         ..    .    .     .      .. . .    . .       .    .. .    .       .                .  .
.          .   .    ..   .   ..                .     .         . . .         .   ..                    .  .    .       .
. .   ..   ...       . .     .       .       .  .        .. .      .  .  . . .. .      .   .           ..     ..    .  .
.      ..         ..        .   . .    . .       .    .                    . .   . .         .     .          .  .   . .
. .     .      . . . .     .   .  .           .    ..        .       .      ..  .  ...         . .  .     . .          .
.     .    .     . .    .  . ..      ... .   .         .      .   . . .  .      .  .    .  .       .           .  .    .
..   .     .    .     .  .    .     .   .     .             . .   .  .           .  .     .              .    .    . . .
.   . .   . .         .  . .      ...  .          ...               . .   .     ....        .    . .      ..  .    .   .
. .     .  ... .      . .                .    .     . .      .        .   ..     .         .   .   .                   .
........................................................................................................................
