.......................................................................................................
.                      S         ..                                 . .   .          . .             ..
.        .                    .                        .  .            .     .      .               . .
.    ..  ..           .                 .     .  . .                             .                    .
.                         . .                             . .               ..   .                 .  .
.          .   .    .  .        .    .        .       .                .  .  . .         .          . .
.                      .                       .                     .. .                             .
.       .    .       .     .  .   .            . . .   .            .       ..       ...        .     .
.              .  .    .                  .                    .    .   ..          .                 .
.         .                    .      .    .                 .      .    .             .      .       .
.    .       .     .                                        .          . .   .   .    .     .       . .
.   .   .                                           .   .      .    .                                 .
.                       .                         ..    ..            .    ..                      .  .
.      . .               .        .    .. .                ..       .               ..     .  ... .   .
.  .    .              .  . X                                   .  ...             .                  .
.               .  .   .   .               .         .                   .                   .        .
.  .     ..                 .                .     ..                 .                 .  ..         .
..                                          ..           .                   .   ..            ..     .
.          .  .      .      ..                         .  ..  .      . .                              .
.         .   .                          . .   .  .  .                                        .       .
.     . . .                          .        .    .       .  .  .  .   .                  ..         .
.   .     . . .       .          .                               .    .   .                       .   .
.   .    .    .           . .    .                                                                .   .
.                                                 .   .    .   . .   .      .    .               . .  .
.       .   .                   .     .                 .      .  .   .   .         .      .  .    .  .
. ..  ..   .                  .   .  .  .         .                  ..              .         .    . .
..   .             ...  .                                  .                             .          . .
.             .                    .                                               .                  .
.     .  .   .                          .                       .    .     .    .          ..       . .
.......................................................................................................
