................................................................................................................
.        .    .           . .          . . .           .                 .      .  .            .   .  ..      .
. .                .        ..   .         .  .     .    .   . . ..              .           .        .      . .
.    ..            .             . .      ...        . .    . .      .     .   .  .      .                    ..
. .   .      .. .   .       .       .           .  .  .         .   .              .      ...                  .
.        .  ..         .        .              .            .  .                         .             .      ..
.               .     . .  .   .                       .       .     .  ..     .    ..  .        .     .  .. . .
.      . .   . .  .        . .           ....   .   . ..       .           .      .  .   .        .            .
..     .      .    .  .  .                 .     ..        .        .          .    ..          .              .
.      .        .   .             .   .     .    .       .. . . .. . .         .          .  .      . .        .
.  .             .  .     .  . .  .  ..   .    .     ..       .       .   .     .          .                   .
.     .  .  .  .  X.         .      ..                       .             .   .         .              .   .  .
.      .    .   ..   ..  S        .    .              .   .                 ..   .  .   .  ..                  .
.               .               .    . .          .       .       . .                         . . .           ..
..  .            ..   . .             .    ..          .  .               .         .           ..      . .    .
.      .          .               .   . ...      . .     ..      .    .       .    .  . .                   .  .
. .  .  . .    .    .     .  .  ..          .          .     .              .       .            .  ..         .
.     .  .  ..    .  .   ..  .                  .                   .  . .          .      .     .   .  ..   . .
.            .                .. .   .          .            . .          .   .  .             .     .         .
................................................................................................................
