..............................................................
.  .  .       .. .  .         .      .. . .   . .    .    . ..
.  .         .     ...  .            ...        .          . .
.  ..     .   .     .    .  .                             ....
..                .         .   .  .           .       .    ..
.     .. .     . .        .         .  .   ...        .    . .
.     . .     .      .       .                      .        .
. .     .  .  .  .   .            .                       .  .
...       .                ..  ...   .    .                ...
.          . .  .        .  .     . ..  .      . .. .        .
.   .  .      .    .        ..   .       .     .           ...
. .  .           . .     .. ..    .    .  .  ..       .      .
.. ..  . .      S  .    ...        .  .      .   ...    .   ..
...  .       ..    .   .  .        .  .  ..  ..            . .
..    .  . .               . ..        .     .         .     .
.       .         .    ..       .. .   . .  ..     .  .      .
.    .      . .   .      .     .  .  ..      .   .   .       .
.   .    .               . ....  .     .  X   . . .  .       .
..         . .      .          ..    .     .  . .  .     .   .
....       .   .   .    .          .    .        .      .    .
..  .     .  .. .   ..     .        .   .   .         .  ..  .
..             .    .         .  ..    .   .   . ..        ...
...          .     .        .       . .      .               .
..      .  .     .   .             .                   .  .  .
.        .           .          .   .. .    .. .             .
..............................................................
