..........................................................
.  .      .            X                             .   .
.  .     .     .     .. .  .      .      .       .    .  .
.   .                   ..   .                   .     . .
.         .         .    .  .    .. .  .        .       ..
.    .       .         .    .             .    . .      ..
.   .                .               . .       . .       .
.              .         .              .      .         .
.           .                   .  .            .   ..   .
.     .       ..   .           .        .             .  .
..  .   .                    ..                       . ..
.       .                           .                  . .
.       . .                               .           .  .
.        .    .       ..           . .  .             ....
.           .        ..       . .           .  .         .
.  .     .  S                 .         . ..   .         .
. . .                 .             .     .              .
. ..                   .  .     ...   .   .    ..    .   .
.                . . .    . .    .. . .  .     .        ..
.  .  .  .                                .             ..
.               .       .    . .      .   . ..           .
..         .           .                    . .        . .
.    ..        .          ..              .              .
..........................................................
