...............................
.    . .  .  .       ... ..  ..
.     . .    . .    ....   .. .
.      .     ..     ..     .. .
...   .   . .        .    .. ..
. .... . .  ..    . ...  .    .
.. . . .  . ..  ..  .    .S   .
.     ..   X .   . .. .  ...  .
. . .    . .  .    .. .  .   ..
. .              .  .         .
..  . . ... . .             ...
..      .      ..    ...  ..  .
. . ......  . .    .   ...    .
.     .    .   . .  .         .
.      .  . . . .      . .  . .
. .     .  .   .... .  ..  .  .
.. ...  ..  ...     .         .
.    .    .   . .. .   .    . .
..   ..                .  .   .
..  . .    .   .. .       . . .
..      . ..    ..    .   ..  .
.. .  .    . . . .   .. .     .
..                .    .   .  .
..   .. . .  .      .   .. .  .
...............................
