......................................................................................
.          .   .  S .      .  .      .    . .   .       ..  . . .          .  . .    .
.       .   .     . . .     .  .   .        .    .       .  .. . ..    .          .  .
. .  .    . .   .        .  . .   ..  .. ..  .      .          ..           .     . ..
..  .       ... . .      . .  .. ..    .  .       ..     .       .      X  ..  ..    .
.    .  . .     .    .   .      . .     . .  .    .  ..       ....      ..     .     .
.   .     .         .  . ..             .  .                 .    .       ..  ..  . ..
.. .              .    .   .... ..   .     .        .      .   ..   .      .  .     ..
..    .           .    .    .    .  ..     .  .  .         .. . .    .  .    .       .
. . ..   . .. .                           ..  ..    ..           .    ..      .  . . .
.  .     .        ...  .  .         .      .    .  .   .     .    . .   .  .  .      .
.   .      .   .    .    . .     ..    ..   .    .        .      .         ...      ..
. ...    .    .    .. .       . .   . . .  .  .   .     .   .      ..  .             .
.   .              ...  . . .     .   .. ..    . . .     .  . .  . .           .    ..
.     ....            .                               .      .    . .   ... .       ..
.   ..  ..    .   .     . . . .    .      .    . .     .       .  ..   .  .        . .
.      ..        ..  .  ..    .   . .                               .  .     . ..    .
.  .     .      ....        .  . .      ..    ..   .   .   .         . .  ..   .    ..
.     ...        .. . .     .   . .  ...   .      ..           ..  .     .           .
......................................................................................
