................................................
.             . .                  .           .
..     . . X  .               .      .         .
..    .    . .           .   .           ..    .
.   .         .   .  .                    .  . .
.        S .   .    . ..              .        .
.     .   . . .      .   .         .  .        .
.  . .   .      . .      .   .     .          ..
.                  .        ..     .      .    .
.           .        .    .      . .  .  .     .
................................................
