...............................................................................................................
.   .   .    .        .          .            .    .   ..  . .      .        . . ..  .. . .                  ..
.      .    .    .  .         .    . .  . .        ..       .   .  .  .  ...        ..         ..       . . . .
.            .. ......        ..         .      .  .        . .      .. . .   .         .  .   .  .       .   .
. ..          .   . .     ..  ..    .         .      .     .   .          .  .   .  ..  .    .  . .           .
..              .    . ..      ..          .   .  ...   .    . ..         . ..   .  .  . .             ...    .
.  .       .          . .        . .     .    . .     ..    .          .  .  .     .      .        . .  . .   .
. .                  . .  .    . . .......    .  .  . .      .S  ...  .       .  . .          .        .     ..
.  .. .... .  .    .      . .        .  .          .   .   .          .           .    .      ..     ..      ..
. .       ..            .   . ..  .  .                  .        . . . . .            . .  ..      . .     .  .
.  .      .. .   ..            .               ..  .   .        ... .     .  .                 .  .       . . .
.     . . ..  . .      .  .      . .      .  ..        . . .. .         . ... . .    .   .. .    . . .        .
. .  . .  .   . . ..      .  ..   .  .          .                        ..   . . . .    .. .               . .
..        . ..              .                .  . .       ..     .      X   .         . . .    .   .      . . .
.         ...       .. .   .   . .     .   .  .          ....     .       .       .   ..            .       . .
.  .     .  .       ... .      .            ... .   .      .   .    ....    .   ..   ..    . .   ...   .   .  .
..            .       ..     .    . . ...             .. .  . ..    .  . ..  ...  .    .   .    ....          .
..  .  . . .        .       .  .   .            .. .  .   ..   . ...   .... .       .       .  .         .    .
.      .     .   . . .         .  . .   .    . .             .       .    .   .   .   .        .   . .   .    .
..   .                            .. . .    . .   .  ..        ..   .     . . ..     ..               .   .   .
.    .    .   .   ..  .   . .           .    .  .     ...  .           ..  .   .     .   .           . . .    .
...    .  . . . ... .   .  .    .    .    . ..  . . .                 .   .    .       .     .     .  . .  .  .
...............................................................................................................
