....................................................................................................
.  .  ...      ...        .         . .  .  .    .   . ..   ..      .   . .     .. .      .     .  .
..  . .      .   .. .S           .  .    .  ..    .  .  .. . ..    . . .    ...   .. .. .         ..
. .... ..    ..   ..                  ..     .   .....       ....   .. ..  .       ..       .  .  ..
.      .    .     . .   .      . .      .   ..    .        .   .      .   .  .   .  ... ..  .X.  . .
..   .   ..  .  . .   ..  .    .       ..  .  ..     .  ..    .   .  . . .    . .   .     .. ..... .
..       . ..     .             .       ... .  .  . .  ..  .     .    .  .     .  .     .. . .     .
.         .  . ..      .      .        .  .    .      . .  . .  .  .    ..  ...  ... . .   . ..  . .
.   .  .  . .. .   .      .     ... . ..   ... .   . . . .    .   . . .  . .  .   .  .  .         ..
.  .         .  .          . .     .       ..   .     . . .        .. . .  .  .. . ..  .  ..    ....
.. ..   ..      ..    ..     . ..      .. . .. .   .   . .   ..    .. ...  ..      ... .   .. ..   .
..  .    ....  .     .. .      .    ... .  ..       ...... . .  .         ..  .....  .    ..  .    .
...    .. .       .        .... .. .   .  .  . .  . . .      ..     .   . .  ..    . .      .  .. ..
.      . .     .  ..        ..   .   .  . .     .     . .    . . .  ..       .. . .               ..
. ..     .        .  .      . ..                .  .        .  .      . .       .  . .  . . .      .
.     .                 .     ..  ..         .   .     .             . ..   . ... .    .  . .. .   .
....................................................................................................
