......................................................................................................................
.   .            . .        .          .    ..   .         ...   .    .         .    . .    .            .    .      .
.      ...  . .    .       .  .    .  .  .      .   . .    ..    .   .  .       .   . .  .  ..   ...  .  .       .   .
.        .            .              .     ..         .     .      .  .         .   .   ..        .        ..     .  .
.  .   .         .           .                .   .                  ..   . .     .    . . .  .              .  .    .
.     ..      .   .    .  .     .  .       .   . . .    ..  .     .    ... . ..            . .    .  .    .. .  .  . .
.       .            .        ...  . ..  ..   .          .         ..    .  ..        .     .  . .      .   .   .  . .
.  ... ..            . .   ..  .    .        .  .   .      .   . . . .   ...   ..   . .           .  .      .. .    ..
.  .  .   ..  .       . ..... .     .    ..           .         .           .  .  . .            .      .   ..     . .
.  .          . .    . ..   .          .     ..                .     ..    ..     .            .   ..   . .          .
.             .       .    .. ..    .               .   .   .  .           .     .      X .. .    . . .       . . .  .
..  ... .    .    .        .        . .   .   ..     . . .      .     ..               .  ..      . .   .    . .     .
.   .              .   .          . ..    . . ..  .         .   .     .             .      . .   ..               .  .
.           ..                       .          .       .      . ..         .. .    .      ..   .       ..     .  .  .
.   ..  .                  .  . .        . ...   .   ... .    .          .      .  .   .. .    .  . .  .   .   . .   .
.    ..                    . .  .    .  .    .  .          ..  . ..   . .     .  . .  .     ..     .  .   ..      .  .
. .    .      . .    ..        ..         .      .      ..      . .        .                S              . . ..    .
.      .  .            .          .  .. .      .    .  .. .  .         .. .    .   .       .... . .        .      .  .
. .    .       .         .    .           ..    . .      . .  ..            .  . ..  .   ..   . . ..   .     ...     .
.      .  .          .     ...           .         .  . .     . .  . .    ..  .                  .   ...     .      ..
..                    .   ..     .           .   .      .        . .      . .   ..       .  ..           .. .  . ..  .
...    .         .  .   .  ..  .   .  .  .  .     .    .    .            . .  .  .           .             .   . .   .
.    .  .     ..          .  .  .         .    .            . .      .   . .    .   .  .      .                    . .
.     .      . ..         .      .      ..    .   .     .         ..    .  .    . .    . ..        .      .        . .
.           . .       ..    .   .  .   .   .     . .           ..  ...                . .     . ..       .  .        .
.     .     .         ..        .. .                 .     .   .       . .       .    . .    ..      .. .     .   .  .
.    .. ..  ..      ..    .       ..         .   ..   .              ..       .          ....  .       .             .
......................................................................................................................
