.........................................................................................................................................
.  .    .              .   .          .  ..      .  .        . .                .           .       .      .   .     ...     . .  .   . .
.      .    .      .          .      ..         .      .  ...            .  . .  ..       .        .           S                .     . .
.  .                .      .   ..    .  .. .                 .       ...  .  . .       ..       . .          .    .  .    . .   .       .
.     .                  . .                   .            . .          ..         . .      .         .. .    . .     .  .          ....
.       .        .   . ...           .         .       .                    ..  .          .         .  .   .  .  .       ...       .   .
.  .     .    .      .         .    .   .   .     .. .   .      .   .      .    ..       .     .   .                   .            .   .
.            ..  .           .        .    .               ..         .     .. .                  .. .  .  .    .  .   ....  .     .    .
.    .   .       .               .    .           .              .  .   .   .    .  ..  . .. ..   ..    ..   ... .           .          .
.             .        ..        .   .  .                 .            .   .            .   .   .    .  .  .                 .   .    . .
.          . .   ..      .         .           . .                    .    .      .  .  .     .  ..  . ..  .           .       ..       .
.. .         .              .      .   .     .       . .            .  .     .  .                 .       .           . .. . .  .     . .
.       ..  .          . .          ...     ..   .         .    .  .    .      .   .        ..   .   . .       .                        .
. . .  .      .   .      .    .          .               . .     .     .X         .  ..   .        . . .                . .     .       .
.   . ..              .    .. .   . . . .    .  .    .             .     .       .   ..       . .  .          .       .   .            ..
.          . .  ..   .    .         ..             ..                             . .          .  .  .       .                          .
.    .  .  ..  .     . .       ....      .   .              .   .          .       .           .   ...         .                    .   .
..  .    .. . ..    .                . .      .   ..       .     .    . ..    .  .     .   .              .          .       .    ..    .
..         .    .  .        .   .          .        .   .  .     .   .        .  .  .         .       .    .. ..  .  .   . .         .. .
.               . .       . .              .                 .           .         .... ..        .      .  .            .         . .  .
.   .                      .           .            .        .      .      .   . .      .    .                   .       .              .
.                    . ..    .          .         .                        ...  .       .    ..  .        ..        . .      .   .     ..
. . .             ..    .   .       . ..     .         .                      .        . .     .     . .      .     .  .. .   .    . .  .
.  .  .  . .      .  .       .    ..   .    .       .        . .   . .  .. .           .  .         .               .     ..     .      .
...  .     .      ..             .      .       .         .     . .      . .           .               . .                              .
.  .     .    ..  .                                    .    . .  . .  .      ..       .        .           .        . .    .   .      . .
.         ..      ..                .    .              .                  .       .          ..                ..  .           .       .
.   .       .   .  .    .       ..          .    .   . .  .     ..    ..       .   .                   .       ...                .     .
.    .    .            .                .        .    .. .   .                  .        ..  .      .       .    ..   . .  . .   .      .
.........................................................................................................................................
