.................................................................................
.      .       .            ..          .           .          .       .  .     .
..        . .   .  . .      . ..           .    .     . .       . .. .     .    .
.   .        .  . .   . .           . .   .   .   . .          .          .. .. .
.  . ..  .              .      ..         . .       .  . . .X.    .       .     .
. .       .     .          .          .     .. .  .    .    .      .. .  .   .  .
.          . .     .  .   .         ..  .   .     .           .  .   ..   .     .
.    . .      ..   ..       .       .. ..        ..  .    ...  .     .          .
..   .               .   .    .   .    .        .. .       .  ..      ..  .     .
. .. .. .              . .                  .    .      .     .  .         ..   .
. .. . ..     .  .       .     . .   .    .    ..  . . .         . .     .  .   .
. ..        .                 .. .      . .  .  .                   .       ..  .
. ..    .      ..     .                .  . .   .    .     .       .        .   .
.           .           .        . ..    .       .                .  .          .
.                  .   ..     . .    ..  .  . . . .  .            . .     .    ..
.     .  . ..   ..      . .      .        .                 .  .. .            ..
.         .   ..   .           . . ..   .  .. ..  .  . .    .  . .      .  .    .
....   .  .          ..       .  . .    .    .        .   .   .      . . .   .  .
..      ..    .         .                  .          .     .  .S     .. .     ..
..     . .  .    . .       . .    .      . ...     ..  .          .          .  .
.................................................................................
