...............................
..    S   .         . .       .
.. . .  .    . . .     .      .
. .   ..  .  .     .      ..  .
.    . .   . .  .   .  .   .  .
.    .             ..  .      .
. X.    . ..      ...       . .
.                 .           .
.  ..       .       .        ..
.  .  .        .   .   .    . .
.    . ....   . .    . ..   ...
.        . . .    .      .    .
...............................
