................................................................................
.  .        .   .            .                   .    .         . .   .    .  ..
.                   .         ..                 ...   .    .  . ..       .    .
.   .  .     .      .   .            .   .  .        ..  .       .    .   .   ..
.      .      .       .    .               .   .            . . ..      . .  . .
.           .           .      .    .      .. . . .   .                .... .  .
.   .  . ...     ..      .     .           ...    .     . .     .         .. ...
.   ..   .       ..          .   .  .         . .       .   . .       . .      .
.   .    ..                 ..      .                .  .               .     ..
.    .     ..        ....      .   . . .      .  .       .                ..   .
.      . . .                     .     .  .                    ..    .    .  ...
.             .         .         ..            .     . ..    .. .  .  ... .  ..
.       ...       ..           .   .   .    .   ..   . . . . .   .             .
...    ..          X     . .. .                ..  .    . . .. .  .       .    .
. ..   . ..       .   .                        .     .     .      .   . S.   . .
.  .          .            .        .    .   .     ....              .  .   .  .
................................................................................
