......................................................................................................................
.      .  .  .  ..       . .        . . .           .     .      .       .      .   .     .   ..      .. .  .       ..
...    .  .      ...   .                     .      .   . ..             ...   . .    .  . .    .      .    .        .
.      .    ..     .     ...   ..  .  .  ..      ..  .        ..  .   .    .  .. ..   .. ...     .      .        .   .
. .   .  .     .       .      ..   . .  ..           .  .....   .  .  ....     .   ..    ..            ....  .   .   .
..      .   .  ..   .   ..   .    ..       .      .  .. .   .      ..    .   ..        .      . ..    .    .         .
.             ..   .  .   .    . .  .        . . ..     .      .  .             .  . .      . .    .  .  ...   .  ....
.   ..     .  .   .    .    . . .         . .. ...      .           . .  .       .    .    .     .   .  .            .
...    . . .   S.         .   .    .. .      .   .  .         ..   .... .          .    .  .      .  .     .    . .  .
.                   .       .    .. .  .       .    ..  .        ..    .  .  .   ..  .   ... .        .     .        .
...    . .. .. ..      . .       .        .     .  .  .     .   ..        .    .     . .       . . .   . .           .
.   . .              .  ..    .  .  .      .  .     .  ..         .. . .     .    ..  .. ..     .     .     . ..     .
...   .   .       .               .  .  ..   .    . .  .     ..  .      . .   .     ..        . .                  . .
. .    ..    .   ...   ..   .. .    .  .    .     .   .        ..               ..   .    .            ..  .      .. .
.  .  . .        ..               .  .    .    . .. . .     . ...  . .    ...        ..    ..  . ..    ..  .   .  . ..
.      . ..   ..   .      .  . . .   ..  .  .                 .    .  .. .             ..  .  .    .     . .   .  .  .
..            ..       .   .         .     ..  .  .  .   .. .     .    .  .  .. ..        . .     . .. .  . .   .   ..
. .  .    .      .   .  . .             X   .   ...     .   .    .   . ..   .       ..  ..  .            . .  ..    ..
.  ..   .  ..   .. .  .   ..         .     .  . .     . . .  . .. .  .    .        .      .   .       ..      . .. . .
..     ..          . .  . .    .. ...  . .     .   ..     . .       ..   ..  ..    .  .      . .           .. .      .
.  .     .     ... .    .           ..    .  .      .     .   ..... ... .. . .       ..       .      ..        .. .  .
......................................................................................................................
