......................................................................................
.                   .       .    .    .          ..      .      .          .  . . . ..
.   .           .         .   .     .    .         X           ..      . ..     .    .
.      . .  .   .         .            .    ... .        .  .   ...   .      .       .
.          . ..   ...           . .        .     .   .    .   .         . .    .     .
.. ..           .         .               .     .         .  .   .          .      . .
.     . .     .  .           ..  .    .   .     . .         . .      ...  .          .
.       . .      ..       ..    .   .           ..         . .       ...       .    ..
.   . .    .   ..          .           .   .       .   .      .. . .         . ..    .
.    . .   .        .              .   .  .                            .   .         .
.   .                   .  . .  .. .      .   .              . .     . ..          . .
.        .    .    .    .              .            .   .                 .  .    .  .
.  .   .  .  .   ..         .   .   .    .  . . .. .             .     .  .    .     .
.   .    .    . .   . .       .        ...  ..       .  ..    .   .    . .  .  .     .
.     .   ..     .                          ..   . .    .  .         .      .   .    .
.. .   .           .        .           .    .  .                  . .         .     .
.  .    ..  .   .   ..     . ...    .    .  .         . .        .  .      .         .
.   . .     .         .                                   ..   .  .     . .    ..   ..
.               ..   .             .                .         .  . .     ..        ...
.  .  .   .        .                .         .  .  .   . .             .            .
.  .  .                 .           . .   .                    .   . .      .        .
.          ..     .         .                .      ... . .                          .
.           .   ..  .     .  .   .       . .            .     . .     ..   .         .
.  .  .  .       .     .    .                 .         ..   .            . .        .
. .    .    .                               .. .           .  .            . .   . . .
.      ..               .         ...                    ..      .        ..         .
.     S         ...       .    .       .               .                   .      .  .
.     ..                                 .   .                    .      ..    . .   .
......................................................................................
