...........................................................................................................................
.  .              . .. .         .      .. .          ..       .    .      . .    .   .   .   .         . . .   .     .   .
. .  .   .   . .. .      .      . .                ..    .. .. .    .   .    .   ..   .. . ..   . . . .  .      .  .  .  ..
. .      ..       ..  .    . S  .      ..   ..  .            .  .   .        .  . .   .  .   .        . .    .. ..  .   ...
.. .   .           .    .       .    .  .  .    ...  .     .   .       .    .. .. .  ...         .            .  .   .    .
.  .. .    ..  .                           ...  . .  .   . .  .           .   ..  . . .  .  ..  . .  .   ...   ..... ..  ..
..  .   . ..               .  .         .  . ..     . .                  .     .           .  ..       . ..    .     .    .
.     ...   .              .   . . ..     ..   .  .           ..  .              .   .    ...     ..  .   .   ..  .       .
..  . ....        .        . . .   .   .                     .        .  .     . .  . . .  .         .  . . . .       .   .
..  .  ..   .   .  .     .      .  .    .  . .      ...    .        . . .  ..    ..     .             .. .      .   .    ..
..    .      .      .     ..  .       .    .. .    .   . . . .     . . .   .       .                 .   . .   ... .  ..  .
.  .      ..       .                  ..       ..   .  .      ..   . .          .  ...     .  .                  .      . .
.             . .   .  .    . . .    . .     .   . .    .         .    . ..   .   ......       .  .      . .             ..
. .     .   .          ..     .       .    ..    . X    ..     . .       ..  .  .             . .   .   ..    .       .  ..
.  .    .. ..  ...    .      .        . .     .. . .   .           . .       .        . .   .          .  ..    .  .      .
.        ... .     ..   .                  .    ..  .   .        .  .  .    .    .  ...       .  .          .       ..    .
..    .            . . .    .   .    .           .  .     ..      .  ..      .                ..           ..   .         .
...........................................................................................................................
