.....................................
.           .      .  . .   .  ...  .
. . .        ..     .    ... . .. ...
..      . . .    ..   .   . .       .
.. . X.  . .      .     . .   .     .
.    .  ...  .   . .  . . .  .      .
..     . . . ..       .. .          .
.  .     .    ..      .. ..     .  ..
. . . .    .. .    . .              .
. ...   . .            . ..   .   ...
.   ..     ...  .  .  ..     .      .
.   .      .  .S. ..        ..      .
.  . .    . . .         ..    .   . .
.   .  .   ..     .. .   ..   .   . .
. ..          ..       .     .....  .
..  . .  .. ..    ..  .     .      ..
.  .. ....   .    .    .            .
...        .... .   . .  .  .. . .  .
.....................................
