................................................................................................................
.                .   .       .     .     . .             . .  .     .        ..            .                   .
. ... . ...      .  .      .           .       ..     .   ..    .     .  .  . .    .     ..    ..              .
.  .     .  .    .  .  .        .             .  ..             ..                        .       .          . .
.       .       .                   . .    . .             .  .             X  .     .         .  .            .
..           .                .          ..    .  .. .   .        .   .        ..     .  .           .       . .
.  .        . .      .    ..   .                  .  .  .  .   .          .   .       .. .          .   .   .  .
. .   .         .      .               ..       ...        .    .   . .  .. ..           .          .          .
. .   .  .  .              .                                  .         ..       .                       . .   .
.       ..          .                           .            .     .                        .      .      .    .
..                              ..         . .   ..    .       . .                  .   .    . .               .
..                                   .  ..       .                .     .                  ..                  .
.      .  .                                                .     .             . .  .    .            .       ..
.           . ..    .  .      .       .       .           .            .    .                  .    .          .
. .     .  .     .      .   .  .             .   .                      .  .                              . .  .
..        .      .            .   ..       .      .           . .      .   .. ..               . . ..          .
. .             .      ..   .                  . .     . .      .  ..       . ...   .    S         .          ..
.             ..     .   ..                    .     .                                         .  .   .      ...
.                .   .  .                             .                    . .              .         . .    . .
.             .   ..    .               .    . .     .        .                . .  . .            .          ..
.                 ..     .                         .   .   .    .   .     .                                    .
.   .         .      .       . .  . . .        . .    .           .                 .           .              .
. .       .            ..    .   . .                 .       .                 .         .  .                  .
.     . .                .                     . . .               .       .     .          .                . .
.          .        .  .  . .               ..           .      ... .        .    . .    .   .                ..
................................................................................................................
