.......................................................
.        .        .      .     X.             .       .
.     .            .              .    .             ..
.              .       .   .. . .                     .
.                     .                    ..    .   ..
.     .      S     .        .   . . .      .. .       .
. ..        .              .        .          .    . .
.         .   ..               .         .. .    .    .
.       .     .     .        .  .                     .
. .       .        .  .           .   ..   ..    . .  .
.       .    .                                     .  .
..    ..   ..      .  .        .                . ..  .
.  .           .  .                .     .        .   .
. .      .  .    .       .                       ..   .
.  . .  .      .                             .        .
.......................................................
