.................................................................................................................................................
. .        .        . .  .            .     .         .             . .        . ..       S       .. ..          .         .     .        .  .. .
.  .               ..   ..                .      .       .            .      .. .      .                .             .              .          .
.  .      ..           .           .       .     .   .   .   .      . ..  . . .      . .     .   .     .  .         .   .        .    .         .
.                .                    .                              .                       .            . .  . . .   .     . . ..             .
.      .                  . .        .                    .           .   .            . .           ..  . . .  .    .   .      .          X .  .
.     .              ...   .   ..    .             ..         ...   .      ..    .                 .  .   .      .   .             ..      .    .
.                                    .      . .  . .  .     .    .        . . .  .      .   .        .         .     .        ..           .   ..
.     .  ..   .                ..            .       .    .  . .       .           ..    . .           .            .  .   .    . .   .       . .
.         .     .    .  . .    .      .          ..     ..     ..       .                . . .          .     .         .    .       .          .
. .      ..  .  .                     .      .  .   .       .   .  .                   .     .           .   .    .               . .           .
. .  .. .   .     .                   .  .  .                     .     .  .      .    .        . .                    .       . .      .       .
.  . .  . .   .  .. .         .     ..          .           .  .         .                                   ..        .      .    .  .  .   .  .
.................................................................................................................................................
