...................................................................................................................................................
.      . .       ..    .   .  .  . ..  . .  .  .               ....... . ...      . ..     . .. . .     .     .  .      .     .  .     .   ..  .  .
. . . .        .   .  . .   ..  ..                  ..   . .  ..   .      . ..   .         ..  .    ..     ..  .    . .    ..    ..    .    . .   .
. .    .  .  .    . . ..   . ..   .. . .          .    .     . . .   . .     .. .  . .     ..    . ..   ..      ...      .  . . .  .. .   ..  .   .
..... .      . .    .. .     .      .  .          ...  .    .    . .       .. .         . ...  .   .      . . ..  .     .            .     .. ..  .
. .. ...     . .  . ..     .   .   .         .  .  ..         .      .         .....     ..  .        .     .          .   ..   . . . .    .    . .
. .       .            .  .    . ...  . .  ..   . .  ..  .       ... .. .   .  . .         . .    .   .  ..   .     .  .         . . .     .. .   .
.......   . .   ...   ..      . .   ... . . . ..    ..  . ... ...      . ..  .    ..  . .  .  .   .         . . ..      ..      .        .  .     .
.   .  ....   .    ..    .. ...  .     .  . .   .      .  . .     .  .    .  ...        .           .        ..      . .   ..     .   .     .  . ..
.       .. . .         . ...    ...         ...   .     .   .    . . ..  .                   .     . . ...   . .       .   . .   .  .    . ....  ..
.    .  .    .     .         .      .    .    .  .     .    ..   .  ... .    ..      .    ...    .    ...         ..    .  .  . ...     ..  ..    .
. .. . .   . .       ..   . . ..   ..  ...              . ...  .  .  . .  . . . .  .            ....        .          .    .  .  . .     .       .
.        .      .  . ..   ..        .    .               ...          ..  .     .       . .    ..   .        .  ..... ...... ..       .  .    . ...
. ..S.  .   . ..  .  .               .   ..  . .   .    ..   .            . .          ....  .    .. . .  . .   . .   . ..          .   .   ..   ..
. . . .     . ..    . . .            ...   .. . ..   .   .     .. .  ..   .  .   . .        .          .  . . .   ..  ..  ... . .  ..   .    .   ..
.  .  . .    . .  .  ..  .       . ...  .   . .. ....   ..  .   ..     .    .  .. .. .. .   .  .  .     .       .    .           .          . .   .
... .       . .    .. .    ... . .       .       ..        . ..    ..    ..   . .. ..  .   .    ..   .   .       .     . .   .    .      ..   .   .
.  .     ..  .     ...  .  .. .      .   .   .          . . .     ....  . .    .   . .   ..     .... .         .    ...   . .... . . ... . . ..   .
.   .    .  ....       .   . ...   .     ..      .   .  ...   . .      ..   . .          .  .. ...  .     .  ...    .     .   .       .   .       .
.   .. . .      .   .  ....   . . .      .. ..       ..  ..        .   .          . .. .  ..   ....           . ..   .   .  .   .    ..  .    .   .
..   .. ..     .    ..          . ..     ....   ....        . . .   .. . .    . . .   .     .. ....          .  .    . . ....     .  .   . .   .  .
.       .  ... . .  . ..  .   . .. .. . .     .   .     .  .....  .        ..      .      .           ..    .. .     ..      .  ...  .  .  .  . ...
. . . .. ... .      . . .   .   . .   . .  .      .  . .     .   ..      .     .  ...  . .  . .    . ..   .   .. ... .    . .       .  .  .   . . .
. .       .   .   .  . .      ..      .   .    ..    .  .   ...    .     ..              . .      .        .X   ..  ..   .                     ....
. .. .     ...   . ..  .. ..   .     ..    .        . . .     ...      ... ..      .  .  . . ...    .   .     ..     . .  ..  .      ..  .  .  .  .
.  . .     . ..      ..    .         .       .     ...  ..        .  .  .      .        ..          . .   . .   .     .    ..  . . ..      .   .. .
...................................................................................................................................................
