...................................................................................
..       ..  . .    .     .    .    .   .  .. .   . .          .   .  .    .  .   .
.     . .   .   .  .       . .   . .. .  .          S   ....  .       .       .   .
.  .  . . .          ..      .  .    .     .. .    .  ..   .     .     ..        ..
. .   .   .  .  .     .  .   ..                   ..                     .    .   .
...     .      .  ..  ...      . . .  ...    .   .  . .    ..    ..         .     .
.      .. . .                      .. .    .                 .  .. ..       .   ...
.     .  .  . . .       .        .   .     .  .            .  .  .  .   .        ..
.                 . .  ..  .          .   ...                 ....  . ..  .     . .
.  .      .  ..            .    . ..         .             .    . .        .  .   .
.     .     .      .  .  .                       .         .  ..   .      .       .
.  .      .     .   .    . ..        .     .          .     .  .         ..       .
.    .    .          ... .          .   .. .            . .   .  ..        ...  . .
..   .   . .. .  .    .. .    .    .. .   .   .      .  .     . . . ...   . .   . .
.    .  . .        . . . . .  . .   ...    . .         .. .     .   .  .    .     .
.     .    .  ..       .. .          .  .  .       .  ..    .     . .    .  . .   .
..   .   ...    . .  .  .      .    .   ...     .      .  .     ...   .     . . . .
.                     .     .. ...                 .              ..              .
.   . .  .  .       ..  .   ..      . . .   X  ..         .  .     ..    . .      .
.   ..  ..     . .. .     .      .    .  .       . .  ..    .   ..       .  .   . .
.  .   .        . ..  .  .           .          . .      .  . .  .       .   .  . .
..         .        .  .   .    .. ... .   .  .    ..      .    .   .         .. ..
... .  .   ....     .  ..           ...  .   . ..  ..  ..      . .       ... . .  .
.                   .     .      . .    .           . ...  . .         .     . .  .
. .  . .       .    .  .      .     ...      ...      ..         .      . .  .    .
.   .    ..   . .   . . .                       .   . . ..     .  .  .     .     ..
...................................................................................
