....................................................
.       . ..              .. .      S  .   ..   .  .
..  .    .   .       .   .         . .  .     .    .
.     ..           .           .      .    .. .    .
.  .   .           .     ..    .                   .
..          X . .   ....      .    ..     .    .   .
..     ..   .  .    .     .                    .   .
.     .  .   .      .       ..  .               .. .
.  .          .   . .. .                    .      .
... ..   .  ..   .  . .  . .  .  .  . .    .     . .
.            .    .            .   .   . .      . ..
.     .   .       .      .           .      .. .   .
.. .. . .        .    .             .         ..   .
.    ..      .     ..  . .. ..                   . .
..          .  .   .             .   ...           .
. .       .   .              ..  . . .  .  . .  .  .
.         .    ....        .        .  .  ...      .
.    .  . .        .  . .      .       .        .. .
. . ..     .           .    ..  .. .      ...  .  ..
....................................................
