...........................................................................................................
.     . ..    ..    . . ..       .    . .        .             ..   ...          .   . .            . . ...
.      . ..    .          .        .   . ..  .   . .    . .  .    .  .    .  .          .   ..    .   .  ..
.  .        .    ..   .  .  .        .       ..  ..            .         .  .. . .  .   .  .   ..         .
.   .   .....     .  .   . .     .   .  ..      .  .  . .         .    .                 . .              .
. ..    ..  .    ..     . ..S               .       .  ..        .   . .. ..       .   ..           .  .  .
.      .           .  .    .      .    .. .. .    .         ..  .   .  .         ..    .     .   .. .  .  .
.           .  .        .         ..        .    .      . . .        . .. .  .     ...       .   .    .  ..
.   . ..  .   .  .    .        .    .        .  ..        .     .      ... . ... ..       .      .   . .  .
.    . .  .  .         .         ... .      .    . ...       . ..  .. . ..      ..  .  . . .            ...
.              .      .     .    . . .    . .   .     .        .      .       ....    . . .     ..   .  ...
.     .    . . .   ..  .     .     .    ..     .. .  .                 .  .. .    .      .. .   . .      ..
..  .  .          . .     .            .. ...        .   ..   X..      .  .   .        .            . .   .
.  .  . . ..                . ..   .     .             .  .  ..   .      .   . .    ..        .   ..      .
.  .  ..                             . ..  .     . .  .            ..   .   .      .  .          .        .
.                     . . .   .    .           .       .     .    ..... ..       ..           .         ...
.   .    .   .. .. .    .   . .       .. .   . .        .     .     .         . ..  ..     .    ..    . . .
...........................................................................................................
