.........................................................................................
.                 .            .        ..  .        ..                            .    .
.   .                                  .       .     .            ..  .          .  ..  .
.                    .      .             .         .             . .      .            .
.          .          .       .          ..               .                           . .
.      .                   .. ..                     .        .             .    . . .  .
.   . .  .            .      .      .. .                                                .
.  .          .            . .  .      .    . . .  ..                        .  .       .
.     .                                                 .        .  .       .     ..  . .
.       .                 .   .           .                  .                         ..
.       .  .     .            .             .           .     .  .    .    .            .
.       .     .       .           .   .       .     . . .  .        .  .     . .     ....
.         ..    .     .        .                 .   ..    . . .     .   .              .
.                        .           .     .   .                ..                .     .
.          .      .             .        .               .   .     .          . .      ..
.          .                      .   .                .                ..         .   ..
..      .             .       .   . ..    .   .   .             .   .      .            .
.  .  .  . . .  . .  .        .      .  .          .          X ..        .      ..     .
.          ..    .   .    ..       .  .    .     .                      .    .          .
.      S          .       .  .             .  .            .      .       .  .     .    .
. .           .     ..        .                .        .      .             .     .    .
. . .      .          . .          .  .          .          .                  .        .
..          ..  .     . .  .       .             .   .                     .            .
.........................................................................................
