.....................................................................................................................................
.                  .          .                . .           . . .      .   .            . . .      .            .     . .          .
.      ..   . .    .        .          .     ...     .  .      .                                      .   .  .        . .          ..
.      ..   . X          .    . . .           .  .                 .       .                      .         .   ..      .          ..
.                      .                      ...                            ..                                                     .
. . .          .     .      .    .      .      .            .      .     .  .    ..            .          .    .   .           .    .
.        .                                               . .            .             .           .    .       .     .          .   .
.. .              .   .            .                .                  .     .         .        .  .    ..     ..       .   .    .  .
.        .  .  .                 .    .          ..  . .       . .           .  .    .  .                          .           . .  .
.    .                                            .             . .          .           .        .        .   . .     .            .
..       .. .            .      ..      . .    . .    .            ..            . .  .        ..    .    . .         . .     .     .
.   .            .              .        .        . .  .                 .        .. .  .   .       .      .    .        .          .
. .  .      . .   . . ..             .        .   .     .    .        .          .   ..     .   .. .                .    . .      . .
.     .  .               .     ..           .      .                         ..                       .  .   ..    .        .    .  .
.  .     .           .           .            . .          .                 .         .     .                   .  . .     .    . ..
.    .             .  .           .    .        .                   .         .  .                     .                 .      . ...
.                                  .  . . .              .   .           .      .     . .                  .  .             .       .
.       .     .  ..                  .      . .  .  .  .   .                   .   . .    .   .         .     .    ..               .
.          .      ..   .      .  ..    .                .   .                       .           ..                                  .
.              S    .  .        .         ...                      ..    .  .    . .                        .     .    .   .        .
.                  . .   . .   .   . .              ...         .  .          .   .  .  . .        .  .        .           ..    .  .
.              .  .    .                   ..   ..            .  .        .     .              .  .  .       .       .      .    . ..
. ..                 .    .    .   ..                 .  .        ..      .               . .       .     .             .     .  .  .
.            .       .   .       .  ..       .        .   .     .           .  .              .    .      .          .     .        .
.....................................................................................................................................
