..............................
.               .       .    .
.       .        ..          .
.      .   .     .    .   .  .
. .  .                       .
.  .       .     .          ..
.    .  .        .           .
. .          .           .   .
.       .    . . .        .  .
. . ..           .       . . .
.   .    .    .              .
.    . .    .          .     .
.    .    . .     .     . .  .
.    .   .  .              ...
.    .         .    .        .
..        . .   .   .S  .    .
. .        .      .     .    .
.  .       .   .     .       .
.       . .  .       .    . ..
. .     .    .   .         . .
.                 .        . .
.      .                   . .
.                 .X         .
.   .   .. .                 .
..          . .              .
. .                .   .     .
.  .            .           ..
..............................
