.............................................................................
.    .                   .        .       .                                 .
..     .                 S ..               . .   . .  .         .          .
.   .                 .      .           .     .          .           .   . .
.      . .                                  .               .            .  .
.                              .    .     . .   .      .                    .
..                      .   .            .                 ..        .      .
...    ..                   .  .                       .      ..     .      .
.          .   .                  .    .      .   .            .            .
.                         .  .       .  .           .      ..     .      .  .
.               . .  .  .      ..       .  .   .   .    . ..                .
.  .  .                       .  .                          . .  .  .  .    .
.  .                  .            .                       .    .        .  .
.             .    .        .  .    . .     .                   .   . .     .
.                     . .            ..  .         . .       .              .
.            .                              .  .      .                     .
.               . .     ..   .  .                                           .
.. .          ..              .                             .            .  .
.   .  .         .  .   .      ..            ..              . .   .     .  .
.  .     .  .        .        .                       .    .       .X       .
.  .  . .                 . .                . ..               .           .
.                       .    .  .      . .    .        .           . .      .
.                       .         ..     .        ..        .           .   .
.       . .      .    .      . .                         .       .  .       .
.    ..                           .                        .       .  .. .  .
..           . ..      .              .   .    .       ..  .  ..        ..  .
.                             .    .  .                       . .           .
.............................................................................
