....................................................
. .  ..        .. . . . .  . .     . ..    . ..    .
. .   .    .   .      .   .  .       .      .    . .
. .  .             .            .     . .    .   . .
.   .     ..  .       .               .  .         .
. .      .. . .      .  .   .  .  . . ..   .      ..
.           .   ..    .    .   .              .   ..
..           ..        .  . .     .  .     .     ...
. . .     .  .    .       . . . ..  .   .  .. .    .
. .           .            ..               ..  .  .
.   .    .  ..    . .        .        .      ..    .
.   ..        .   .         .               . S    .
.       . .  . .     .        .. ..     .       .  .
.   .       .       .                 .    .       .
. .     .      . . .   .  .     .       . .   .    .
.      .        .        .                .        .
.  .  . .   .. . .     .      . .  .     .   .    ..
.      .    ..          .. .   . ..  . .  .  .    ..
.  ..        .  ..     .          .  .      .  ..  .
.     .                       .X    .. .        ....
....       .  .   .          .  . ..     .     . . .
.  .    .       . .        . ..    .           . . .
.  . .  .   .  .     ..  .         . .     ...     .
.     ...              . .  .   .    .         . . .
....................................................
