........................................................
.                   .     ..       .         .         .
..         .      .                  .                 .
. . .                         .  . .                  ..
. .   .   . .   ..    .                         .      .
.      .      . .               .                      .
.         .                  . S  .  .        .        .
. .                            .   ... .   .           .
.             .   X                      .      ..     .
.               .    . ..      . .   .                 .
.                .       .     .   .  .                .
.   .        .   .      . .   . .        . ..     .    .
.               .       .   .                   .      .
.       .  .                 . .             .         .
.                      .                           .   .
.                  .   .       .     .    .  . .       .
.                   .            .    .        .      ..
.    .        ..  . .             . .        .         .
.                                                   .  .
..                              .                      .
.            . . .   .  .  .             .  .  .       .
.  ..   ..  .         .       . .    .                 .
.   .  .          .        .   .                       .
.               . .         .                  ..    . .
.  .                        .          .   .      .    .
.                             . .       .        .     .
........................................................
