...............................................................
.   .      .                 .  ..    .           ..    .     .
..   .  ..    .      . . .                      .          .  .
.   .        .     ..   ..  .   .                . .    . .  ..
.                . .                      .     .             .
..        .                          .  X          .          .
. .                    ..          . .         ..      .   .  .
.         ..      .                 .     .                 . .
.   . .    .    .      .   .                 .                .
.         ..        . .       .      . ..  .            .     .
.   ..             .  .            .   .  .             .     .
.  .       ..       .          .     .  .        .            .
. .           .                     .       .               . .
.          .S  .   .          .                   .           .
.                  .    .  .      .    .  .    .              .
.     ..                    .     ..    ..      .             .
..    .                .  .           .         .             .
.  .            .  .  .       .                     ..        .
.    .    .    . .         .          .      .       ..       .
...............................................................
