........................................................................................................
.  . .      .  . .    . .   . .       .   .     ..  .   .                 .  .               .         .
.         .       .    ..          . .   .      . .  .     ..          .   .      .  . .     .         .
. .         .       . . ...   ..       .   .     .              .         . .     . ..          .      .
..         .              . .                .     .       .          .       .   .  . .  .    . .    ..
.            ...   .   .    .    ..  .  ..                               .         ..    .  .   ..     .
.          .     .    . .  .    .              .. .   ..     . . ..       ..  .  .         .           .
.            .       . .   . .                  .            ..    .   . ..      . .     .             .
.    .    .   .     .        .     .           .          .     .   .      .       .                   .
.  .      .       .    .... .    . .    . .     .                 .           . .            .     . ...
.          .                     .. .    .        .  . .      ..   .            .        .       ..   ..
. .  X        .       . . .              . .. .     .                   .  ...       ..       . . .    .
.   .       . .                 .   .  .               .                  .              .         .   .
..             . .      .          ..        .                 S             .      .   .        .     .
.   .        .         .          .   .  .    .      .             .  .       .                        .
. .    .    .     ..  .      .  .  .. ..      ..  .            .     .                   .   .   .    ..
. .             .          .      .          .   .     .        .         .                  .  .      .
.     ..   .    ..        .   ..  .          .     ..      .              .    .        .              .
. . .       . .         .    .  . .              ...                      .        .             .    ..
..           .                 ..          .           . .   .       .    . .           ..       ..    .
........................................................................................................
