........................................................................................
.      .   .                        .          .           .  .          .             .
.          ..          .              .           .           .  .                 .   .
.   .               .     ......     .  .      ..    .        .           .       .    .
.  . .   .          .. . .  .. .      .     .     .       .  .   .    ..               .
.  .             .       .   .           .  .  .    .  . .        .                 .  .
.     .           .  ..  .      ..                         .   ..  .   .        .      .
.  .   . . .                   .         ..  . .      .    .             .            ..
.   .    ..                 . .     .  .     .       .                   ...           .
.  . .. S       .              .   .      .     .               .        .   .    .. . .
.       .   . . .  .    ..                      .       ..                    ..    .  .
..              . .     .                  .         .                   .        ...  .
. .         .  X   .   .  .     .      .    ..      .                  . .   .     .   .
.   . .     .    .              .                  .       .       .   .   . .  .     ..
.     .   .     ..    .                . .      .   .            .  .      ..         ..
........................................................................................
