................................................
.          S                          .    .   .
.                                  .   .       .
.                                .  .          .
.                     .                 .      .
. .    . .                         .           .
.              . .    .        .        .      .
.    .  .          .         .                 .
.                           .         .        .
. .. ..    .  . .          .       X           .
.   .         ...       .    .     .         . .
.                         .      .             .
. .     .         .                         .  .
...   .                                    .   .
.  .   . .                      . .            .
................................................
