..........................................................
.              ..       .     .                .         .
. ...             .     ..  .               .  . .  .   ..
.       .            ..      ..             . .          .
.    . .  .  . ..  .     .    .       .     .        ..  .
. .   .         .     .  .                      .     .  .
..      . .       . ..               .      .  .  .      .
.                .      .     .            .        .  . .
.     .    ..   .. .  .            .  .      .    .      .
. .      .   .  .  .       .    .                ..  .   .
. .        . .  ..     .    .    .                     . .
.    . .    ..    .           .    .               .   . .
.    .  .  .                     ..                  ..  .
.                   . .. .  .  .     .        ...        .
. .                     .     .  ..      .        .     ..
.     .               .  .  . .      .       .   ..      .
.    .   ..  .  .        .   .     . .       . S    .    .
.     .  .   .               .       .        ..         .
..                  .. .      .       .   .         .   ..
.                               .     .   .   .          .
.      . .         . .   .            .    . .         . .
...  .            .      .. .        .         .  . .  . .
. . .         .          .                  ...          .
.            .          X.  . ...    .      .       . .  .
.      ...                         .    .    . .       . .
...       .    .           .                        .    .
..........................................................
