.....................................................................................................
.        .         .   X .. .             ..  ..       .       .  .   .   .    .. . .      ..       .
.   .       .          .   .             .     ..      .     .            . . .   .    .         .. .
.             .      .                     .          . ..  . ..    . . ..   .   .       .    .   . .
.        .                 .   . .           . . . ..  ..   ..  . .    .. ..       .               ..
. ..      .   .  .              .  .     .     .        . ..                . . ...        . .   .  .
.      .  . . . .         .  . . .           ..                  .       ..                   . . ...
.          ..     .      .           .  ..    ..   ..             .  . .  .      .  .         ..    .
. .  ..        .        .  ..        .. . . .  .                      .. . .     ...   .        . . .
.   ..    . .. .  .   .  ...   .    . ..     .               . .            . . .   .  .  .    ..   .
. .     .          . .       .           .        .     .  . .             . .. .              .. . .
. ...    .  . .  . .    .  .                         .     ..   .   . .        .     . .    .       .
...   .   .       .  .       .. . .     ..                   .      .   .  .  . .      .      ... . .
..   .  ..        ..            .                 .   .  .   .     .           .           . .      .
.              .. . .    ..   .       S  .    .    .   .  .         .        .     .                .
.   .          .       .    .            . .  .  .  .   . .      .   ...  .  . .            .  .  . .
.     .  .  .. .     .   .         .   .    .      ..      .                ..  . .                 .
.          .      . .           ... .       .. .            .                         . .      .   ..
.           .     .  .  .               .    .     . .  .  . .     .     .                     .  ...
.....................................................................................................
