.........................................................................................................................................
.           S       .    .        ..   .           .       .           .   .         .       .                                    .    ..
.                  . .    .   .      .   .    . .       .             ..           ..       . .            .                 .          .
..     .     ..          .            . .   ..   ..              ...   .. ..   .   .               .   .          .          .        . .
.       . ..         .   .                             .                   .             .                 .    .     ..  .   . .       .
.                        . .           .        .                    .          ..       .      .       .        .                      .
.                         ..                             ..   .     .            ..          . .  .                                  .  .
..   . .   . .       . .    .          .  .   .        .   .                   .     .             .      .  .         ... .  .     .   .
.                    .   .           .       .          ..      . . X   .          .         .     .      .          .                  .
.  . .    .       .          .    .      .        . ..    .              .              .         .                 .        .  .  .    .
.........................................................................................................................................
