.....................................................
.   ..     .        ..           .  .         . .   .
.    . ....       ..  .  ..         .    .  .       .
.  .  .. .  ... .    .  .    .    .     .     . .   .
..      . .        .. ..        . . .       .. ..   .
. .      .      ..       .  . ...  .  ..  .      .  .
.    .        .   .   .        . .     .  ..  .     .
. ..X ..      .    . . .                  .   . .   .
. ..          . .. . . . .           .  .    .   .. .
.  ..        ..       .   ..    .     . ...        ..
.      .           .                                .
.      ..      .    .  .        .  .  .            ..
.. .  .  ..  .           ... . . .        .     ..  .
.      .        ...   . . . .. .           ..  . . ..
.  ...    .      .  .  .. .. .  .   ..       .      .
.     ...    . .  .            .    ..   . .. ..    .
. .    .           .              .     .   .       .
.     .. ..    .   .      ..      . ...      .... . .
.    . .     .    .      .   ...  .  .  .      .   ..
. .. .   . ..  .  ..   .       ..       .  ..   .   .
.      ..       .  .     .. .  . .       ..... .    .
. .   .     S   . .                    .  .  ...    .
..     ..  ..       .   .     ..        .. ..   . . .
.    . .   ...  .       .     . .                  ..
.....................................................
