.......................................................................................
.. .   .          .  ..    ..   . .. .  .                 ..   ..   ..     .    .     .
. .       .      .       .    .  .  .           .      .     .       ...              .
. .      . .   . .  .         .  .            . .         .       .   .    ..         .
. .    .     .   .       ..    . . ..           .            ...   . .  .  ..       . .
.     .     .S            .  .        ...    ..  .        ..            ..            .
.  ..         .    .         ..  ..      .  .  .  ..   .    . .  .      . .   ...    ..
..     .    .    .      .       . .            ...        ..  .. . . ...      .      ..
. .  ..    .     ..      .       ..           .                   .   . .   .       . .
.       .  ..          .  . ..   . . .          .    .  ..... .               . .. .. .
. .   .   ..               .        . ..         ..                 .         . . .   .
.   .        . .       . . .      .         .    .       ..      .       ..   .. . .  .
.               . .         .    ..    ..  .      . . .     .         ..  .  .. ..   ..
.            ...   .         .     .  .   .   .   ..          .             ..      . .
..  .             . . .. . .  ..          ..   .       ....        .              . . .
.  . .      .      .  . .  . .  ..   .  .     . .  ..  .   . .  .        .         .  .
..  .      . .     . .       . .            . .    ....    .            . .   .   .   .
.    ..    .     . .    .           .  .            ..     ...   ..       . .         .
.           .   .. .     .         .. ..      .              X   .    . .. .     ..   .
.    .  .  .     .   .      .  .         .        ..  ..        .      .       . .    .
.            .     .  .     .     .  .            .   ...   .         .  .            .
.  .         ..           .      .  .             .   .         ... .        .  .     .
.......................................................................................
