......................................................
.            .  .    .                   .          ..
.   .        .     .       .        .            .   .
.                .    .   . .                 .      .
..                  .    .   .. .     .          ..  .
.       . .        . .. .                       .    .
.  .     .   .                                 ..   ..
.        . .  ..         . .  .  .      . . .        .
.           . .   .. .                 .           . .
.       .   .      .          .    .   .        .    .
. .                         ...       .    .      .  .
. ..  .                 ..                    .      .
.   .   .        .   . .  .           .      .   . . .
.    .          .               X  .    .            .
..        .                     .                    .
.                                            .      ..
.       .  ..  .   .                 .              ..
.     . .      . .   .   .                        .  .
.        .    ..   .      .    .        .      .     .
.        S     .            .               .       ..
.  .                .   .   .                       ..
.         .        .              .   .              .
..                 .          .      .   .     .    ..
.              .     .           .  ..    .         ..
.   ..  .          ..       .          ..          . .
.     .     .     . . .    .           ..    .     . .
......................................................
