........................................................................................................
.                   .            .   .      ..             .  .         .     .              ..    . . .
.            .      .       ..       . .                       .     .. .      X           . .        ..
.  .                                  .     .               ..             ..        .        .     .  .
.    .                .  .                                    .             .                        . .
...                    .         .           . .. .  . . . .     .        ..      .            .   .   .
.       .         .  ..       .        .     .               .       ... ..                            .
.   ..        .   ..           .  .       . .  .   .             .     .                        ..  .  .
.         .        .  .   . ...      . . . .  ..  ..               .         . .    .     .          . .
.                 .          .  .      .   .         ..          .            .     ..  .    ..       ..
.        .             ..         .    ..   .  .  S                .       .   .                 .     .
.  .    . .   .  .     .          ..    .    .  .  .  .  .            .                      .     .  ..
..  .       .        . .      .    . .                                              .            ..    .
.        .                    ..      .   .    .                . . .         .       . . .   .  .    ..
. .             ..    ..      .               .      .        .   .     .           .    .  ..   .     .
..           .              .   .    .             ..    .   .         .   .  .    .  .                .
........................................................................................................
