............................................................
.    .             .      .             .  .               .
.              .. S  . .  .         .   .         .     .  .
.                             .. ..    .                  ..
.  .                         .  . .    .   .              ..
.    ..    .      .     . .        X   .       .      . .  .
.  .        .     .        .  .      .        .           ..
.             . .      .  . .     .    . . ..       .      .
.   ...   .  .  . ...     .  .  ...   .     . .     .     ..
............................................................
