...................................................................
.  . .       ..  .    .           .   .  ...           .   .      .
.    .        .   .         .         .          .                .
.    ..        .   .    .     .         .     .          .        .
.         .              ..     .         .          .      .     .
. ..          .       .  ..                      ..     .  .      .
.   .                    . .      . .     ..                   .  .
.       . .. .    .                     .      .        . .. .    .
.     .         ... .         .       .        .   .  . .      . ..
..       .   .  . .      .              .    .    .     .         .
.         .  .   .   .       .   X  .          .       .          .
. ..   . .         ..                                .         .  .
. .      .          ..       .    ..         .     . .   . ..     .
.    . ..  .   ..  .       .    .    .    . .S   .     ..      . ..
. .    .          .             .             .              .    .
.           . .  .   .      ..      .  .    .. .          ..      .
.   ..       . . .    .  .   .     .      . .                   . .
...................................................................
