......................................................................................
.       ..     .   .      .  .  .      .      .                .   . ..  .        .. .
.   . . .  .         . ....     ..         ..            ..          . ..   .    .  ..
.   . .     .     ...   .      ..       .   .     . ..   .. .   .  . . .   ...  .  . .
.  . . .  . .        ..   . ...   .    ....                  . .     .. ..   . .  .. .
... S   .. ..       .             ..  ..  .    ..   .  . . . ..  ..  . .. .    ..    .
. ...                  X     ...  ..     ..    .. . .    ..      .   . . ..    . .   .
.  . .         .     .        . ..      ..  .. .     .  .    .  .    .  .      . ... .
.       ..     . .      .                .    .   .. .        . .        .. . .   .  .
..  .          .   ...    . .    .      . .      . ..  .. . .    .      .     .. . ...
......................................................................................
