...........................................................................................
.   . .    ...      . .   .     .      .  .           . . . .   ..          .    ..       .
..     .               . ..       ..   .      .    .        .     ...   .   .... .  ..    .
.       ...           .    . ..   .             .. .               .  . .  .         ..   .
.       .   .  .      .    . ..     . .   .   .  . .  . .         ..   .    ..  .    ..   .
.  . .                  .  .  . . .  .  .            .  .      ....     ...  .     .   .  .
.   ...        ..   .    .      ..  ..             .      ..   . .    .. .          .     .
..         .      .           . .  .  .  .     .            ..    . .      .  .. .     .  .
..      .  .           .   .        .. .  .  . .. .   .. ..      ..      .         .      .
.     . .    . . .          . . .        . . .       .           .  .  .  .     .     .   .
.    . .. .    .    .. ..  ..    .  ..   .   . . .          .  ..   . .    . .. .  .     ..
.   ..   .    .  .  ..     .                   .    ..    .     .. . . X. ..       .     ..
.  .       .......        ...            .        .  .    . .  .. . ...            .      .
.  .             .  .. ... .                .    . .       . .          S .     .         .
. . .                     .   .       . .    .   . .     .... .            . .   ....    ..
.              .          ..    .  .      .              ..          .         .    . ... .
.         .  .. .              .    . . .. .                        .    .    .     .     .
..    . ..        . .   . .        .               . .   .. .    .      .        .. .     .
...........................................................................................
