...........................................................................................................................
..      .    .         ..    .   .       .          . .     ..            .      .   ..     .       .   ...   .  .  .    ..
.  .    . .   ..        .             .            ..        .      ..  ..     ..  .     ..          .     .              .
. ..            . .       ..   .  .   .    .                                           ..       .      . .       .      . .
.    ..      .                .   ..      .      . .   ..      .  .  .      .   . .            .     X          .     ... .
.   .  .           .       ...        .      ..       ..    .. .      . .       .                     ..   .       .      .
.           ..   .                  .  ..  . .    .                    .            .      . .   ..               . . .   .
. ..    .                         .      ..    . .     . . .    .      . .  ..       .        . .   .       .    .        .
. ...                          .    . .      . .      ..   .       .              .     ... .    .         .         ..   .
.    .   ..  .    .     .         .     . .   .     .    .  .   .     .   .           .          ..            .  ..   .  .
..          .        .    .  ..  .                     .         .   .  .       .           ..              .         .   .
.    .   ..   . ... ..         .   .       . ..         .  .    ..              ..         .               .              .
.               .        .     .     .       .                 . .      .       . . .                                     .
. .       .                   .     .    .  . .        .. .     .      .          S                       .  .   .   .    .
. . .     .  .   ...        .         . .         .. .   .                .      . .     .. ...  .      .           .     .
...........................................................................................................................
