...............................................................................................................
.      ...     .   .                        .                     ..    .       ..             ..           . .
.                         .      .   .         X    .        .               .                    .  .        .
.   .   .   .    . .                               ..               .       .   .        .                    .
.. .   .  .        .                           ..        ..     .                                             .
.                    .  S     .     .  .    ..                  .        .          . .      .      .         .
.             .           .                           ..                   .      .   .                      ..
. . .       ..         .           .        .  .             .    .     .          .      .                   .
.          ..                 . . .         .    .                  .                           .             .
...............................................................................................................
