............................................................
..  . ..    .      .      .   ..       .   .   . .  . . .  .
.  .    .      ...   .  .        .   ...    .     ..      ..
..    . ..          .  . .  .   .  ....               ...  .
.   ...   .   .  ..    .   .        .        ...           .
.     . .             .  .   .S       .        .     .     .
.   ..    .       ..        ..  .               .         ..
.       .. .   .  .. .    .           .   .  .     ..  .   .
...  ..            .   ... .       .   .     .      ..    ..
...  .   .. .  .         .  . . .         .     .  .       .
. . .     .   .        .     ..         .    . .  ..     . .
... ..      .      ..        .   ..     .X       .         .
.   .       . . . ..        .            .       .        ..
.  . .      . ... ..                 .. ..     .  .   .   ..
.. .  ..  . . .      ..  . . .      ..        .   .     .  .
. .. .             .    .        .   .    .  ..    . .     .
.          ....  .   . .  .     ..     .             .     .
............................................................
