.................................................................................................................................
..     ..                 .       . .                                                .   . .                   ..        .      .
. .     ..          .       .            .       X       ..   .           .    . .   .                .   .          .      .   .
.                ..    .    .   ..        .            .          .    .         .      .    .                 .  .     .       .
.       .    .     . .    . .   .       .  ...  .  .     .   . ..    .                   .       .  .       .       .           .
.   ..              ..     .      .   .                        .  .  ..  . . .         .    .         .                 .      ..
.      . .        .      .  .       .      .               ..          .    .          .         . .     ..               .  .  .
.     ..     . .                                 .. .       .    .                                       .                  .   .
.           .  .         .     .      .                           ..         .     .   .. .  . ..  .         .             .    .
.                     .                . .              . ..  .  .         ..   .   .                         .     .        .. .
.     . .        .                 .        .          .. .              .  .  .                      . .   .                   .
..           ..      .    .    .   .   .     .                   .   . .       ..       .           .       .  .     .    .     .
.        .           . .     . .    .      .   . .       .                       .     .   ..  .                     .  ..  .   .
..               .  .. .     .     .                   . .  . .                .      .     . .        S   .  .         .       .
.  . .  .         .  .          .. . .                .         .   .   .                       .  .         . . . .        .   .
.................................................................................................................................
