...........................................................................................................................
.   .. .      .      .    .        X     .  .     .       .       .  .   . .                . .   .   .        .      .   .
.             .           .       .   .      ...    .        .             .       .        .     .    ..  ..      .      .
.                   . .  ..    .  .       .      . .       .   .              . .     .        .     .   .  .   .    .    .
.   . ..   .                ..        .       . .  .          .  .  .  .         .                ..         .  .         .
.                      .           S   .    ..  ..                 .    .       .     .                . .      . ..      .
.                   ..              ..  .  .          .    .      .     .       .                 ..                .     .
.  ...          .     .   .         .    .      .  .     .      .       .  .              ..         .      .             .
..         ...   .        .       .               .           . .  .           .       ..    .    .                      ..
.  .       .     .  .     .. .             .                           .    .      .     .  ..                    .       .
.      .      . .    .    .             .    . .  .  .           .      .        .           ..         .             . . .
. .      .         .        .   .          .     .      .  .           .                 .       ..      .                .
...........................................................................................................................
