................................................................................................................................
.    .         .     .  .    .  .        . .       .   .      .   ...  .        .   .     .    .       .   .  .      .  . .    .
..            .         .  . .     ...  .    .     .    .    . . ..            .         .          .        .          . .    .
.       . .     . . .   .        .        ..     . .    .. .   .   .     ...                .      .     .           . ...    ..
..      . .    .    .     ..     ..  .. . . .  .      ... .    .     .       .     .    . .   . ..          .   . .  . .       .
. .            .  ....        ...          ..  ... .             . .     ..     . .             .. S.      ..                  .
..  ..  .    .   .   . . ..   .  .              ..       .      .    .       ..     .    .   .    ... ..   . .    .    .     . .
..   ..   ..     .            .    .  . .  .       ..  ..             .   . .   .      . . .   .      .    . . .   .    .   .  .
. .  .  ..    .  .          .   ....    . .  .  . .   .. .      .            ..   .  .   .       .        . . .  .   .        ..
.           .  .     .    .. .      .   .... .             .        .           .  . . . .  . .... ..  .      ..  .      .   . .
.  .    .  .   .    .    ...    .  .            .          .     .    .             .         .   .      . .    ..     .  .    .
. ...       . . .        ..              .  .    .  .    .   .          ..          .            ..    ..            ..      ...
. .           .. .               ..          ..   . .           .    .                   ...   ... .  . . . .           .      .
.       ..   . .     .       ..  .  .     .  .     . ... .     .    . . . ...  .  .  . .   ... ...       .      .   .         ..
.. . .   .    .     .  ..  . . ..     .     .   ..          .  .   .    .     .         ..   .. .. X..      .         .  ..   ..
..     ..               .  ..   . .     . .   .              .    . .  .         ..                    .  .          .      . ..
................................................................................................................................
