.....................................................................................................................................................
.  .       .           . ..        .   .       .         . .       .        ..      . .    . . .     .   .   .           .    .     .. . .  . .   . .
.  ..  .  .               . .  . . .      . .    .     .         . .   ..    ..   .  .          .. .  .  .   .   . ..  .      ..      . .   .    . ..
. .    ...        .. . .    .       . .      .  .  ..       .  .          . .     ..  S  . .   .         .   . .    . ...  .    .  .  .  ..    .  . .
. .    .    .. .      . .. .  .   . ..        .  .     .    . .       ..  . .    .      .  .. .  ..  . .      ....  .     .    ..    .     .        .
.    .               . .       .   ..        . . .  .          . . . . .. .  ..   .     .. .     .    . .   . .    .  .  .    .  .  .     .. .      .
. ..        .. .  ..     .       . .   ... .  .  ..    .   .   ..  ..       .   .   .    .  ..   ..        .   .. .   .     .    .   .     .  .     .
....  ..    .   . ..      .        . ....    . .     .  .      .   .  .       ...   .          .       .  .   .  .  .  ..        . . .    .     ... .
.   . .      . ..  .      . .        ..    . .  .   ..    .    ..     . .   . ..    .  ..    .. ... . .       . .    ...    .   ... .   . . .   .  ..
.. . .  .    .       . ..   ....          ..            . .      .       . .    .   .     .   .. .  .     .   .           .  . .            .       .
.. .    ... ..  .   ...  .     .  ..      .   .    .. . .                 ..   . .       ..  .  .          ..   .    ....   X    ..        .    . ...
.. ..  .       ..         .. .   .       .. .    .  .   ...   .   ...   .       ..      .  .     .... .              . .  . .. .    . .        . .  .
.  ..   .   .   .    .   .       .       .  .  . ..      . .          . . .      .    . . . .         .. ..     .   .     ..     .  .   .   ..     ..
.              .     .      . .      ..  ... .           . .  .. .  ..  .      .    .  .   .  . .   .. . .      ..     . . .  .            .   ..   .
..       ..    .  ....                . .  . ..               .    .     ...  .    ..    ..  .   .. .      .  . . .. .   .        . .   .          ..
. .    . .   .   .   .      . .       ...       .  .  .   ...       .      .   .              ..    .  .      .  .. .      .             ..   .  .  .
.....................................................................................................................................................
