...................................................................................
.     .       . .                  .   .     .        .       ..    .  ..     . ...
. .  .    ..     .            .     .     ..  ..   .   .                  . .  . ..
.  .  ..   .       ..   .    ..  .  .   .       .     .    ..      .              .
.  .. .   .      ..   .....    .       .       .   . .     . ..      . .     .   ..
....  .      .    .  ..   ..       ..    .. .      .  .     .    . .... ..      . .
.               .. .  .         .    .  .     .  .   ..  . .   .  ..   .  . . .  ..
. .       .      ..  . .        ..  .   .       . .  .   .     .  ..    .   .  . ..
. . .               .   . .  . . .   .. .         .         .  .   . .  . .       .
..  .  .. .     .    .    .      .         .    . .    . .    .  .    ..      . . .
.    .   .     . .              . .  .   ..  ..   .           .        ... .  .   .
..      .   . ..      .           .. .   .     ...   ..      . . .                .
....  .        ....    . . .   .         .           .   ..   ...       .    .    .
..        .        ...  . ..  .   .        . . .         .  .  ..   .  . ..    .. .
.    .            .      .   . .        .  .         . ..        ..     .  S .    .
.  .  ..           . ... .    .          .. .  .     ..  .  .      .  ..    . .   .
.  ..    ..      .     .            .  ..        .  .     .       .. ..  .  .    ..
..   .       X.. .  . .. .. .           ..    .    . .       .. .  .  .   .  ..   .
.        . . ..       .  .   ..   . . .  .   . .  . ..  .      .. .    .        ...
...    ..    .  ..   .    .            ..  .      .. . ..   .  .      . .       . .
.  .         .  .     .         .                .     .    .  .          .    .  .
.  .   .       .  .         .   .  .   .   .. ..        . .    .     .     .      .
...................................................................................
