.....................................
.   X  .    S.  .      .    .    ....
.  .  .  .. .    .  ...         ..  .
.            .     .             .  .
.     .     ..  .  .    . .     .   .
..     .         .       .   .    . .
.   .         .     .       ..   .. .
.    . .      .    ..       .     . .
.          . .       .   .   ..     .
.     .   ...   .       .   .    .  .
..  .      .    .. .             . ..
. .        . .            . ...     .
. .     ..       . .    . ..  ..   ..
.....................................
