..............................................................................................
.   .   .    .   .       .. ..  .      .    ...           . ..    . .    .  . .            . .
.    .            .  ....                  .     .   .   .     . .  .         .    .   .     .
.          .            . . .               .     .        .. . .  .  .        .  .    .     .
. .            ... .      .  .       X . . .     .   .                ..     ..        . .   .
. .      . .            .  .         .   ..        .  .        .          .       .     . . ..
...    .                     .      ...    ..  . .          ...  .             .  .  ..      .
. .   .  .  .    .         . . .         .         .. . .      .  .    .   .   .    .  . .   .
.    .      . .  . .       .                . .       .      .    .     .  .           .     .
..        .    .             .   .   .    .            .       . .       . .     ...       . .
.  . .                 . .  ..     .   . .           .        .  .       ..        .   .    ..
.. .     . ....  .       .    . . .  ..     .       . .      ..          . . .               .
.    .   .       . .      .    .     .  .     .            .          .     .         ..     .
.  .. .    .       . .     .  . .        .             .    .   S        . .        .  .  .  .
..     .  .   .  .  .   .                     .      .       .   .   .       .          .  . .
. .   . ..         . .                    .        ..    .              .  .  .. ..          .
.           ..            ...     . .  .       .           .    . ..  .. .     .  .  .  .  . .
.       .        .    .  . . .      ..        .         .   ..      .  .  .       .  . .     .
..............................................................................................
