.....................................................................
.   .   .           . ....   . .             .  .        .          .
.     . . .            . .  . .         .     ..   .  .  . .   .    .
..    .                 ..          .    .    .   . .               .
.. .     .    . .   .                    .        ..         .  .   .
.        .   .     .     .    . .      .       .     .        ..    .
.   ..         . . .   .    . .      .. .              .       .   ..
.  .    .      ... .         .. ..         ..   .   . ..  . .       .
. ..     .               .         .  ..       .       .  .   ..  . .
..       .          .      .   . .              .  .       .. .   . .
..     ..   .         .      .    .    ...       ..    .         .. .
. .               .            .      .   ..   . . ..               .
.    . ..    ..  ..     .      . .     .           .           . S ..
..         ..         ...    .          . .  . .                .   .
.     .    . . .  ..   .     .   .                    .  .       .  .
.. .       .            .    ..  .       .   .   .  .... .    .     .
..     . .    X..           . .                .    .  . ..   .     .
. .    .  .        . .      .      .   .        .             .   . .
.  . .  .  .        .      . ..           .      .  ..    .         .
. ..     .          . .    . .       .  . .  .   ..      ..         .
.      .       . ..  .  .        .   .    .  .   . .                .
.  ..     . .         .        .   .  .       .        .      ..   ..
.     ..      .        .   .          .  .  .     .   . .    .. .   .
.     . .        .   ...   .     .       .       .. .    ..    .  . .
.              .             ...  .. .       .                      .
.....................................................................
