..................................................................
.     . .  .       .    ..        ..                        .    .
.       ..            .          S  .   .  .    .. .     .       .
. .       .     .  .       .  . . .      . .         .           .
.   .    X          . .             ..          .  . .  .. ..    .
..    . . ..  .   .   .    .       .  .            . .           .
.        .    .    .   .          .. .     .    . .        .   ...
.   .. . ...                 .  .. ..   .   .  .  .      . ..   ..
...       .            .   .                   ..    .          ..
.       .   .        .         .            .. .        .  ..  . .
. .       .         . .       ..    ..         .   .        .    .
.  .  .          .   .  ..        .. .  .    . ..      . .       .
.  .          .     .  .  .   . . ... .       ..          .  .   .
.     .   ..           . ...  .   .  .         .    . .          .
.         .        .   . .          .      ..      .   .      .  .
.       . .    .    .     .     . .                   . . .  . ...
.     ....      .     . .     . .  .  .     .      .   .         .
. .   ..      .        .. ..            ..    .      ..    . .   .
.               ..  . .   .        .       ....   .. ..     .   ..
.     ..  .  .  ..   .        .  ...  ..      ..     .  . . .    .
. .. .                    . .       .        .  .   ..          ..
.  . .  .     . .   .   .  .    .      . .   .   ..         . .  .
.      . .   ..      ... ..     .             . .     .          .
..             . .           ...   . .    .  .              . .. .
. . . .     .    .          . .                  .       .       .
.      .          . .   .             .                 .    . . .
...  .   .        .            ....    .          .      .  .. . .
.  .   . .           .       .                    . .  .       . .
..................................................................
