..........................................
.                   .  .   ..            .
.   . . ..            .             .   ..
. .  . ..   .   ..          .    .      ..
.    .    ..     .S  .       .   . .     .
.         .   .    X . .    .            .
.         ..      .      .        .. .   .
.                .          .      . .   .
.     ..  .. .        .            ..   ..
.  .            .    . .     .   .      ..
. .        .               .  .   .  ..  .
.   .      ..   .   .       .   .      . .
.    .      ..  .         ..             .
..  .. .     .    ..  .  .  .    .       .
. .   .           . .                    .
..........................................
