.......................................................................................................
.            . ..     .  . .  .          ..         .         .   ..       .    .   .   .    ..      ..
.       .      .       .. .     .   ..           .        .   .   . .        .                        .
...           .    .     .. .   .   .  .            .    .   .        .         .          .   ..     .
.            .  ...         .      .    . .      .              .  .       . .    .    .  .  .        .
.  ..              . . .      .                      ..       .  . . .         .    ..      .      .  .
.       .   .         .      .                               .      .     S.       .  . .         . . .
.        . .             .              .              .        .      .      . .   .          .  . . .
.      .            .                  .                 .    .     .  .                        .     .
.           . ..           .        .    .    .   .. .   .       .  .             .                .. .
.                                               ..        .     .                   .  .              .
.          ..         .  .             .      .        .                           .      .   .       .
.      . .     .     .               .  .     .             .    .   .        . ..                    .
.. ..        .      .    .   .        ..           .     .     .  .   .           .       .          ..
.  .  .           ..            .            .      .    .  .       .  .       .                      .
..                 .    .    .     .                       .X.               ..       .     ..  .     .
.    .      .            .   .         ..     .  .               ...     ...            .         .  ..
.......................................................................................................
