................................................................................................................................
. . ..  .                        ...               .     .  . .. .    ..          . .  .  .   . ...   .   .      ..      .   . .
.   .           . .  . .       .  .  .          ..   .. . . .    .  .. .     ..   ...  .  . .     ...        .  .  .  . .. .   .
..               .      . . .         ...    . .  .    . .  . ..    .  .   .    . .     .      .  .    .   ..     .  .   . .   .
.      .            . .   .         .                .. ..             .   ..  .         . .  . .     .  .   ..    .    ...    .
.   .  .   . .       ...       .  .     .  . ..    .   .  ..  .    .        . .     ..   ..    . .        ..  .      .    ..  ..
.         .            .        .     .   ..  .      .  ...         ...        .      .       .     .             .     .  .  ..
. .               . .  ..  . .   ...  .         .  .   .    .       .    ....              .   .         ...        .        . .
.   .. .     . .      .  .  .   .  .  .   .    .         . .  ...  .  .     .     . .  .     .  .  . .    .      .       .    ..
.    .....            .              . .  ...     .    .      .  .    ..  .               .   ..                  .   .  .     .
. ...    .  . . .  . ..  .     ......  ..  .    ...  . .         .    ...  .      .   .      ..      .  .    . . ..            .
.     .      .  ..        .             .                       .             .   .  .    ..  .   .       ..      .   .. .     .
.  .   .                 . .    .   .         .         ..   .   .  . . .           .     . .     . ...            . .     .   .
.. . .   . . .            .         .      .      .   .   . .   ..        .   ..    .      ..                    .     . .     .
.         .     ...          . .  ..  .      .  .  .         .   .  ..       . . . .   . .   ...   .   .  . .  .     .  .      .
. .   .  .    . .   .  .    .     .   . .    .     . .            .   .  ..    .    .  .     . .      .   .        .         . .
.      . .                .  .. . .          .        .      .    ..    .     .          . .   .  ..   .   .    . .  .        ..
.  .    .      X     .   . ..       ..            ..   .         .  .  .        .  .         .  .        ..      .   ..        .
.. ..  . .               .   .            .      .  . .  ...    . .   . . . .                   .               .        ....  .
. .  .      .  .      . .  ..  ..        ...   .. . . .  .  .      . .     ...   .          . .          .     . S. ...   . .  .
.           .... .     .... .   ..        ...        ...     .  .. .    . ..  .       .   . .       .         .         .  .   .
.     .     .    .         ..        ..    .  .  ..   .     .    .          .   .  ..   ..  .   .     .             .....   .. .
.   . .             . ..            .   .  .       .      . .   . ..           .    .       .              ..  .     . ..     ..
.     .  .     .       .       .  .  ..    . .          .. .. .  .. .   .. .   ..        .  .. .      .       . .  .           .
. .   ..  . .   .  . ..        .. .   . . .         .       ..     .             .  .    ..    .    .  . . .  .     ..     . . .
..  . .         . ..          .      .    .. .        .      .   . .    .  .. .        .       .           .    ..       .  . ..
.   . .  ..   .  .       .          .          ... ..    ..     .      . .    . .        .    . .     .  .   .  .  .. . . . .  .
..            . .               .     .      .  .     .      .     .      .       ..    . .      .    ..  .       ..     .     .
. .. .. .            . ..  . .  .      .   .. . .    .    ..     .  .       ..  .  .        .    .  . .   .  .                 .
................................................................................................................................
