....................................................................................
.  ...      . .       .  .                .       .      .      .  .  .    . ..   ..
.   .  ..        . .   .   .                .   ..   . . .  . .   . .      . . .   .
. ...      .      .. . ..    .  .          .  .   ..            .  .     ...    ....
.     ...   ..      . .      . ..          .   .      .     .    .   .    .  ..  ...
. ...  ..        .      . . .     ... ...    . . . .    .     . .   .              .
.   .    .. .. ..   .    .   ...    .. .  . ..         .  ...      ...    .        .
..  . ..   ..  ..    .      .    ..   .  .      . .   . .  .              .     .  .
. ..S . .    .    .  .      . .          .       .    .  .      ..    .    .      ..
.    X . .   . . .   .   . .    .    ...     .      ..  .  . .     .  . .    ..    .
..    ..   .    .  .  . ...      .  ..  ..     . . ..        .   . .. . . .     .  .
.    . .         ..  ..  .   .   .  .           . .   .   .. .. .      .. .   .   ..
..  ...    . .... . .  . .  . ..            ..      . .          .        .      ...
. ..     ..    .. ... .. ..  ..  .  ..  .    ..        .  .        .       . .. .  .
.  . . . . ...  .          .. .   . .. .   . ... .      .     .  ..  ..  .      .. .
.. .            ...    .  .       .   . .   .   .    ..    .   . . ..   . ..   .   .
.     .. . ...      . .    .  ..   . .  . .   .  .   .... . .  .   ...    ..  . .  .
....................................................................................
