...........................................................
.  . ...     ...  .              .   .          . . .    ..
.   . .     .    .  .   ..     .     .     ..       ..    .
...     ..                  . .       .     ...        .  .
..   .   ..    .   ..    .      .      ...  .   . . . S.  .
. .  .   ..     .   .  . .   .  . . .. ...   .    .. .    .
. . .   . .         X. . .. . .    . .  . . .  ..      .  .
.           . .  ...    ..           . .          .   .   .
.   . .      .    . .   .   . .  .   .          .         .
.   . .     .           .      .          . .  .  .  .    .
.           . .  . ..   . ...     .. ...   . .  .   .  .  .
..    .    .       .  .  .      .    .      .            ..
.    . .    . .   ..         . .  .         .  ...        .
.. .   .  .   .      ..       ..   .      .       .  . .  .
...........................................................
