............................................................................................
.      S    .               .        .. .          .   .    . ..    ...   .     .       .. .
.      .                     .               . .  .    . .. .    .     .       .  . .     ..
.    ...               .  .         .  .  .     .    .          .   .         .            .
. .  . .     .   ..        .   .          .   ..         . . .    .  . .. .    .      ..   .
.          . ...  ...  .   ...  .  . .  ..  . .   .             .     ..           .       .
. ..       .     .    .  .       .    .     .  .             .     ..    .  .  ...   .     .
.   .   . ..    ..  .. .    .     .    .            .         .     .  .     .        .    .
.         .   .           .                 .        ..  .             .   .        .    . .
.  ...   ... .     .  .    .      . . ..                .   .       .    .                ..
.   .     .     ..        ..     .        .      .  .   . .   .       .  .              .. .
.           .    .    .        .         . . X.. .   .   .    .  .        .     .     .    .
. .   .          .   .   . .  .       .     ..     ....      .    .           . . .  .   . .
............................................................................................
