.........................................................................................................
.   ... ..    .        .      . ...            . .  .  .     .         .     ..        ..  .     .      .
.     . . .. .    .      ..  . .  ..  .    .   . ...     . .         .       ... .. .          .    .   .
.. . .        ... ..       .             . . .      . .   .. ...     .          .. . .   . ..   .   .  ..
. ..    ..  . .  . .             . .    ..     .   .  .      .   .. .      .      .   .    .       .    .
.    .   . . .  .         . .  .  .      .   .   ... ...  .          ...   . .  . .      .  .     . S   .
. . .   .  .       .. . .    .     ..      .                   .       ..  .   ..      . . .  .. .     ..
....        .              ..            .    . . .         .              .  .      .    .         .   .
.        .. .    ..       .    .        .            ..  .     . . ..   .  . . .  .    . .      .  .    .
.            . . ..   .    .   ...  . . . ..       .      .  .     ...X .  .     ..       ..  .       . .
.  .  ....     . ..             .         ...  .  . .                 . .        .   .  .        . .   ..
. .  .          .             . .     ....   .       .          .    .         ..    .      . ..        .
.........................................................................................................
