...............................................................
.    .. .    .   . .       .                  .   .   .   .  ..
.  .      .    ... ....... .    .        .. ..       .   ..   .
..    .  .          ....   .      ..   .  ..  .   .  .  ..    .
...  .    . ..... .  . .   .    ..              .    . . ..   .
..  .  .    .    .. .   .  .. .    .      .     .   . ..      .
.  ..  ..     ..    .. ..   .. ...    .          . .  .    .. .
.        .  . .       .  .    .   . ..  .      .  ..    .     .
.. .  .   .  .      ... . . . ..  S.      . ..   .. .   .... ..
.  .    ...         .  .   . .        .     .         .     . .
.  . .    . .          ..        .    .  .         . .        .
.  . .       . .  .      ..  .   ..        .             .    .
. . .  .           .    .    .  . .   .      .    . . .   ..  .
.     .    .    ..    .   .   .. .       .   ..  .  .. .  .   .
. .. .   .  . .X..   .        ..       . .  .  .. .        .. .
.     .   ..            .  .. .     ....       .       .      .
.  . ...     .       .   ..     ..          .   . .  ..   ..  .
.. ... .. .   .. .   . . .      ....  .      .           .  . .
.      .  .      ..    .        .            . .. . ..  .  .  .
.  ....   . .. . .. ..   .  .     .  .           .       .    .
.  .  . .                .       .         .. .        ...  . .
.        .     . . . .  .       ..         .  .  . .   .  .. ..
..     .    .   ..   .            .   .        . . ..  .  .   .
. .  .         ..   .    ..  .  . .               . .   . .   .
.  .     .            .  . ..   .  .         .    .           .
.  . .   .   .  .  .                       .  .  . . . . ..   .
...............................................................
