.........................................................................................................................
.      .  .          .     .               .         . . .      .   .                     .  . .  ..    .     .      .  .
.         .        . .                 .    .   .  .                .....          ..               .      .     .      .
.          .  .                                    . . .      .     .           .                   .   .       .       .
.     ..                .  . ..  .               ..   .        .   . .               .      .       .        .          .
.         X                 .             . .               .                         .       ..     .                  .
..        ..   .   .      .                                    .              .   .        .  .   .      .              .
.        .              .           .    . .         .  ..                       .   .    .             .               .
.   .         .   .  ..  . .  ..    .     .                       .    .       .. . .     ..                .           .
.                 .                  . . .  .   .        .         .               .       . .                     ..   .
.         . .      .                  .   . .  .. .  .    .   . .   .                  .        .        ..     .       .
.       ..   .          .                . .   .                 .        . .         .      .                        . .
..     .  .                  .         ..  .   .        .     .  .         .                  .   .         . . .     . .
.               .     .      . . .   . .    .                        .    .      .  .   .               . .  .  . .     .
.                  .        ...     .                      . ..     .  .       ..             . .        .              .
.      .     .      .      .       .  .  .             .         .    .           .             .   .     .             .
.      . .                  .   .     . .     .  .    .          .  . S    .                   .        .. ..    .  .   .
..               .     .        ..   ..         .                 .                         .               .          ..
.    .   ...       . .    .                        .        .    . .    . .                             .      .        .
.              .   .         .       .         .   ..  .             .                          .        .        .     .
.        .   .           .  .                  .                  . .    .        .        .     . ..  .         .      .
.........................................................................................................................
