..................................................................
.                .         .  .       .   .        .      .      .
. . .      .       .  .        .   .         . .          . .    .
. .       S    .      . .           .       .         .          .
..      .              .  .        .            ..    .          .
.  .  .     ...  . .      .  X .   .             .  .            .
.  .                                     .                .      .
. .   ..     . .     ..              .. .  .  . . .  .    .      .
.. ..              .         .     ..         .     .     .   .. .
..................................................................
