........................................................................................................
. .           .     ....    . .   . .   .      .                .         .. .              ..    . .  .
..     ..        . ..  ....  .. .  .    .  . .   .   .. ..              . . .      .   .    ..  .  ..  .
.       ... . .  .         ...       .    .  .     .        ...  ...  .  .    . .              ..... ...
.     ... ...         .   .   ....   .  ..    .  .   .  . .        .     . ..    .              ...  . .
. .    . .       ..       . .  .            .   . .          .. . . .    ..   ...         . ..  .   .  .
..   .    .   .             .                . ...  . .     .    .  .         . ..   .  ....    ... .  .
.  .    .    ...     . . .    .       .    . ... .  .   ..   . ..   ..          .  ..   .   .  . .    ..
. . .   .   ..        ...  .   .    .   .  .. .     .            ..   .                .               .
.. .... .     .. . .   ..  ..              .      . ..        .  . . .  .  .. .. . . .      .          .
.     .  . .  . .     X     .  ..     .    .. ...              . ...     ...         .  .. .      .    .
.    .     ..... .  .             ...    .   .   . .      . .    .   .     . . .... .  .   . .  . . .  .
.  . .   .           ..  .. .  .             .         . .        .     .   .   .   .  ..        . . ...
.                           . .    .                  .  .    ..  .             ..            .       ..
.  ..  .  . .   .   .            .   .  .  .. . .    .S.     ..      .       .  . ..  ..             . .
.   .     .      . .   .      .    ...         .. .  .  . . . ..   .       .  .   . .     .  .        ..
..  .         ..  .         . .       ...  .           . .  . .. .   .. ..                .    .    .  .
.    .       .  ..  ..      ...     .    .    . ..       ..     ... . .    .. .             .  .      ..
.     . .. . ..   .. . .       .       . ..    .   ..     .                    .      . .      ...     .
..      ...  ..   .    .   .  .           .. .  .  .  .                   .                ... .     ...
.. . .            .. .  .  .   .. . . .     ...   .        . ..    .     .   .     .  .  .    . .      .
.  .   .  .. .    .    . .   .                    .   ..  ..      .  .    . . . .  ..    .  . .     .  .
.      .      .   .      .       . .     . .   .     ..      .     .     ..   .  ..  ..     .  .  .  . .
.  .    . . . ..     ....  . .   .. ..   . . .   .      . .  .   .    .      ..... ..        ..        .
........................................................................................................
