......................................
. ..  .  .     ..  .         ..  ..  .
.    .        .  .               .   .
. .     . .     .. ..          .   . .
.  .  ..        .  ..   . ..       . .
.          .. .       .    .. .      .
.     .              . .     .       .
.     .   .     . .    .  .   .  .   .
.  .. .     .  .    . ..    . .      .
.     .        . . . .    .          .
.            .. .   ..  .   . ..   . .
.     X..      ..  .  ..     .    .  .
.         . .     ...        .       .
.      S      .. .     . .      ..   .
...      ..       .    . ..  ....  . .
... .                      .  .    . .
.    ... .           .    .         ..
.   .      .         .        .     ..
......................................
