...........................................................................................................................................
.             ... .         .   .        .         ..  .            .    .   . . .. . ..        .. .           .   .   .        .      .  .
. .    .         .   ..   .  .   .  .       .      .    . .                                   .. .  .            .                     .  .
.                   .   . .   .    .       .     . .            .       .         ..     .  . ...   .      ..        .      .    .   .   ..
.      .  .    .     .     .     .      ..       ..         ..                  .        ..  .                  .       .        ..       .
. .   .  ....  .    .              .       . .    .       .    .           ..       .   ..  .      .        .     . .     . .   .. .  .   .
. .    .                   . .    .             .  .  ..                        .      .. . .          .   .    .  .   .   ..     .       .
.         ..                    .   .        .  ...       ..                       ..     . .    .              . . ..    ..     .        .
.        .      .            .       ..          .  .                           .         . .            ..           . .  .            . .
.  .                  .     .   . .   .   .   .      .    .                                               .       .   .       .    .      .
. ..  .     .            .             .        .          .   .         S       .      .      ..    ..                      .            .
.   .   ..  .      .                .        .     .             ..           .         .  .         .   ...    .. .           .          .
.                       .          .        .     .       .      ..    .   ...             .          ..  .  .             .             ..
.        ....                   .                      .    .     .   . .   ... .                .        .                               .
. .       .        .                  .    .         .    .       . .          .       .    ..    ..     .         .      .               .
.   .               .       .       .                         ...  . ..    . .      .          .   .     .       . .   . .   .            .
.                     ... ..     .. . .   .. . .   .        ..  . . . .         .  .           .   .                       .    .     .   .
. .   .    . ..   .                  .   .       .              . .      ...        .                   . .  .  .. .         .  ..    .   .
...          . .                    .        ..         . . .           ..    .              .       .    .        ..     .   .  .     .. .
..  . ..          . ..        ..   . ..    X          .    .  .  ..     .          .. .  . .      .  ..        ..   ..  .  .        ..    .
.        .   ...    ..   ..    .    . ..       .        .     .  .      .       .    .       . .      . ...  .  .    .                   ..
...........................................................................................................................................
