.....................................................................
.      ..     .   .       .        .       .   ..            .     ..
.    .    . .                  .       .          .       . .      ..
.         .  .            .  .            .   .     .  ..    . ..   .
.    .                        .                . .          .   .   .
. .                                  .     .        .       .       .
.      .            .  .       .     .      .   .      .            .
.  .    .         ..   .. .   .  .. .            .  .   .       .   .
.   .   .     .                .             .  .  .          . .  ..
.     . ..       S.   .         ..           .           .       .  .
.   ..                 .     .... .  .    .       .  .      .     . .
. .     .. ..  . .  .           .    .  .    .  .      .       . .  .
.             .    .  ..                  .   .             .      ..
.   .. ..                              .  .  .. .          .        .
.  .        .  .    . . ..     .       . ..       .                 .
. .     .    .     ..     .       .        .  .       .      .     ..
.        . .     .   ..    .    .     .  . . . .   .      .       . .
.       .    ..     .             .  ..      .      ...      .      .
. .    .   .             .. ..            ...                 .   . .
.     ..      .. .              ..        ..      .  .  .  .        .
. .  . .         ..   .        .. .      .   .         .     .    . .
.  .    .       .                     .. .                     .    .
.  .   . .        ..  .   . . .    . .         .           . . . .X .
. .           .   .      .             ..         . .    . .  .     .
.....................................................................
