..................................................................................................................................
.     .       .   ..   . .         .  .         X            .    . . .    ..  .   . .               .  .      . .     ..       ..
.   .       .                       S         .             .           .            .     .   .  ..   .     .         . .  .   ..
. .            ..      . ..     .                          ..     ..            .     ..       .. . .                 ..         .
.  . .    .         .                    . . ..   .     .     .        ..     . . .       .   .              ..             .    .
. ..  . .      ....     . .                .                  .       .     ... ...                                         .  . .
.        .   .  ..   .   .       .           .           .         .   . .      ..        ...       . .          .    .    . .  ..
.      .    .        .      .       .   .    . .         . . .  .         . . ..  .     ..           .     ..                .  ..
. . .                 .          .    .         . .                .     .        . .  ..  .      ...  .      . .    .    .      .
..................................................................................................................................
