......................................
. .           . . .                  .
.     .   . ..         . .  .       ..
.  . . .         .    .          . . .
. .       X ..          ...  .  .    .
.  S   . ...       ..  ...           .
.      .      .    .        .      . .
.          .      ..... ..           .
.           .         . .. .      . ..
..  .     .  . .   .       .  .      .
.   .  .. ... .        .. .        . .
......................................
