...........................................................................................................................
..  .    .       .   .             .  .  .  .       . .     .  .                       ..        .    . ...               .
.                 .                                     .           .           .          ..             .. .            .
.            .                .             ...        .    .    .. .  .          .  .       .             .     .    .  ..
.      . .          .        ..       .          .           .   .       .                           .         .. ..      .
.    .          . .       .    .          .     ..                      .  ..  .       .  .  ..   .      .         .      .
. .          .     ..   . . .          .               .       .  ..   .                  .                  .            .
.          .               . . .         ..      .        . .   .         .       .                    .    . .      . .  .
.                    .                        .        .  .                   .       .   . .                 .     .     .
.  .    S  .         .           .   .  .   .    .       .    .    ..  . .              X       ..               .     .  .
.       .... . .      .   ..        .             .     ..     .               .           .   .    ..                    .
.  .        .             .    .       .  .            .    .     .  .     .       .      ..     .          .  .          .
.  ..      . . .                ..           . .   .  .  ..          .   .               .       .    .                   .
..  .  . ..        .                 .                    .   .      .    .                       .      .      . .       .
.    .  .         .       .                .                     . ..   .   .                    .                  .     .
.      . .                .                          ..           .                                 .                 .   .
.             .     .. .                        ..                              .                           ...        .  .
. .        .     .         .          ..      .     .       .     .      .     .     .      .              .       .    . .
...........................................................................................................................
