......................................................................................................................................................
.    ..      ..   .          ..   . .         .  ..           .   .       .          ..       . ..        .     .  .                     .  .        .
.     .                         . .        . ...        ..  ..    . .     .   ..            . . .. .      ..         .      .    .      .       .    .
.        .         .                    . .      .  .                   . .  ..    ..       .   .  ..                        .         .            ..
. ..           ..         . .           .       ..     .      .   .                 .          .        .         .  . .             .. ..      ..   .
...  .           .           .    .             .                    .    .   .          . .  .        . ..      .  .  . .. .   .   .    ..         ..
.            .                  .  . .   ... .  .    .         .          .  .          . .       . .     .   .     . ..     ... . .   ..       .    .
.   .              .   .   . ..  .        .            .      .             .     .     .                         .            ...                  ..
..  ..     .  .         .        .      .    .  .     .    .     . .                      ...      . .     ..  ...               .     .             .
.           .       .    .   .     .. . .       .  .     .  .   .    .               . .     . ..      .              .          .               .  ..
.                    .   .      ...          .    ...      .  .     ..  .           .  .                .  .     .   ...   .   .  .       .          .
.             ..         .               .          .     ..                    .  .              .        .  .   .     .        .            .      .
.          .  .  .          .                        .    . .          .      . .  ..       . .                     .              .   ..        . . .
.       .                . .      .         .                 ..            .           .   .      .           .. .  .. .     ..  ..                ..
.   . . ..                           .                               .                    .              .        ..         . ..        ..          .
.         .            .                .       .  . .      .                       .       .      .  .           .  .           .. .    .           .
.  .         .  .               .   . .       .   ..       .          .   .                    .      .  .    ... .     .   .   .  . .. . .  .       .
.       .         .   .          .           .          .      . ... .    .          .         .            .   ...         .    .     .   .      .  .
.   .         .  . .              .               .   .  .                   .    .     . .                                 .   .. .          ...    .
..     .      .  .  .   ..   .     ..   .  ... . .                    .         .             ..            .           .       ..                .  .
. .      .             . .    .       . .  .                   .           .         ..          .          .        .    .                          .
.    .             .       .        .                  .  .    ..       .   .    .  .  .      .  .   .               .           .  .            .   .
.  .             .          .    .      . .    .       .  .      .     .        .        .   .    .   .  .  .    .     ..   ...  ..  .   .. .     .  .
.      .              ...          ..    .           .           .X                         .                       .     .                   ... . ..
.               .            .          . .      .              .   .                                    .           ..  .   .    .         .        .
..      . . .  .     .          ... .              . .  .                      .       .            .   .  .        . .              .      .   .    .
. .      .. .                      ..     .       ...                              S . .           .        . .                         .            .
.            ..   .     .  .   .  .        .   .        .                    .        .              ..              . .          .  .       .       .
......................................................................................................................................................
