...............................
.. .            .    ..  .  . .
.... .            .      . .  .
.          . .  . .   ..      .
.                  .  .    .  .
.   . . .. .           .    . .
.      .. .  ... ..       .   .
.                 .     .     .
.           ..     ....   . ...
.            . .. .     .. .  .
.X  S ...   .  . .            .
.               .      ..     .
.... .       .       . .   .  .
. .      . .  ..  .           .
.  .  . ..      ..            .
...............................
