..........................................................................................................
.   .. .           .. .         .          .. .          .. ..            .  . ..          . . .       . .
.     .  .   .         .   .   . .  ..  .       ..   X         .        .   .. . . .  . .    .    .  . . .
.   . .  . .. . .       .. .   . ...            . .         .       .             . .   .  S         .   .
.          . .     .        .    .  .  . ..       .     .      .          .         ..   ...  .    .. .  .
.   ..  .  .    .   ... .   ..  . .     .  .        .   .. .    .     .         .     .  ..  .     .. .  .
.... .   ..   .  .       .    .      ..  .           .          . .             . .        .    .  .     .
.  ..               .    .  . .         ....   .. .      .  .  .. .         .   .                      ...
..  ..      .         .    .  .             ..     ..                        .  .   .      .   .   . .   .
.  . .   .      . .  . ..    .     .   ..  .             .    ..     .          .  . .. . .  .  . ...  . .
.         . .         .           ....   ...   ..    .  ...      .    .          . . ..  . ..   .   .   ..
..   .. ... ..   ...      .     .      .     . ..   .              ..    . .   ..    .. . .       .     ..
.  .      .. .. ...  .    .  .           . .    .     .     .          ..     ..          .    .   .     .
.       . .   . . .    .            .          . .              .      .   .    ..    .  ..    .....     .
.   ..     .    . .            .           . .  .    ..     .   ....       .   ..  . . .  .  ..  . . .  ..
.   .    .     ..   ....     ..    .    .  .          ..                .   .    ..     .       .  ..    .
.  . .  .. .  .        ..      ..    .        . .. .. .   .  ..                 ..   ..      .. .   .    .
.       . .    .  .  . .    .   . .  .  ..   .       .   .      ..     .      .   . . .   .              .
...       . .      . .  . .   .    .. .. . .              .      .    . .    . . ..   .  .. .  . .  . .  .
...  .    .  . .    .     .    .    .    .     ...    .    .   .        .         .            .         .
..........................................................................................................
