............................................................................................................
..  ..             .                   . .  ..           .                     . .     .      .  . .   .   .
.    .   .              . ..  .          .     .  .  ...                               .  . .  .       .   .
.      ..                              .                  ..            .     .   .  .     . .   .       ...
.    .     .....      .  . .        .          ..       .            .  .        .   .    ..     ..S    .  .
.          .           .    .      . .     ...      .  ...        .       .                     .     .    .
.  .     .  .         .  ... . . . .      .  ...                 .  . .... .         . .      .   .. . . . .
.    .  .                ...       . X       . . . ..        .  .         .     .   .      .    .        ...
. .  ..        ..        . .  .   .  .      .     . .   . . . .     ..    .              .   . ..   ..  .. .
.   .         ... .   .                          . .     .    .   .      .    .    .         .. ..   .   . .
..             . ..      . ..         ...         . .  .    .  .     .    ..  .       . .             .   ..
.  .        .   .                       .        .  .          ..       .  .  ..     .  .       .      . . .
. ..     . ..         .          ... .    .  . .   . .  . ...   ..   .  .   .                .        ..   .
.          .  .      .           ..     .      . .                    . ..  ..    .  .            . . .    .
...           .  .   .    . .          .       .  .    ..   .     . .. .   .  ..   ..    ...       .       .
.   .  . ..     . .. .          .      .     .   .  .         .        .                 .  . .       .    .
.   . .   ..  .   ..          . .    .   .       .   .   ..  .       .                .  .     ..  .      ..
.   .  .   ....        .      .         ..  .. .  . ...   .       .  .           .    ... ... ..       . . .
.           .                . .   .   .  .  .             ..          . .           .     . .    ..       .
.            .         .       .     .                      ..          .   ..  .  .      .   .    .      ..
. . .. .                         .   .     .          .             .    .     .       . ..            .   .
..                   .    .    .   .     .  .          .           ..   .        . .               .  .    .
.         .        .       .          ..    ..      ...    .   .     .       .       .  .  .  . .  .       .
. .      ..      .   .      ..           .      ..            .    .   .   . ...  . .   .     .  .   .  .  .
.    .   ..      .     .     .           .     .  .      .       ..         .        .. .  ..    .    .    .
............................................................................................................
