..................................................
.. ..   .   ...        .  . .. .   ..  .   .    ..
. . . .           ..    .. ..       . ..         .
.   .     .        .    . .      ..  .     .  .. .
..    .  .  .  ..  . .      .  ... .  . .  .... ..
..     .. .. .   .  . .  .....    .     . . .    .
..  ...  .  . .  ..       .  .        .      ... .
.     . .        .   ..    .            . ..     .
..   .             ..          .  .   .   ....   .
..  . .. .      .  .   ..     ..     .X ...  . . .
..  .      ..          .      S  ...   . .  .    .
..  .    .   . . .... ..    .     .    .      .  .
. .    . .   .            .. .   . .     .       .
.   .       .     .       ..    ..     .   .  .  .
..................................................
