.........................................................
.    . ..      .  .    .  ..               .     .      .
.           .   .                      .                .
.                     .  .   .     .                    .
.    .               .           .         .          . .
.  .         . .  S      .   .    .. .       .   .      .
..      .   .         .     .        .  .     .   .     .
.    .    ..             .. .X .  .     .       .      ..
.      . .     ....  .  .                 ... .    ..   .
.   . ..     .  .  .   .  . .     .    .         ..  .  .
. .  .     .                . .       .       ..        .
...        .   ..                      . .  ..       .  .
.........................................................
