...........................................................................................
.                       .            .   .              .       . .      .            .   .
.                  . .    .        .            .                  .   .  .   . ..        .
.        .     .          .   .    .    .     .          .. .     . .      ..             .
...         .   .  .    .               .   .     .          .        .          .       ..
.            .  .              .       ..             .  .     .           .              .
.  .                .. . .      .             .   .   . .     ..            .             .
.                                                    . .           .        .    . S      .
.  .                    .              .   .         .         .                  .     . .
.       .             ....     .     . ..X .         .                         .  .       .
.                               .         .   .   .                                  .    .
.                   .          .                         .     .    .           .   .     .
..          .                                   .               .     . .      .          .
.                  . .        .         .      .       ..             .              .    .
...........................................................................................
