........................................................................................................
..   .. ..  .     .    .       .   .......   .      ...   .  . . .   ..      . ...  .     .... . .   . .
.. .. ...    ..   . . .   .   .       .. .  . .   ..      ..      ..     .. .  .  .  .       .      . ..
.  . .  .   . ...    ....  ..    .        ....  .     ..            .       .          . .     .   .   .
. ..        .    .     . .     .   .  .    ...  ..  . ..      .   .           .    . . ..    .  .      .
. .  .   . ... .  .    .   . .  .  . .  .  ..   . ..    ..   .     . ... ....       ..            .  . .
.. . .   ..  .      . . . .  ...  .      .           .   .. ..       .. .         ....   .  .    ... ...
.    .  ...   .      .. .  .            . .  .        ..           .    .          . . .          ...  .
..       .. .        ...      .     ..     .  .  . .  .  ..   . . . .     .        .        .    ... . .
.   .    .  ..   ... ... .     ..    .    ..  .  .       ...       .  .   . .        .. .. .    X...   .
. .  .               .      .  .  .        .. .   .       . ..    ..  ...     . .         .   .   .  . .
.. .   .    . .    .  ...   ..  .    .       .    .              ..    .  .    ..   .  ..  .   ... .   .
.     .    .   ..        .   . ... .. ..    .   ....      . ..     . .     .     ... .              .. .
.  .    .  .   .   .   .   . ..  .                 .           . . . .. ..  . . .. ...       ..  ..    .
.  .      .   .      .       .     ..  . . .  ...  .  . . ..      . ...  .. . ..      ..   .   . .. .  .
..    ..   . . .. ..... .    .  .   .     . .   .  .  .   ..           .. ..   .  . .       .  .   ..  .
. .     . .. .. . . .   .. .   ..  .  .    . ... .     S      . . ..  .   .    . .         .. . ..  .. .
..        .  .      .  .  .. ..   .    ...   .    ..   . . .   .  .       ..     . . ... .   .  .      .
.  .  .      .            .  .    .        ..  .    ..    .      .  . .. ...    . .  . .   ..  .   ..  .
.   .  ..  .  .  .  . .  .. .  .  .     .  ..  . .. .  .. .          .    .        .        ....   .  ..
...      ...       .   .      ..    .  ..    ...   .       .  . ..    . .    . .                 . . . .
. .  .   .   .  .    .     . ..             .     . .... ..   .    .     .         .  .           ... ..
........................................................................................................
