....................................................................
.                                           .   .      . . . .  .  .
.                   .       .             .                     .  .
.     .     .  .     .              . .     .          .        . ..
.                .            .  .            .             .      .
.     .                   .             ..                   .  .  .
.      . .        .          .       .                 .  .        .
.  .     .    .  .        .  .  .                 .  .. .          .
.                     .   .   .      .     .                .     ..
. . . .      .        . .                 .                        .
.    .     .   .   .            .       .       .                  .
.       .   .. .   . .       .       . .    X        .   .         .
.               .          .     .   .                   . .       .
.             .                              .                     .
.      .              .                     . .                    .
.         .            . .             .                .          .
.                                      .              .            .
..         .         .  .       .     . .  .                ..     .
.      .    .                  .                               .   .
.          .    .  .                    ...      .    .            .
. .      .                                 .                 .     .
.              .                 .            .   .  .  . . . .  . .
.  .       .                           .         .    S          . .
.   .    .    .          .             .  . .              .       .
....................................................................
