..........................................................................................................................................
. ... .   .     ..    . . ..    ..     .    ..     ....   ..   .  ..      ..  .. .        ......      .        .     .            .      .
.    .    . .     . . .      .  ...   .    ..             .                .   . ..      ....     .  . .. .    .  .     .          ...  ..
.   ..       . .  .       .       . .  .   .             .   ...  . . ..              . . .     .     .....    . .    ... .   ..  .  .   .
.   .  ..  . .   .  .   .     .     ...  . ..  .     .    .    .    .  .    .    .      .  .     .    .       .    ..      . ...  .      .
.   .    .    . . ...   .  . ..  .   .   .    .  .                .              ..   .    .. ..    .     .         ..     .  .    .     .
..  ..  ....    ..   .    ...         .  .   ..   ...          ..   . .     . .  ..   .       ..   ....    ..      ..     .  .    .   . ..
.  .   .   . .   .    .             .    ... ..      .     .         .   . .       .. .   . .       . .  .    .. .  .           .   .   ..
.  .  . .     .     .   . ...  .         . .   .  .     ..      ..  . .   .  ..           .    .    .     .   .             .      .. . ..
.         .         ..         .     ..  .  .    ....   ..   . ..  . .. .. .       .      ..  .  .... . . .  .    . .        . ..   .  . .
.   .          ..       . .. .    ..    .. ...         .       . .    ..    .   .   .. . ..       .       .    .    ..     .  .  ...    ..
.  ...   .      ..                   .. .   .          . .      .     .  ..  . .    ...  .  .      .  .. .          . .   .        .  .  .
.           .     ..  . .   .  . .. .  .     .  ...   ..   . ..     . .  .  .     .    .  .  ...   .    ..  .      ..          .  .      .
.   ..  .      ..   .    . .      .        .. .   ..          ..... .  .       . . .         .  .  .    .      .  .         .    .  .  ...
. .  ....   . .... .  .     . . .. .        .    .  .      .   .  . .   .  . .  ..       ...  .    .                ....  . .  .. .    . .
.   .     ..   .. .       ....         .. . ..     .      . .....   .. .    . .  .   .               .       .         . .  .      .   ...
. .. .   . .     .   .     .    .  .. ... .        . .   .. .  .     .     . . .  .         .   .  ..  .     .  . .      . . .    .  .   .
.    .   .     ..  .  .    .   .     ..       . ....      . . . .      .. .    ... .       .         .. . .   . ...              . .. . ..
...  .. .                        .  .     . ..... ..   .   ..  .   . ... . .   .       . .       .    .    .   .  .             . .      .
.    .  .  .    ..   .... . . .. ..  .   .            .  ..      . .        .      . .   .  .. ..  ..   .  ..   .  . ..   .   .          .
.      ..     ..           ..  .  .    .   .   . ....     .         .             .       .       . .      . .   .      .   .          ...
..  .  . X    ...    .  .  .   .    .. .   .       ...       .    . .   .   . . .       . . ..  ... .  . ....    .   .     .     ..    . .
. .       . .   .        .   .  ..  . ..   .  .     . .        .   .  ..     . .        .    . ... . . ..    .     ..        .  .   .  ...
.  .       .      ..         ..  .            .  .  .    ..    . . .   ..    .   ..  ..   .      ..  .  ..   . . . .. .         ..       .
.  .   .  ...  .   .  . .  . .        . .   .      ..        . . .     ....   .       . .  .. .  .  .     .         .  .      . . .   S ..
.  . ..  .  .  .     . .. .  .   .      ..   .   ...  .     ..   ..          . .. . ..      .  .       . .        . .      .   ..   .    .
...       .             .    .  . .          .  .     .   .. .  ..  .    ..  .. .    . .      ..  ...  .   . .          .       .   ...  .
..........................................................................................................................................
