........................................................................................................................
.   . . .      .  .       .  .      .                  .           .  .       .. . .      .        . .    . .         ..
.         .   .. .   .       .  .   .  .           .         .  .       .              ..     . . .     ....    .      .
. .  .          .           .    . .   .  .               .      .          .      .      ..  .    . .  .     .   ..   .
.  .       .   .      . .   .   .    . .  .     .             .        .   .           .             .    .   ..    .  .
.          ..   .  .   .  ..    .                . .      .   . .           ..             .      .       . .    .     .
.  .       .      .         .  .   . .   .  .          .           ..          . . .  .      .  .         .            .
.       ..  .        .           .      . .          . .                    . . .   .       .         ... .            .
.         . ..   .             . .       . .       .  .                     ..  .   ..  .         .             . .    .
.  .   . . ..   .          .   .           . .    . .               .    .          .        .  .  ...  ..   ..        .
. .           . .               .            .  ..   .         .   .  .      S.      .   .    .    .          .    .   .
.    . .          . . .  ..  ... ..    .       .    .             . .     .       .      . .        .      ..      .   .
. .  .          . .              .              .   .     .   ..           ..    .  .            . .                   .
.           .  .  .              .            .  .          .. . .               .  .    .. .     .          .  .      .
. ..      .   .  .      .. ..  .   .             .                  .   .   .  .       .    .      .                   .
.     .                  .              .      .    .. .       .        . .    .           ..  .    ...     .          .
.    ..                  ..         .            .     .  .                        .        .  .  .    .   .           .
.   .. .   ..           .   ..  .     .    .    .   .           .   .          X  .       . .. .     .       .  .      .
..            ..       .    .  . . .   .. .  .    .         . .  ....    ..            .   .       .  . .  .   . ..    .
....    .          .        .     ..  .  .   .   .    .     . .  .               .  .     .         . .   .  .       . .
.                   ..       .         . .            .                       .. .  ..  .          .     .    .        .
.. .   .  . ..           ..         .      .    . .     .  .      .     .      .    . . ... .      .   .     .         .
........................................................................................................................
