.............................................................................................
.       .  ..      ..   .  . ...    .    .    . .      . .         .  .        .     .   . ..
.   .       .  .     . . .              .   .  .       .    . ...  .. .     . .    .  .     .
.. ..                   .    ..         .   ..   . .     ..   .       ..         . ..  .  . .
.  .  .  .             ....    ...                      . .  . .. .  ...  .   ..        . . .
. .  .    .   .   ...   .   . .   . ..   .     .  .       . .   . ..       .    ..    . ..  .
.     .. .. .  .S. .      ... . .     .  .. .. ..      .     . .  . .      .   ....   . .. ..
.       .    . .        ...     ..     .  . .   . .  .. . ..  .   . ..    .  .  .      .    .
.  .    .       .  . .     .   .   .         .. .       .   .......  .    ..  . ..  .  .   ..
..  .        .   .     .     . .     .      ....  . ..       .       . .. .       ..   .   ..
..      .    .          ..          .        ...        .  .         .    . .  .    .  . .  .
. .      .  .   . .       .  .  .      .   .. . ..    .      .     .    ...   .   ..  .     .
.      .. ....  .   . .... .      .    .    .  ..        .  .   ....     ..  ..   ... .  .  .
.     . .  .. .  ..   ..      . .    ..  .           . . ..     ...        . .  ...      .  .
.   . .    . .    ... X..    .. . .  . .       . .  .       .  .  .     . .    ..   .    .  .
.   .. ...    .   ..   .     .      .. ..              ... . ..   . .    ....     .. ..     .
. . ..  .    . .        .  .             .. .  . ..   .     . .  .   .... .     . ..   ..  ..
.............................................................................................
