................................................
. . ..    . .            . X .    ......       .
.    .    . .     .      .   .    . S         ..
.   . .     .            .   .    . . . .    .  .
.     .  .        .      .   . .     .         .
.    .             .               .          ..
.             .          . . .                 .
.       ... .        .  .    .   .         .   .
.       ..  ..  .          .       .           .
.             .  .            .              . .
. . .      ..    .            ... .      .  .  .
..            .           .  . .         . ..  .
.         .                  .              .  .
................................................
