............................................................
.        . . . .    .  .      .  ..  .     .  .    ..      .
.        .  .           .    .S    . .       .       ..   ..
.        . .  .       .        .     . .  .  .  .        X .
. .          .  . .   .   .  .       ..   .  .  .          .
.          . ...   .  .   .   ... .        ..     .   ..   .
.  .    .   .     ..  . . .  . ..  .            .    . .   .
.              .   .   . ...  . .  .   .             .    ..
...   .    .                        .   .  .     .         .
............................................................
