.........................................................................................................................................
..  .. .   ...     . ..          .          .    .. .   .      .    .  .. .    .   .        .    .        .   .      .  .    . . .  .   .
.   .        .               .  . . .  .      .   .   . . ..         .  ..       .          .    ...             .     .     .      .....
. .  .        .    .       .      .  .                      .     .  ..    . ..                .    .         .     .  . . .S   . . .   .
.           .      . .   .   .       ..  .    .   .     .  .  .   .        ..  . . .      .   .   ..     .     .     .     . ..         .
.                .   .  . ..  . ...   .    .      .  .       .   .      ..   .                       .               .            .  .  .
.. ..     .      .              ..      .     . .         .           .     .         . .             ..            ..      .           .
.    .  .             .    .              ..             ..   .   ..      .       .    .    .  ..      .   .            ..   .  ..      .
.   .. .. ...  .          .    .       .  .        ....   .               .                  .. .      .  ... .   . .     .             .
. .    . .             X  .                                     .      .  .           .  .      .      ... .    .       .    .   .    . .
.                  ..       .       .  ..      . .     .    . . .   .     .                     .   .                       ..    ..    .
.........................................................................................................................................
