............................................
.    .      .         .  . ..      .    .  .
.  .. ..              .  . ..  .      .   ..
.   .    .      .              .   .      ..
.         ... .   .             .    .. . ..
. .     .    .   . .         ... .     .   .
. .        ....   ..      .  .     ..  .  ..
.    .     .     .        .  . . .   . .   .
.  .  . . .          .   ..       . . . .. .
... .  ..S  .   ...     .  .  .     .      .
.. ..     .     .      .       ..  . ....  .
.    . . . .   .            ..   ...    .  .
..   .            .  .           ..  .     .
.    . ..  .   ... .  .   .   .  . X .   ...
.     ....  .  ...   ..         .   .      .
.  .        .   .. . .     . .  .  .   .  ..
.  .    .      .    ..   .    . . .   ..  ..
.            .      .   .      .   ..    . .
.    .    . .    .  .    .      .    .     .
.  . .        .                ... . .     .
. ... .    ..    .   .  .   .         . . ..
.   .    ...  . .  .     .  .     . .   .  .
..  ..      . .  . .        .     ..   ..  .
.  . .   . .  .    ..  . ..  .        ..  ..
... .       .  .   .        .              .
............................................
