.........................................................................................................
.         .                    .   .     .   .          .   ..    .  .. .       .          . .          .
. .    .... .  .   . .      .  .       .       ...      .         .             .                .      .
.  .   .    .        . . .    . .       .  ..               S    .        .        .                 .  .
.  .  .            ...                ..   ..  .      .       .    .         .     . .     .     .  .   .
.       .  .        .              .  .               .             .     .       ..                .   .
.           .       .   .          . .       .  .            .    .  .      ...                      .  .
.   .        .      .       .                       .  . .                        .  .    .       . .   .
.      .         .   .      .                   ..              .  ..     .              .           .  .
..   .                         .. .   .    . .                              . .                        ..
.  .       .                        .      .  .      .         .    . .   .                      .      .
.  ..    .         .   .           .          .. . . .. .                .       .                      .
.      .      .               .                .              .   .     .    .      .             .  .  .
.                      ..    .   .  .                .       .    .      ..   .   .                     .
...    . ..                  .      ..    .      X  .  .    .  .   ..   .             .                 .
.  .              .                                           .    .      ..       .                  ...
.        .    .      .        .       .  . .       .     .   . .   .         ..             .           .
.........................................................................................................
