..................................................
.X     .  .       .        .. . . . .        .   .
.                .    ..        .        ..   .  .
.     .                   .       ..          . ..
.                  .       . ..                  .
.         .  .                    .             ..
.                   ..    .   ..                ..
.                  .   .          .              .
.                      .                         .
.                    .       ..   .              .
.        .         .   .     .                   .
.     .       .          ..     .      ..       ..
.     .                      .. .              ...
.              . .                      .  .     .
.      .      .           ..      .           .  .
.          .  .   ..   .     .  . .         .    .
.  .S               .        .  . .              .
.  .        .     .     .   .         .      .   .
.            .              .                    .
.                      .    .                 .  .
.           .                .    . .            .
.  . ..         .    .    .               .    . .
..................................................
