............................................................................................................
.         .    . .     .   .       . .              ..  .  .      .                .   .     .     . .     .
.    .   .     .     .  .     .  .. .   .. .     .   .      .                  .         .         .       .
.     .        .S       ..    .      .   . .             .       .   .. .       .      . . ..           .  .
.   .    ..             .            .      . .                      ..      .   .           .     .. .    .
.                      .     .      .   . ..   .  .  .     .          . .   .     .  .       .   .. .      .
. .       .    .            ..            .   .     ..     ..  .             .       .    .  .          .  .
. .      ..        . .         .             ...  ..         . ..         .       .      .                ..
.             . .        ...  .    . .    .                           .     ..       .        .      . .   .
.              .     .    ..               . .   .. .     ...          .  . .      .  .             .  . . .
.      .                                   .   ..   .   .         .  .                      ..  .    .     .
.           .     .   .            .         .    .           .  .   .   . .         . . .  .   . ...     ..
.               . . .    .   .              .   . .   .  .       .    .          .                 .       .
.    . ..                ..         ...          .   .  .  ..     .      .  .   ..                .    ..  .
.   .   .          .  .  .     .. ...     .           . .  . .                                          .  .
.      .     ..  . .                .     . .        .    .     .      .          .    .   .              ..
.  .       .     .    . . . .                 .       .        .   .    .     .   .   .         X.         .
.         . . .       .   .                 ..   .   .  .        .   .       . .   .. .   .  .    .        .
.  . .. .        .  .          . .           .           .     .. . .    .     . .         .          .  ...
............................................................................................................
