......................................
.. .   .   . ..  . .   .  .. . . .  ..
. . .      . . .     .    ..   ... . .
.  .     .S  . . . . ...  .   .   .. .
.   .  .  .     ..  ...  . .  .   . ..
. .    ..   . .     ..     .     ..  .
.  . .   ..  .     . .  . . ...     ..
.. ..            ..      .    . .  . .
.. ....  .  .        . .       ..  . .
. .       .... .      .   . .      ...
.  ..           .   ...   .  ...     .
.   X  ..   .         .    .   . .   .
.   .   .   .. . .    ..     .    .. .
......................................
