................................................................................................
.     .  ..  .         .....           . .   ..  .    .     ...          .       ....   .      .
..  . .  .  . ..   . .         .. . .         ..    . ..           .    .           .  .       .
.           ..     .  .        . .   .   .  .    S    . . .      .. . .   .    . .  .    .   ...
. .        .. .                  . .    .          .      .      .        . .          .  .    .
. X .        .    .              .     .    .  ..    .    .     ..          .      .  .   ..   .
.    .             .   .  ... .       .          .    .               .                        .
.  .      . ..     .       .     .  .        .        ..    .        .  . ..  ..          .    .
.  .    .       . .   .  .   .       .  .   .          .  ... .. . ...      . .  .. .     .    .
.  .       .         .   .   . .. . .                   .      .. .  ....         .     .   .  .
.  .           .           ..               .         ..      .   . .         ..   .  ..       .
.            .      . .  ..    ..  . ..        .                  .   . . .  .     .  .. ..   ..
.    .   .    . ..   .       . .  .              ..  .  .    .      .  ..      ..  ..     .. . .
. .  ..  .  .   .   .              . ..  .   . .           .       .        .   .       .. .   .
.  ..         . ..   .       .      .           . ..   .       ..  .  ...        .   .         .
. ..  .  . . ..       .   .   .  .           .     ..  .   .          . .      .  ....   .  .  .
.  .       .  .             . .        . ..            .   .  . .         .   .             .  .
.         .    ...     . .       .        .        .     . .                ..  ..  .  ..      .
.. .   ..    .       .   .  .           .          . .    .    .. ...     . .      . .   .  .  .
.        . .    .            .  ..  .  .             ..     ..      . .    .          . .. .   .
.  ..   . . .             .           . .  .   .                 . .     .  .      ..   .     ..
..   ..       .       .  ..              ...           .          ..     .          .  ..      .
................................................................................................
