.................................................................................................................................
.. ...  .. .      . . .            ..   .      .                    ..    .          .       . .  .         . .    .      . .   .
.    .     .      ..     ..          .         .                .                .     .    .                  .. .      .      .
..                ..    .       .  .                      ..   .                  .. .                 .      .    .     .   .  .
.       .  .   .      .  ...    . . . .          .      .  .. .                     .   .        .     .             .  . .     .
..S   .  .  .       .  .                    .. .          . . . .  . .      .  .     ..  .  .          .           .   .   .    .
.             .           .   .      .      ..                         . .     .  .   .                   . .        . ..       .
. .  .      .           .      . .             .    .    ..     .    . .. .   .       .          .     .     .    . .     . .   .
.                .. .        ..            .   .      .        .       .          .                . .  .     .      .  .      ..
.   .          .           ..         .   .    X      .               . ..    ..  . .               ..  .             .         .
.    . . . .             ..   .  . .        .    .                .  .      . .       .   . .           .  .    ...       . .  ..
.    .   .             .          ..         ..               .        . .        .          .     .       ..         .         .
..           . . .    .              .. .  ..            .        .   .            .     . .               . .  .               .
.      .  ..  .   . .   .    .     .                     .  .  ..  .             . .                  .       .     .  ..     . .
.................................................................................................................................
