.............................................................................................................................................
..    .     . . .     . .    .  .    .. .   . .       .   .   .      .         .    .  ..      . . .  ..   .      . .    .   .     .   .  ...
.   .         .       ..  .    . .     ...   . ..            .                          .             ..    .. .       .      . ..   ....   .
.   .                    ..  ...  . ..    .. .. .      . .   .    ...   . . .          . .               .   .   .       ..  .       .      .
. . .  .      .      .    . .   ..      .         .            .            .  . ..   .   .             ..  .  .      .   . . .  .         ..
.    .    ..                .   .        .         .           ...       .    ... .        . .      . . .    .           .        .         .
.       ...    .         .           ..        .                   . .             .          .  .  .  . ...        .   . . .     .  . .    .
.  . . .  .      ...          .    .  .    .    ..    .. .            ...   .      ..          ..            . .  .  .     .      . .       .
..  .      .         .  ....  . . .   .              .    . . .       .       ..  ..     .   .  .         .    .    .      ..            .  .
...    .  .     ..  .  .                    . ..  .         ..          . .                   ...  .    .    .            .    .            .
.    .     .  .   .   .   ..  .   .        .       .         .   .  .           .    . .              ...  ..     . .   .    .              .
.   .          .    .    .     ..      .  . ...   .                                            . . .   .  .            .   .                .
.        .. .   . .  .   ..    .                 .       .          . .        .          ..    .    .                  .        .  ..      .
. ..   ..           .     .   .    .   .  .         .            ..   .      .               .     . .   .        .       . .               .
. ... .   . .    .  ..              ..  .     ..   . .  .   .          .   .  ..   .    .. .     ...          . ...             .    ..     .
.         .  . ..       .   .  .         .        ..      .  . .            .   ... .              .  .            .   .   .  .   .       . .
..     . ..  . ..      ..   .  .          .    . .          . ..   .       .                   .           .. .       .   .              .  .
.     . .   .   .   . .      ..          .. . . .    ..  .  .              . .          ..       .  . .  .     .            .          .    .
..    .          . ..    .             .   ...              .  .      . ..  . .   . .         ...  ..    .    .  X        .  ...   .        .
..  ..    .  .            .      .  .     .  . ..      . .  . ..   .     .   .  ..                 ..      ..  ..      .     . . . ..     . .
.    . .   .        .         .  .    .          .                   .        .  . . ..... .  .  .     .   ..  ..    .     .             .  .
.        . .     .   ..      .       S                  ..      .            . .     .       ..     .   .     . .  . . . .       .          .
..    ....  .         .               .       .      . .  ..          . . .          .   .          ..            .          .   .      .  ..
.............................................................................................................................................
