....................................................................................................................................................
.. .  .   ..            .        .               .               .    .   .  .      .                       .              .   .     . .   .  .    .
.        . .    ..     .       .            ..        .               .  . . ..   . .   .   .          .  ...      .    .   .       .  .    .      .
.            .              .             .      X .          .     .     .            .     .     .        .   .  . .           .. .        .     .
.                  .     ..           . .     . . . .    .  ..    .                  .           .    . .          .                               .
..   .   .      .  .      . .         .             .   . .              .   .                .  . .           .      .   .          ..  .     .   .
. ...       .          .       .       .   .   .  .         .  .     .       .        S    . .     .    . .     ..     .        .             .    .
.       . . . ..    .      .    .  .      .     .                          .    .      ..             . .  . ..         .   .  .      ..         . .
.   . .  .    .       .   .  .   .  .. .      .               .     . .  .            .  ...         . . .    .                  .  .  .   .. .  . .
....................................................................................................................................................
