..................................................................................
. ..    .        .         ..  .S            .          .                        .
.      .  .                    .      .            .    . .  .   . .       X     .
.      .  .          . .      .                                             .    .
.   .       .        .                 .                 . ..   .  ..          . .
.             ..   .    .                                         .    .     .   .
.    .              .    .             .  ...      .             .   .     .  .  .
.                          .                                                     .
.         .                   .                                 .     .         ..
..           .                .        .                       .                 .
..   .              .         .   .                  .             ..  .        ..
.     .            .     .        .              .       .  .  .  .              .
.       .           .               .    .          .      .                     .
.                 .       .         .   .                 .               .. ..  .
.                    .           . .   .   .            .      ..                .
.          .        . .                        .    .                   .        .
.          .      .                    .             .    ..  .                 ..
.                       .       .   .      .            .              . . ..    .
.      .            .            .       .      ...  .        .  .   .           .
.         .  .            .       .                     .             .   .      .
.                                              .         .     .                 .
..   .   .              .    . .   .          .        .       .  .              .
.        .          .        .         .  .                              .       .
.    .   .                 .     .  . .         .  .    .    .        .   . .    .
..  .       .                  . .         .     .   .                     .     .
..................................................................................
