........................................................................................................
. .              .                               .      .      . .        . .                    .     .
.        .                .              . ..        .         .  .       .   .  . .             .  .  .
.          .       .    X                  .     .                         .      .               .    .
.       .    .. .     .                       . .        .                .  . . .          .          .
.      . .             . .       .   .                               .                  .   .          .
.     .      .       ..    .  .    .                    ..          S        .              ..       . .
.    .          .       .                            .                          .  .     ..   ..    .  .
.   .                  .        .        .     .     .   .            .                .   .    ..     .
.             .           ..  .          . .            .                       .        .          .  .
........................................................................................................
