..............................................................................................................................................
. . ... .     .  .              ..   ..  .    .   .         .    .    . .        ..       .      ..  .          .                   .        .
.  .        .  . .         .   .       .    .   .   .              .   .   .  . .   .        .    ...             .   .      .    .    .  .  .
..                         ..       ..       . .        .       .. .  . .  ...      .     .   .   .   .           ....   . . . .  . .   .    .
.       . .. .    .              .    .   ..          .  .       .    . .   .  . .    .      . .  .  . .  ..                               . .
. . . .  .         .      . .  . .  .   .       ..  . .   .                    ...     .   .  . .    .           .    .        . .           .
.         .       .   .    .   .     ... .       .         .. ..      .        . .                .    .     .    .   .  .   .     .  .  ..  .
..   .   .            .              .           .     ...  .   .          .        ..     .  ..           .     ..             .   .  .    ..
.   ...    .   .. .  .. ..   ..    ..    .          .      .  .     .  .            .    .  .  .           .  .  .   ..       . .. . . .  .  .
.  .             .      . .  .        .           .  ..  .  ...                    ....  .      .     .    . . ... . ....    .     .         .
.  .     .  .        . S .   . .     .   .  ...  . ..     . .  .  .              .          . .  . .      . . .  .                         . .
.. . .       ...  . .  .           ..     ..    .     ..               .         .   .         .       .     ... .       .   . .   .  .      .
. ..    .    .  ...  .         .          . .....      .     ...  .                    . .     . .  .       . . .  .  .  .     .     ..   .  .
..... ..    .   .  . .  .      X ...  .   ...            .  ..    .  ..     .            . .  .       .  .             ..    .   .         . .
.       .   .     . .   .             .   .     .  . . .        ..    .   .  . .             .     . . .      ..     . .  . .    .    .      .
.    .   .  .   .  ..             ..    .      . . ..    .   .  ...               . .  .     .       ..     .                  .   ...   .   .
..           .        .         .  .     .             ...     .      ..  .   .         . .      .      .  .        .        ..   ..  .      .
.   ...        .  .    .   .     .                 .           .    .        .       ..    .            .     .              .   .   . .   . .
...           ..       .           . .         .  ...            .     . .   .      ..   . . .     .             .     ..      .   .     ..  .
.  .     .   .      .           ..     .               ...       .          .    .           . ..              .    . .  ...   . .    . .  . .
. .    .        .     .          . ..           .      . .              .            .         .. .     ...  .       .               .       .
.   .     . . . ...   .    .     ...   .      .       .               .   . .       ..                ..   .    .         ..    ..     .  .  .
.    . .   .         .     .  . .  .    .        .    .          .   .  . .. .   ...  . .       .   . . .   ...    .     .    .     .    . . .
.  ...    ..    .  .  . .      .         ...   .  . .   .  .     .        .  ...    . .           . . .  .. .  . .          ...      .       .
.                .  .     .  ....   .                    .  .     .. .     ..          .. .   .    ... .     .   .  ..          .     .      .
.       .      .. ..          .        .         .    .        .       .            .      . .   .  .... ..    ...     .    .   .  ..      . .
..............................................................................................................................................
