........................................................................................................................................
.      .   .          .   .   .    ..   . .  .             .       .       .        .     .    . .     ... .   .            . .   .    .
.     .   .  .  .       ..              .    .            .   .            .. . . ..  .    .  .    .     .. . .        ..      . .     .
..        .      .         .     .        ..    .     .    .          .    .                    .       . .. ..    .  .. .           . .
.  .   .     .   ..    .    .      .. .    .           .  .        ..  .    . .    .  .... ...     .. .   . ..  ..    .               ..
.         .    .   .   ...  ..  .      .         .     .  .   .  .  .     .  ..    .     . .            . .    ..     .   ..     .    ..
.  ..   .         .                 X           .    . .    .             .     .           .      .  ..       .                 . .   .
.  .     . .    .            .  .    .         .         ..   ..  . ..    .      .... ..      . .    .           .     .        . .    .
..    .   .  . .    .         .            .         .        .       .           .  S          .. .          .       .  .     ...    ..
.  . . . .     .         . .    .    .    .  .           .  .                   .     .    . .  ..  .    ...                     .     .
.                  .         .       .   . .   .                    .  .              .        .  .   .   ..             .            ..
.        .       . .           .      .  .         .           . .       .      .      .    .    .   .                   .   . . .     .
.  .              .     .  . . .  .    .. .   .         .    .   . .  . .      . .  .          . ..   . .                              .
.       .      . .           ..  .   .. ..  .         . .     .  .        .             .. . .  .   .. .      .  .    .  ..      .    ..
..   .      .   .. .  .   .    . .         .   .          .   .        .   . . . ..   .     .    .   ..                . .  . .     .  .
.        . .  .     .    ..   .     ..   . .  . ..  .    . .               ..        ..             .    .        ..                   .
..    . ..  .          ..                   .         .                      .       .  . .        .   .     .      .     .  .      .  .
.                      .  .             ..   .  . .   .  .  .       .  .   ..  . .    ..      .     .             .  . .      ...    ...
.   .   . ..  .  . . .. .  .      .   . .          ... . ..       .     .   .                  .  .        . ..       .        .       .
.     . .              .    .         .        .           .  . .   .. ....   .       .      . .  .         .  .  .     .   . .  .    ..
.        .   ..         .        . ..  .      .   .     .                .              ..          .    .           .       .  .      .
.   .  ..    .                       .       .      . .      . .       .       ...         .    . .   .   .              .    .     . ..
..    . ..             ..                .  .. .          .     . .  .   ..                       .  .               . .  .            .
.        .           .    .        .   .      .  ...  .   . .           .     .        .  . .        ..       . . .   .        .  .    .
........................................................................................................................................
