.............................................
.        .. .    .  .. . ..   .             .
...  .    .     ..      ..     . ..         .
...    ..   S .. .   . ..   .  .       ..   .
..    . ..      . .  .   .. .  .    .  .... .
..  . .     ..         . . .   .    .   .  ..
. .    .  .     .  .      . . ... ..  .     .
..      .  .  . . ... .. .  .  .   .   . .  .
.  . .. .  .  .    .  .  .      .. .   .   ..
.    . ..  .. .  ..  ..        .     ...  . .
.      ...  .  .. .   .   .   .   . .       .
.              ...      .  .              . .
..   .  . .  ..    . . . .   ..    ..     . .
.        .      .  .                .     ...
..       ....   .   ..  ..         .     .  .
.      .  ...        .   .                 ..
..  . . ...  .. .   .. . ...  . . .  .      .
. .     .   .   ..       .    ....  .... .  .
..  ..        .     .     .  .. .  .   . . ..
..  ..  . . .  .  . .    ...   ...       ....
. . . .      .    . .  .  X. .  .  . ..  .  .
.  .   ..  .. .   .    ......   . .. .. .   .
.. .. .  .    .  . . .            .  .  ..  .
. .   .        .            ..  .   .    .  .
...  . .      .. .... .  .   ..    .  .... ..
. . . .  ...     .  .    . .  ...   .       .
..      .                  .     ..   ..    .
.     ....         .  .. ... .    .   .     .
..   ....      ..  .  ..     . .        . ...
.............................................
