..............................................
.   .   .    .. .     .. . ..   .      .     .
. .  .   .      ..        .  .... .  .   .   .
. .  .                .   .         .    ..  .
. . .    ..      .  .     .      .           .
. .       ....           .   .     .     .   .
.   . .              .  .        .    . .   ..
.          .    .   .        .   .  .... . . .
. . . ... .  .     .   .   .     .. .       ..
.                  . .      .    ..  .       .
.         . .     . ..  .         .    ..    .
..   .   . .   .....  . ..  .  .      .      .
...   . . .  .          .  .  .       . .   ..
.     .    ..    ..      .. .  ..   . ....   .
.    ..                   .     .       .    .
.  ..   .. ..  . ..    .. .   . . .    .  .  .
..   .     ..    . ...  . ..    .  .  ..     .
. . ..                   .  .    .  .   . .  .
.  .         .    .   .    .          .      .
.    .     X         .    .   ... ..       . .
.        ..  . ..               .      .  S  .
.       . .  . . ..          .   .   .  .  . .
.. .                    .           .  .     .
.   .      ..    .   .    . .   . .  .       .
.   ..  .        ..  ...  ...   .        .   .
.    .   .         . ..  .   ..        .   ...
. .   .        .    .        .  ...          .
..  .  .        .          .  .  .  .  ..    .
..............................................
