......................................................................................
..  .    .     ..  .  .  ..         . ..    .    .    . .. .   .      ..       .     .
.    .  .   . .   ... .   .     .. .   .  . . ..  .. ..      .   .        .  .       .
.       . .. ...  . .  .  .   X.        .  .   ..        . ..  ..    .      .    .   .
..  .  .   ..          ..    ..    .       .  ..   .   ..    .    ....  .   .    .   .
..  ...   .        .  . .. S  .  . .  ...      ..      . .     .     .   .        .. .
.   .     .       . .      ... ..       .     .      ..  . ... ..        .  .      ...
.     .  .    ..  ..      ...   . .            . . .   .       . .  ..     .  .   .  .
.  .   .   .    ..  ...      .     ..     .     .     .       .  ..  ..       .      .
...   .   ...          ......  ..    .     .         ..            . ..           .  .
.          . ...  .  .   . .  . .      .  .   ...   .  .   .     ..         ..    .  .
.    .          .           . .  ..    ..          . . ..    ..   .  .  ..         . .
... .  .. . .    .   .   ..  .  ..    . .   .   ..        ..  .   ..  ..  ..   . . ...
.          .  ..  .    ..   .   .  .   ... .   .             ......  .     .      .. .
......................................................................................
