.......................................................................................................
...         .         . ..  .. .           . .    .   .         . .  .         ..   .   .  .  .   .  ..
....       . .  ..     . .      ..    .   ..    . .     . . .        ..   .    ..   .    ..  .   ..  ..
.    .  .     .      . . . . .. . ...    ..      ....    .       .            .   .   .     .      .. .
. ...        .    .         ..   .    . .  . . ..   ... .         ..     ..   ... .       .    . .. . .
.. ..   . .  .  . . . .  .  ..   .  .  .    . ..          .    . . .  ..  .     .  .               .  .
.     .   .  . .  .. .  .X.    ..              . .  .   . .  .       . .            .   .     . ..    .
. .. .    .     .         ..     . .    .   .  .     .     .   .        ...     S.      .. .  . .   ...
. ..         ..  .   ..                 .                    ..       .     . ..  ..      .  . .    . .
.       .....  .  ..   . .       ...   .   .    ..         .       .       ....  .     .    ...   . ...
.  .     ..          .      .              .  .        .  ..       .. .           ... .     . .   .   .
. .  ..   .. .   .. ..           .       .  .    .      .     ..  .. .  . .  .    .  ..    .       . ..
. .   .. .    .  . .. .    .  .   .    . .   .        .    .  .         .   .  .     .      . . . .   .
.  .  ..    . .  ...      ..     .  .    . ..     .        ..     .   . .     .. .   .   . .          .
.. .   .  .   ..   ...       .      .  .  ...   .      .         . .  .  . ....             . .. .  ...
. .     .     .  ... .  .    .            .. ..      .  .      .         .  .. .           . . .    . .
.           .    .. . ....  ..     . .    .     ..  .    .         .. .  . ..     ..       .    .     .
.    .              .       . . .  .  .    . .      ..       .    .   . . .    .  .   .....   .   .   .
. . . .              .     .  .      . .        .     .   ..    .   .. . .     . . ..   ...      ..   .
.   . .    ...    .     .  .           ... ..   . ...   .           . . . .        .    ..            .
..        . . .   .  . .      .....   .         .        . .       .     .  ..     .      .  .   ...  .
.     ..   ..    ..    ..  .  ..       .    .    .        .  .   .    .  ...     .    .  .. . . ..   ..
.  . .   .. ...        .   .. . . .   . ..       .       .      ..     . .           .  . . .      ....
.             .   ..     ... .  ..  .. . .   .  .            .. .    .  .  .   .  .                   .
. .      .     .  . .   .      .  .   ...              .   .               . ..          .  . .       .
.......................................................................................................
