.............................................................................................................
.    .     .  ..      .   .   .   .      .  .          .   ..      .  .  .        . .   .. ..           .  ..
.  ..     .  .       .   .. .    .       .      . .        .       ..                     . .       .       .
.    .               . ...  S                . .   .  .. .             .    .. ..   .    .  ... .     . .   .
.    .   .        .    ..      ..        .   .          ..   ..   .         . .        .          . . .     .
.  .             .   ..          .                 .    .  .         .     .        .  .  . .     .        ..
.    . .    .        .        ..   ..   .  .        .     . ..   . .  .   .       .   .      . ... . . .    .
.    . .   .    . .. .     . X. .           .. ..     .  ..    .  .            .             . .          ...
.  ..   .     .       .. .    .   .    .    ..       ....     .   . .    .  .       ...           . . .    ..
.            .  ..   .         .                 .       . ..    ..         .      .    . .     . .   .     .
.............................................................................................................
