...............................................................................
.    .                .     .     ..      .       . .   .      .  . .   ..    .
.      ...   ...    .    .         .... .      .   ..     . .      .   ...    .
. . .. .   .            .  .  .   .  .   .    .  .     . .    .   . .   .  .  .
.            . .      .   .      X    .   .    .       .   ..  .        . .  ..
.   .  .  ..          ..        .   .   ... .     .   ..                      .
..  .  .   .      .      .   ... .       .   .           .       ..  .       ..
. ... .  ..    .         .  . . .        .      ..   .  ..   ..   .          ..
...    ..  ... .. ..           .. ..  ....    .    .   . .  ..     .      .   .
...  . ..       . .  .  ..   .   ..            .      .     ...  .  .   .   ...
. ..    .  .  . .     . .         .    .       .     ..            ...  .     .
..    .  .     .           . .        ..    .S      . ..  .   .     .     ..  .
.    .     . ..  .   .      .. ..          ....  ...  .  . . . .   .          .
. .        .      .   .  .      ..  ..    .  ...               .        .. .  .
...............................................................................
