................................................................................................
.                  . .   .    .      .            .     .       .  .    .        . .           .
..  .                                 .                    .        .        .                 .
.  .     .    .                .    . ..          .                                            .
.  . .               .         ...               .             .        .    .       .   .     .
.  .    .                .                       .                  .   .        . .     .     .
. .             .        .           ..         .          . .            .                    .
. .  .         .    .   .          .  .      . .                   .   ..           .          .
.        .  .   .  .      .     .         .    .      .           .   . . .       ..     ..    .
.        . .             .               .  .        .  .. .            .           ..         .
.          .                 .         ..         ...                               ... .   .  .
.   ..            .            .            ..    .. .. .       .                 .            .
.                                ..               .   .                        .         .   . .
. .                 .                    .                     ...           .  .           X  .
..        . ..     .    .  .   S       .   ..           .       .      .         ..     .  .   .
..            .        .           .  .          .              .. .             .             .
.                            .                              .                  .         .     .
.         . .     ..     .                 .       . .      .    .      .       .  .        .  .
.   . ...      .   .       .      .   .      ..       ..               .     .                 .
.                                        .           . .         .    .  .  .                  .
..      .        .  .        .             .        .      .       .           .            . ..
.   .        .          .            .                                .     .    .             .
. ...     .   ..    .    .         .           .    .    .         .     .              .      .
.     .       .    .              .             .                        .  .        ..       ..
.                     .                     .          . ..      ..   .   .  .        .      . .
. .               .            .   .     .    .               .      .                         .
. .                   .  .               .        .   .      .           .                   . .
.     .   ..       .            .         .                                                    .
................................................................................................
