...............................................................................................
.                .     .    . .   .   .     .           .    . . .  ...        .. .           .
.      .     .   .    . ..      . ..  . .                  . S                .       . .    ..
.      .  . ..   . . . .    . .      .   . .           .      .    .      .X     .        ..  .
.  . .    .    .  .   . .  .  . .      . .    .     ..    ..  .         .      .  .      .    .
.     .   .              .          .    ..   .      .        .  .   .    . .   . .  .    .   .
.         .     .   . .   .  .    ..         .    . . ..         .    ..        ...   ..      .
.. . .      . .   .. .                 . .  . ...   .   .    .  ...    .               .  ..  .
.   .. ..  .     .     . . . .  ..  .   .  .  .  .   .   . .. .  .... ..         .     .. . ...
.         .     ...  .   ..  . .               .  .       .      . . .   . .  .  .   .  . .   .
.  .          ....         .       .. . .  .  .      ..  .   .       .      ...      ..     ...
..    ....  .  .                 .  .                .  .  .      .      .       .. .     .   .
.      . .    .        ....   .                .   .. . .        .     . ..    .   .        ...
. . . .    .   . .     ..   .       .  . .   .         .   .  ..  . ...   .        . .    .  ..
...............................................................................................
