....................................................................................................................
.       .  ..   . .... .      .   .. . ..   ..  .  .       .   .     . . ..                    .       .  .       ..
.      . .  .  .            .    .   . ...  ..   ..  .          .  . ..    .  ..                .. . . .        .  .
.    . .    .. .   . .   .  .  ..     .           .      .   .  .   . . .    ..    .  ..      ....  .  . .    . .  .
.     ...  . .   .  .  .    . .      .       .       .   .     .     .         .      ..   ..    .   . ..     ... ..
.   ....     . . .   . .... .   .  .      .  ...  .     ..      .      .. .    ..      .         .          .    . .
. ..  .       .  .   . ..   ....   ..    . . ... ... .             .. .    .    .     ..   . .. .  ... .      .    .
.    .......    ..   ..      ..         .    .    ..        . .  .. .    .  .   . ..   .    .            . .      ..
. ....  .      ...   ..            .  .    . .         .                   .    X           .    .   .    .. ..    .
...             .           ...    .    . ..   .  .   .   . .    .     .    . . .    . . .  ..    . . . ......   . .
.  ..     .  .   .  . .. .  .      .          . .      . .    . .  . . .. ...          .  .  ..   .  ..     ..     .
.. .. ...   .    ...  .  . .... .  ...      .    . .   .    ...     .       ...   ..       .   ..       .    .    ..
. .     . . .            .  .  . .   .     . ..                    . ..       . .   .. .    .  ... .            .  .
.  ..  .     . . . ... .. . .  ... . ..     .     . .   .        . .             . . .              .  .  .  .. .  .
.  .   .  . . .    .. ... .  .      .  . .  .     .   . .  ....   .  .  .     .    .    .. .. .    .  .      ..    .
.   .   .    .      .     ..  .  ..   .  .      .  . .    .  .  .     .     .  . .      . .         .     . ...  . .
..    .    .       . .. .  .. .    .. .             . .     .    ..      .   ..   ..   ...               ...  .  . .
.           .       .     .        . .  .   ..     ..   ..         ..  .  ..  .  . .. .  .         ..    . .       .
.    .   . . ..  ..   .  .        .     ...   .. ..   .  .   ..      ..     .  .     .                 .   .  . .. .
.       .        .          ......  S          .. . .. . .     .         .    .    . .. .. .        . .. ..   . . ..
.       . .   .  .  ..     . .   .          ..    .    .. .        .   .    .      ..  ..        ... .  .      .. ..
.   ..      . .   .      .      .                 .  .       .     .          . .     .  .. . ..  .. .    ..       .
...            . .     . ...      ..    ....   . . .       .     ..   .  .        .  ...  . . . .         . .  .   .
.    .    . .     .   .         .    .        . ...   .      .  .. ..    .   .   .   . .  ..    .  . .   ..     . ..
.   .   ..   .  .    . . . .   .   ...    .  . .    . .  .    .    .   .. .            .  ..  .   .    .          ..
..        .      .   ..   . .            ..  . .  .  .            .         .. ..    ...       .     . ...   . ..  .
.  .     .   .  .  . ..      .. . .    .  .         . .    .     . . .    .    ..       .  .     . . .    .      . .
.. . .    .    ..       .   .    .  . .          .   ..     . .        .        ..                     . .   .  . ..
.   .  .   .   .      ...   ..      .. .      .          .   .         ...  .               ..    .     ....       .
....................................................................................................................
