..............................................................................................................................................
.     . .               .         .      .              . .   .  .. ..  . .X    .         .   . ..  .          .  . ..  .   .     ..  ....  ..
.  ..     . .        .          .           .    .  . ..  .  .    .                        .          .    .        .  . .         ..        .
.         .         .   .         .  .                .. . .        .    .    .     .. .  ..  .     .  . .            ...   .    . ..        .
.   .      . . .   .     S       .  ...   .    .  .        ....               .  ...  . .        .  ....         ..   .  .                .  .
.         ....  .      .  .  .       . .          ..         .    .. .  .        . .       .           .    .      ..     ..                 .
.  . . .. .    .                  .   ..   ..   .         . .       . .    .  ..  .  . .        .  ..         .. .    .   .   . . .  .      ..
.              .  ....  .     . .       .. . .    .  ....  .           ..   .   .    .   .          . .  .     ..                         .. .
. .            ..        .     .    .   .  ..     .  .       .       ..   . .            .   .                     .  .    ..  . ..       .  .
.   .      .   .  .. .    .    .    . .. .    .          .        ..        ..     .    .  .  .   .            .     .    .        .         .
.       .    . .        ..              ..    .                .                   .       . .      .. .  .   .   ..        .               ..
..      .              .  .                      .    ..                .   .    .    .     .          ..    .       .    .              .   .
.  .    .                          .  .  .  ..    . .  . .        ..           . .                        .   .    .  .       .              .
. .  .   ...  .             . .         .               . .             . .     .    .     .       .  .   .   . . .     .   .    .  .        .
..           ...      .   .             ..   .           . .  ..  ..  .     ..     .   .   ..   .   .             .   .               .  .  ..
..     .         ..   .   . .  .     .   .              .   .  . .                .      . ..               .                .   . ..    ... .
.  .       .        ..  . .      ..  .      . ..           .   .                    . ...       . .   ..          .    .    ..       . .   . .
..............................................................................................................................................
