................................................................................................................
...     .           .  .  .       . .   ..  .    ....  .  ..  .      .  .  .           .  ...  .  .   .      . .
.              .    ...         ..  ..      .   . X    . .   ..  . .       . . .    .    . .        .   ..     .
..         ..   .     ..  .   .. .   . ..      ..       .  ..    .  .      ... .           .   .   .           .
.           ...  .  . ..       . .    ..    . . .    ..               ..   .             ..                 .. .
.   .      .     . .    . ..         .       .   .      .. .         . .   .   . .    ..    .     ..      .   ..
..... .  ..  . .  . .. .    ..     . ...  .     ...  .    . . .    ... . . . . ..       ..       ..     .     ..
.       . .       .  .  .     .   ..   .     .                    .  . .          .          ..   .           ..
.  .    . ..  .    .    .  ... . .    .   ..         .      .    .       . .    .         .          ..     .  .
.     .     .       . . .  .     ..    ..    . .   .   . . .      . ..  . .   .  .       ..        .  . . .. ...
....         .  .   . ..      .  .  .        .   .    . . . . ..   . .  . .   .      ..  ..  ... .      .  . . .
.    ...    .    .   ..    .         .   ..          .    . .     .. .  ..S  .     . .  .    .     .        .  .
.  .      . .    ..  .      .    .      .  ..         .   .  .  .. ..  .     . .  .   .        .. . .     . .. .
.         ...  ....  . .. . .   ..   . .  .  . . .      ..  .      . ..   ...    . ..... .  . ..     .  . ..   .
................................................................................................................
