...................................................................................................................................
..    .  .    . ..       .        .    ...  . . ..        .      .   .     ..    . ..   .   .      . . . .          . . . .  .    .
.   ..      ...  . ...  .    ..      .     . .   . . .       ..  .     .      .         .           . .  .     . .  .        .    .
.  .. . .    .  .       ..          .. ...  .       . .   .  .   .   .    .    .   .. .   ..       ...    ..  . ..      .         .
.       ... .    .    ...   .    .             . . .  ..        .   .       .   . ..   . . .    .      .     .  . . ....   ..     .
...  .  .  .  . .     . .   . ..    . .      ..   . .   ..  ..  .   ..      .             .       .           .   . .        . .  .
.     .   .        .. .. .  . . .              .   .    ..     .    ...  ..    . . .    .       .     .    . ..        .   ..  .. .
.. .    ..    ..  ..  ..  . .   .   .     .  .    .     .   .. . . .  .    . .  .      . .    . ..   . .   .           .    .    ..
..      ..         . .            . .. . . . .  .   ..  . .  .   ...    .  X. ..    .   .  .    .        ..         ..    ... .  ..
.S  ... .    .   .... .  .     ....           . .   . .. .  . .   .  ..  ..  ...    .  ..  .     . .      ..       .            . .
. .  . .   .  .     .  .      .  .  ...    .     .   . .     ..      .       .... .   .  .     . .. .  .       . .. .   .  .    . .
.    .      . ..    .          . . ...  .       . .     ..  . .   ..     ..   .. .   .     . ..       .. .      .. .  ... ..   .  .
..     .   .. .  .      . .  .  .    .  . ...   .   .    ..  .  ... . .   .  .      . .   .   . .    .     .. .   .           .   .
..  .          .    .  .     ..   . .   .  .  ....   .           .. .  . .. .        .   ..    ..  .     .     . ..     .. . .    .
...      .. .   . ..   ..  .   ..      .       .   ..       .   ....   ...    .  .   .      .   .    .     . .      ..          . .
.        ..      . . ..  .     .   .  .     .. .    .    ..   .          .    ..     ...  .       .  .   .  .    .. .           ...
.. .           .   . .    ...  .  ...       .     .    .   ..     .   . .    ..    .   ..       ..   ...   ...   ..    ..        ..
.  ..   .. .    .       .. .  . .      .   .       .           . .   . .  .  . . . .. .  . ..          .   .       .. ..          .
. . .  .     .    . .   .    .. .. .        .        ... .. .           .       ...       .    .  .. .  .  .   .  .         ...  ..
. ..      .          .                 .  .  .. .   ..     .         .    .  . .               .  .             ..    . .... .   ..
.     .     . .   .     . .     ..   .. . .. .  .      .   .  .  .    ....     ..       ... .   .      .              ..      .   .
...................................................................................................................................
