......................................
..  . ... .. . ...  .        ... . ...
.    .. ..   ..   ..   .  .    ...   .
..  .     .           . .  . .      ..
.      .     .  .  .   ..  .   .     .
...    .  ..    .     .. .   ... .  ..
.         .        .        .    .   .
..  . ..   .. .  .   . .. .  .      ..
.     .   ..  .  ..   .  .    .. .   .
.   .. . ..       ...            .   .
.    . .  ..     .   .    ......  .  .
.     .  .  .           .   .X       .
.  . .    ..  ..    .       ....     .
...  . S            .        . .    ..
.   . .  ...     . ..  . .      ..  ..
.    ..   .      ..  ..              .
.  . . . . ..     .      .       .   .
.  .  .     ..  ..        . . ..  . ..
. .     .  .   .   ..      .  ..     .
.   . . ..              .            .
..    .. .. . .     ..  .   . ..  .  .
....  .   .    ...    ...   .        .
. .    .  .     .    .        . .    .
.   .      .   .   .         . .   ...
......................................
