................................................................................
.    .      .   ..  .        .                                      . .       ..
..      .                 .    .            ..   . .      .      .     ..      .
.   ..     .    ..            ..  .  .     .     ...     .         .          ..
.          .                    .              .   .          .          .S    .
.    .  .     .          .                    .      ..         .      ..  . . .
.     .  .        ..   .            .    .       .   .         .. .            .
.              .        .        .  . .  .   .     .  .        .   .  .   .    .
.         .     .  .          .  .    ...      .        .      ..              .
..   .  .             ...   . .   .       .            .        ..       .     .
.  .             .          .   .      .                                 .    ..
.                .      . .       .    .     .    .               ..    .      .
.    .. .  .     .                 .           .                .              .
.      .   .  .   .  .     ..      . .   .     .                . .       . .  .
.      .           .     . X.       .          .             .    .            .
.               .   .  .   .   ..   ..  .     .      ...  .     . . .     .   ..
................................................................................
