.............................................................................................................................................
.  ...   .    .     .     .   .  .              .        ..  .        ..              .  .     .    .  .             .             .        .
. .   .   .           .    .    .  .                      .       . .          .     .   . .                         .           .     .    .
.  . .             S                 .       .           . .             ...        .                         .              .  .     .   . .
.     .              . .    .   .             .        .   .          . .   .     .  .         . .                  .                .      .
.  .           .     .       .     .     .  .            ..                     .      .  .      ..        .       .         .   .   . .  . .
.   .               X     .    .    .     .            ..   .              ..      .. .     .                                 .           ...
.           .           ..                          .    .      .    .                     ..       .  .     . .. .  . .             .      .
. .                         .      .  . ..    .                ..              ..     . .     .  .                               .          .
..                            .   .       .                                             ..                  .     .  .    .         .   . . .
. .      .        .                      .    .        .             .    . .       .. .        .           .  .   .  .       .        .    .
.         .        .     . .                                     .                      . .                                 .        .      .
.... .         .     .             .  .   .                .            .                          .   . .        .      .   .    .    .    .
.    .  .        . .               .  .       .                        .      .        .               .  .     .   .           .       .   .
.          .       .          .    .              . ..          ..                      .. .  .                                          .  .
.    .           .  .  ..            .          .   .                  . .         . . .   .   .        .                .  . .          .  .
.............................................................................................................................................
