........................................
.    .             .    .   .       .  .
.       .   ..   .                     .
.                  .         .         .
. .    .                        .      .
.        ..  . . .           .         .
.               . . ..            .    .
..           .  .   . .  . ..     .    .
.         .    .  .      .       .  .  .
...  .       .   .      .              .
..          ..    .         .       .  .
.                           .          .
.           .   .   .             .    .
.     .    .          .     . .        .
.     ..            . .   .          ...
..   . .. .  . .   . .            .    .
.       ..     .     .  .  . .         .
.                   .  .   .   .       .
.. .           .         .      . .    .
.                   . X     .       . ..
. .   ..   .  .              .        ..
.     .     .       .     . .     .... .
.     .   . .  .    .  .         . ..  .
.  .                 .         .  S    .
.      ..  .            .    .        ..
........................................
