................................................................................
.   .         .      .   ..     .                              .               .
. . .     ..  .    .          .   . .     .                 ..  .    .         .
.        . ..           .   .        .        ...                     .  .     .
.                    .   . .                 .          .. .   .  .            .
..  .            .         .            .    .  .      .   .                .  .
.          .           .      .     .     ..     .    .         .        .   ...
.                 .      .   ..        .  .   . . . .      .    .            . .
.  ..        . .        ..      .    .   ..      . .  . .    .    .  . .    .  .
.         .       .                ..       .. .          . X           ..    ..
.         . .     .       .   .                 .            .        .   .    .
.     .          ..    .. .. .. .  .                              .     .. . . .
.         .   .    .       ..             .          ... .   .       .         .
..    .                   .         .        . . .          .                  .
. ... . .  .      .        ..                     .            ..              .
.          .               .              .   .   .        .            ..     .
.     .     ..          .      .          .  .         .  .  .S     .        . .
.                                        .     ..   .    .                     .
.            .                   .     .            . . ..              .   . ..
..  .  .         .    .                  .         . .         . .           . .
..             . .     ..      .         ..     .                       ..  .  .
.  .       . .    .     .            .              .     .        .         . .
..          .  . .     .   .    .      . .                      .   .         ..
................................................................................
