.........................................................................................................................................
.  ..  .        .    .   . .. . .      ...     .  .           .            ..           . ..               .   . .  .          .....    .
.       .      .  .      .     . .   .    .      .  . . . . .  .            .. .           .        .          .             .        . .
..   .       .              .      .   .       .           . .      ..                       .                     .                .   .
.  . .          ... .        .. ..            .     ..                      .               .              .  . .         .    .        .
..  . S .  .  ..        .    .      .       .         ...    .       .                             .        ..            .             .
.      .             .    .                    .                    ..                  .     .       .    .            .               .
.          .    .    .      .         .   .                                .       .   ..           . .      . .. .   .    .       .    .
.     . . .     .  . ..             . .     .     .        .    .      .       ..            .  .            ...    ..           .  .  ..
.       . ..   .      .  .          ..          .      .    .   .        ....     .. .       .             .   . ..          .          .
.      .                 .       . .                     .    .        .      .                         .    . ..     .     .           .
.      .     .   . . ..                      .            ..         .                  .        . .   .    .   .    ..         .  .    .
.            .        .  .        ..    . . .      .                       .    .   .    .   .     .    .              .               ..
.    .             . .               .     .                   . .                .   .    . .       .          .   .  .   .X.   .    . .
.         .     .                . .             .                  . .    .  .     .. .  .  .      . .           ..                    .
.                .  .         .                .           ..  . .       .                .     ..  ..     .. ..                        .
.     .           ....    .    ..                  .   .  .                .                  .        .      .     .                .  .
.     .                     .      .     .   .  .           .             . . ..   . .                    .          .             . .  .
. .     .  .      ..     .         .    .      .  .      .  .             .         .     .   .        ..      .                        .
. .         ..        .  . .    .         .      .     .     ..  .   .    .           .        .       .    .. .                       ..
. .      .   .          .  .  ..  . .  .   .      ..        . .     . ...     .      .        . ...         .             .             .
.         .      .   ..           . .    .. .           ..  .   ..  .  .  . . .        .             .          .              .      . .
. .                        . .  .                .     .           ..    . .. .            .  . .      .   .     . . .        .         .
.            . .  .  .   .    .   .                 ..  .        . .  .  . . .            .       ..         ..       .      .     .    .
.                 .       .        .                 .    .   . .  .   . .         . .    .    .    .        .        .              . ..
.........................................................................................................................................
