...........................................................................................................................
.  .  .  .            .   ....    .      .  . . .    .    .    .  . .   . . . ..  .......     .  .   .   ...   ...        .
..       .    .    . .    ..  . .  .   ..       .   .    ...     .   ..          .   ... .... ... .  .   .     .       .  .
.  . .    .  .   ..                 .    ..   . ... .      ..      .       . ..        .  .  . .  .      ..            .. .
.  . . ...      .  ..   . . .            ...  ..  .   ..      . .. ... .  . .      ..          ..  . .  . .   .  .    ..  .
.        .        .   . .  .     .. .  .     .  .    . ...    ...   .       . ..       ..  ..   ..... ..           .    . .
.     .  .   ..         .      . .   .   ..  .    .    . ..     .. .            ...  .      .  .   .. .      .. ..     . ..
.  ... .... .. . ..  .    .       ...      .    .   .      .                .        ...   .     .. . .... ..   .   .     .
..   .    .    .     .     .        . ...           . .   .     ... ...    ...      ..       .      . .      ..    .    ...
.      .   ...  .    . ...   . ..      . .. .       .    . ..  ..  . ...  .  .          .       .          .   . ....    ..
.     .  ..  .        .      . . ..   .   .    . .  .  .. ...   .            ..  ..  .  .   ...  .  .. . . .       . .   ..
... ..       . ...      . X .     ..     . . ..  .   .   .     .  . . . .   . .  .  .      .       ..        .            .
.     ...  S .           .        ..   ..   ..       . ..     . .  ...  . .       .  .  .         . .    .. .     .  ..   .
.        .  ..        .   .  . ...   .  . .    ..                     . .  .  .             .      . ..       .    .   ....
..   .    ..    ..  . .. .. .       ..                  .      ...    .. ..   .   .   ..     . .. ...        .   .       ..
.  . .           .          .   .          ...     .    .  ..  ..   ..         ..  .    ..    . .       . .    ..   ..    .
.             . .     .  . . . ..  ..     . .  ..  .. .  . .      .     . .  ...    .     .. .. . .  .       .    .   . ...
. .   . .     ..    .      .     ..    .....       .      .  . .. ..               .   ..  . ..     . .       .. .   .  ...
.  ..  ..        .         . . ..        .     ..    . ...             ..      .  .       .     . .. . .     . ...  .  .  .
...  .      . . ..     .    ..... ..   .. . ...    .    . .  ...                .  ..   .   ..   .  ..          . .      ..
...........................................................................................................................
