.....................................................................................
..               .     .   .      ..  .         .       .            .              .
.        . .             .    . . .   .                  .          .               .
.  .    .    .X     .   ..     .   .    .              .          .                 .
.         .               .   .       ..    .                   .                S  .
.          .                   .     .        .    .             .        .         .
.  .  .   .  . .             .     .                        .   .    .              .
.    .  . . . .                   .     ..   .             .       . .    .  .     ..
.. . . . .   .          .  .   .        .      .       .                   .        .
.         .    .       . .                    .  .              .       .           .
.....................................................................................
