.............................................................................................................................
...              .      .      .         .  .   .         .       . .         . .  .. .      .            ...           .   .
.   ..    ..  .             .          .     . .    .  . .     .    ..  .       .   .                     .   .        .    .
..  .   .    .       . ...  .  .       .  .    .     .  .  .     . .  .            .       .   .  .   .  .  .     . .  .  . .
. .  . .      ..          .    .     .  ..          ..          .          .            .    ...  .   .        .          . .
.    ...      .                     . .   ....             .       .            .     .. . ..  .  . .                     ...
.      . .                         .             .      .  .                  .  .         .  .  .    .     .    .          .
..   .   .                .. .                                  .  .              ..   ..     .         .       ..        . .
.      .       .     .        . .       .        .        .             ..  .      . .            .                       ...
.    .                            .                 . .        .    .   ..     .               .   .         .        . .   .
.           .     .            .    .. .                   ..         .   ..     .     .  .     .  . .      .    .  . ...  ..
.       .       .   .        .          ..  .       . .             .  .         .     .    .    .                          .
..   .. .                    .    .  ..       .              .         .    . . .            ... .                .   .     .
.        . .       .         .       .          .        .     .               .                 .  . .                    ..
.     .       ..              .. .     .   .    .         . .   . .   .      .       .                    .        .        .
.. .        .  .   . ...   .   .  .      .  .      .             .      .      . ..                 .   .    .   .     .    .
.                      .              .      .       ..    .   .  ..    .     .             ...              .              .
.                 .       .                . .             . ..                        .         .     .    ..              .
.     .. .     .                  .         .           .     .                .   ..       .      .              S.   .   ..
.       .             .   .           .       .           .    X  .         .    ..                  .   . .     .   .    . .
.     .       .     .  .  .    .              .  .      .      . .             .     .  .          .                .       .
.       .   .       .  .  .  .        .              .               .    .                      .    . .                   .
.         .   . .   .  .   .       . .           .        .   .   .       .                   .        . .           .      .
..            .        ..         . .  . . ..  ... ..                         .                                         .   .
.      .                        ..       .         .                .      .                 ..      .               .      .
..               .  . .   .   .    .     .     .  . .   . . . . ..  ...  .       .  .                              .  ..   ..
. .             .  .                  . .  .   .       .      .  .    .    .               .                  .      .      .
. .       .    .       .      .    .     .       .          .   .     .. .    ..   .    ... .       . . .                   .
.         .     .                    .   .     .                   .    ..    .       .                      .         .    .
.............................................................................................................................
