.....................................................................................................................................
..  .  .         .    .   .    .             .             .  .   .      ..     .  .      .   ..         .                .         .
..          .   ..          .       . ..    .    . .   .   . ..  .    . ..  .    .      . .    . . . .  .    ....                   .
.     ...         .       .        .       . .  .          .    ..  .     .       . ..   .    .             ...     ..  .        .. .
..      ... .                                .  .      .       .. .       .  .    .              .   .          .         .  . ..   .
.                        .  .   .          .   .     .  . .   .. . .                . .  .       .       .   .  ..    ...    .. .   .
..    .         .          . .        .  .       . .                  .   .       .     S        .                ..      .  .. . . .
..  .        . .    .    . .       .        .           ..     .     .  . . .        .         .      .    .  ... .   .        ...  .
. .. . X  . .  .           .          ...        ..    .  .        .. . .     .  . .         .       .   .           .      . .   . .
.  .          . . ..        . . .               . .   .   .  .          .   .      .      .         .      .         .... .  .  .   .
.....................................................................................................................................
