.........................................................................................................................................
..  .      . .       .     ..  ..   .. ..  . ..   .  .  . .  ....   .  .   . ..  .  .      . ..  .. .  ... .  ...        . .        .   .
.   ..    ..       .  .  ..   .     . . .       .  .                .  .   ..   .  . .   .       ... .           .   .     ..   .    .  .
..    .        . .     ..      .   .   .    ..... ..                 .   ....... . .         ..      .       . . ...      . .      .. . .
.  .           .    .     .      .   .       . .. .  .. ..  .   ..           .  . ..                . .   .   . ..    .        . ..     .
..                . . ..     .   . .         .   . .. ..   . . . .           .   .. . ..     . .    .       .   .      . .           ....
.  . .   ..         ..   . ..       .     .  ..  .         .. .  .  .. .        ..  .  .  .              .    .       . .    .      .. ..
.    .       .  . . .     ... .   ..   .  .               ..       ..      . . .    .     .        .       .   .   .     . ...  . .  .X .
.   ..      .      .        ..    . .    ...   ..   . ..    .     .      .  .....  .  ..      ..  .. . ..        .      .  .    .     . .
. .  . .      .     .     .   .     .  . .      ... .  .   .    .   .   .  . .  .. .  . . ..           .         . . .        .    ..   .
.   .   .     . .  ... .   .      ..  .       . .                    .     .   ..   .   . .      . .   .    .  ...   .. .     ..     . ..
.    .      .. .    .       . ...   .  ..   .   .      .  ..    .     .  .      . ..        .  . .    . .   .            . ..  ..     . .
...  . ..  .      .    . .    .    .        . S..  .       .   .        .       .      .   .     .     . . .        ..   . .    .       .
.  .      ..  .   .  .        .  .    ..     .    . .  .. . ..    . ..             .         ..     .   .  ...    .  .    .   . .    .. .
.   ..      .       .            .  ...                . .     ...         .  . .      .      ...    ..      .. ..           .   .. .   .
.........................................................................................................................................
