................................................
.      . .   .   .            .     ..  .  . . .
.         .. ...     .            .      .     .
.. .   .   .                  .   .     .   .  .
.       .   .            .   .        ..       .
.  .   ..      .  .           .  ..     . ..   .
.   X  .  . .         . .       .         .    .
. . .           ..  .      .       .  . . .    .
.    S     . . .    .                     ..   .
.           .    . .     . . .    .    .       .
...    ..    .    . . . .  .. .  . .     .     .
. .. .             .   .   ..       . ...      .
.  .            ..  ..        ..  .     .      .
.    .      .     .  .. .   . .  .. .  .       .
.      .    .       ...    .     .       . .   .
................................................
