............................................
. . ... .      . ....      . . .  .    .   .
.. .    . ....     .  . .     ..     .     .
.    .  .  ..        .         .     .  .. .
.            .       .X  .     .  .        .
.             .        .. ..      . .    . .
..     .   .. .     .  . .  . .      . ..  .
...     .  .     ...    ..   ..       .    .
.   .  .  .         . ..    . . .     ..  ..
.     . .    . . .     ..            .    ..
. .   . .   . .     ....   ..    .     .   .
.        ..   . .    .   ... .     .  S   ..
... .      ..    .    ...  ..   .    .    ..
. ..   .  .      ..   . .    .  ....  .    .
.  .  . .  .  . ..  .    ... . ... . ..    .
.  .   .          .      .       . .  . .. .
..  . .    .   . .  .       .  ..    . ..  .
.  .   .. .              .  ..      .    . .
.   .      ..   .       ..     . . .       .
.     . .  .         .          .          .
............................................
