.........................................................
... . .         .               . .         ..      .   .
.           . .                 ..     .         .     ..
.      .          ..     .                 . .          .
.  .         .    .   .         .            ..      .  .
..              ...       ..   .  ..            . .     .
..         .   . . . .     .    .           .   .       .
.      ...   .      .   .     . .     .           .     .
.  .  .          .   ...          .              .      .
.        . .       ..  .S                      ..  X    .
.        . .      .  .    .          .           . .    .
.     .      .         ..  .     .          . .      .  .
.........................................................
