.............................................................................
. .     .           .       ..     .                       ..          .  . .
.       .   .       .    ..          . ... .   .  ..     .       .        . .
.         .   ..       ..   ..      .    .          .   .      .   .     .  .
.    .  .       .  ..  .  . .   .  .   .    ..    .    . . . .       .     ..
.  ..            .     .      .             .   ..        .  .              .
.    .    . .           .  .                        .   .      ...  ..      .
.            .    .     .   .  .     .   . .  . .  .        ...        . .. .
.          . .   ..           .  .             ..       .               . . .
.  . .  ..   .   .        . ..    .. .   .    .          X        .         .
..           .         .   . .       ....                   ..      .    .. .
.    .         ..   .      .             .   .      .   .     ...    ..    ..
.  .    .   ..   ..   .       .  .         ...  . . .       S  .    .       .
.           .      .. ...     . .                    .      .  . .   ..    ..
.       .    .    .  .                     .      .   . .   .. .   .   .    .
.. .       .       .. ..         .  .  .    .            . .    .           .
.  ...      .            . .      .   .. .         . . .        .  ...      .
.    .                 .  .      .         .       .  .        .     .      .
. .  .   .                .       ..  .         .     .     .. .   ..   .   .
.     .      .     .     .                 . .  .    .  ..   .     . .    . .
.  .              .   .      .  .  . . .     .  . .                  .      .
.        ..  .        .    . .  ..  .  . .           .. . . .     . .     . .
.      . . .  .      .          . .   . .     .  ...    .        . .        .
.............................................................................
