..............................................................................
. .       .....  . .            . .. .     .     .     .  . ....         .   .
.. .          . ..    .. . ...   ..      .     . .     . . ..     .          .
..       .  X  .  . ..       . .  . .       .  .    ..     .      . . .      .
.     .    .           .    .      .        .... .             .  .          .
.  ..    .       . ..           .  . .     .        .  . .       .    .. . ...
.   .    .   .          .        .   . .   .. .         . .          .    .  .
..      ..      .    ..  . .  .   .   ..       .  . .       .            .   .
...   .           .   .     .         .      ...   .  .      .  .            .
..  .                    .     .. .       . . .. ....  .    ..     . .. ..   .
. .    . ...         . .. ...    . . ..      .     .....        .   .    .  ..
...      .       .   .  .   .  S   .     .     ..   .     .        .     .   .
.   . .            .   ..     .   .  ...     ..  ...  . .     .  .     .    ..
.   . .   .  .       ... . .  .    ..  . .    ..    .       .. .     . .     .
.  ..   . .  .         .     . ... .          .       .    .   ..  ..    .  ..
..       .      .   . .    .     .     .. ..             ..    ..        .   .
.    . .   ..      .   ... ...          .    ..      .      .      .. .   .  .
.    ..   ..   ..    .      .   .    ..         .    .   .  .            .   .
.    .   . .          .   . .      ...   .   .... .     .       .  . . .  .  .
. .  ..       .       .  .    .       .     .     ...         .         . . ..
.  .   .   .                 ..   .  .     .   .     .      .      ..     .  .
.   .   ..      . ..  . .    .. .       .      .    .     .   .     .        .
.         . .   . .          ..   .       .. . .   .      ...  ..  .    . . ..
.     . .. .. ..... .  .     . . .   ..  .  .    .          ..   .  .    .   .
.  .  .   .  . . ...                .     .       .  .  .        ..     .  . .
..............................................................................
