..............................................................................
...            ..   . .  ... . ..     . .       .  .  .      .          . .. .
..  .  .  .       .  .   .... .          .    .     . .  . .... .X .  .    . .
.        .      .  . .     .    .     .    .. .         .      .  ..     .  ..
.     ..   ...      . . .      . .      ..     .    .   ..    . .  .        ..
.              ..  . .  . ... .    .. . .   . .   . .   . . ..  .   . ..    ..
...    .   .           .       .     .               .    . .       .        .
..   . .    . ..        .. .      .  . ..      .   .  .   ...      .S ...   ..
.      .   .  . ..   . .   .... .  .    .. . . .  .. .   ... .. .. .   .    ..
.. ...   .    .  .. .           ..   ..       ....    . .       ..           .
. ..            . .   .          .   .   ...   .. . . . . .. .    . .        .
. ..  ..     ... .. .  .  .        . ..       ... . .     . . .   ...   .    .
.    . . .  . ..  . .  .  ..  ...      ..         ..      .   . .    .      ..
.        . .   .     . .  .   .   .   .  .  .. ..  .     ..    . .   .    .  .
...  .. ...     .  .        .   ..  .  ..   .  . . . .       ...   .  ..  .  .
.    .   .  .        . .   .   ...  .    .  .  ..   . . .    .   .. .  .  .. .
.  .    .     .     . .   .   .    .   .  ..    .     . . .   .  .   . .  . ..
.. .  . . ..        .   .    .    . .   .      ..   ..       .  ... ...      .
. ..    .    .  ..         .   . ..   . .     .   .      .               .   .
...   .. .  ... ..   .  .  .  .     .           .    .       . ..    .   .   .
.   .   ..  .  .. ..   . .        .      .. .. ..... ..   .   .     . .  .   .
...            . ..     .   . . .   .      .  .              ..     .      ...
.   .  .     .    .. .       ..      ..  .    .   .        ....  . . . .    ..
..............................................................................
