.......................................................................................................................................
. .      ..   ..       . ..   . ... .      ..      .      ..    ...          .  .  .     .         .. . ...  . .        .    ....     .
.. .  ...  . .    ..  ..  ..        .    . .      .     .    . .   .. . . .    .   . .    .        . ..        ....    .   .       .  .
....  ..  .  ...  .  . . ..   ..         . ..  .           . .       .    .       ..    .    .                ...   . .    .    .     .
...      .     .    .  .  .    .. .  .        .  ....  .        . .       ...      .  ... .   . . S          ..   . ..     ..     .  ..
. ...       .  . ..    ..         .   .. .  .                  .  . .     ..  .  ..  . .   . .   .  . .  .         .. ... . . .       .
. . .     ..     . . .   ...   .  .          .   .  .    .       .   .   . . .           .     .   .    . .  . ..       .    .. .   . .
...  ..  . ..         . ....         .        . .. .    .  .     . . . .     .  X     . . .        .  . .  .  .   .    .     .   ..   .
..  . . .   .    ..         .   ..  .    .. . .   .       .    .  .      ..              . .  .  . .   .   . .   . ..   .  .    .     .
.  .. .           ... .    .     .  . .      .        .        .    . ...  .  .     ..    ..        .    . . .    . . .. .        .. ..
. ..  ....  .   ....      ...      .  .    ...     .  .   . .. . ..       .   . ...     .     . ....... .        . .  .. .   .   ..  ..
......  .   .     .  .      .....  .  .   ..      .       ..        .   .     . .. .    .    ....  ..   . ..  ..   .  .          .    .
.......................................................................................................................................
