........................................................................................................................................
.      . .      .               ..                     .   .        .    .      .                  ..  .        .    .        ...    . .
.        .  .     ..  .     .      .    .              .   ..                    .    .   .  .           . .     .     .    .    .  .  .
.   .  .              .         .  . . .   ....       .    .        .                  .    . .       .         . .                    .
.  .   .   .     . .           .         .     .       ..  .             .   .             .     .                  .                . .
..    .            .      .                             .             .       . .      ..                  .              . ..         .
.         .. .    .    .  . .           .    .         ..                     .  .       . ..  ...                        .   .        .
.            .                                      . .               .                      .  ...         .         .          .     .
.         .         .    ... .    ....    . . . ..      .         . .   . . .       .       .        .      .        . . .       .     .
.  .           .     . .      .        .            .     .         .   ...          . .            . . .     S                     .  .
. .          .       .   .               ..       ..   .        .    .   .   .   .     ..    .       .     .            .     ..      ..
.         .     .      .    .         .              .       .                .        .         . .    .           ...    .      .    .
..      .       .. ..   .   .  .                    .   .                   .            .         .     .    .      .    .            .
.                      .    . ...       .  .             .  . .   .   .  .       .    .   ..   . .    .              .    .          . .
.            .    .          . .          .     ..          .   .    .       .                  .                .    .        .  ..   .
.     .     ..             .     .. .  .   ..     .                .    . .      .     .   .        .   .                           .  .
.      .          . .           ..          .   .      . .   .      . .    .         .            .                         . .       ..
.           . . .       .                   .                          .    . .   ..          .    .      ..       .           .       .
.      .  .            .  ....                        .. .              .             ..        .     ..  .    . .      .    .   .     .
.   .     .  .  .   .    .                 .   .              .       .      .     . .    . .                              . . .       .
.     .                              .     . . .              .  .. .       .     .   ..        .     .         .      .  .  .         .
.    .     .  .     .    .        .                        .       .. .          .         .    ..            .    . .      .   .      .
.  . . . .    .    .              .                .  .              .                .  .      ..    .            .   .    ..    .  . .
... .    .       X        .     ....    .      .        ..                      .... ..    .           .        .   .   .   .     . .  .
.        .          ..               . .   .       .       .               ..  . ..    .                ..     .            ..     . . .
..   .   . .      . ..   ..    .  .                    .    ..    .          .        .. .     .     .           .     .    .          .
........................................................................................................................................
