............................................................................................................................................
. .     ..   .  .            ...  .       .      .   ..      .  .     .       ..           .    .        .   .  ...               . .      .
. . ..  .     .       .   .  ..       ..                  . .. ..     .   .  . . .  .    .      .       .  .     . .             . . .     .
.    ..      .    . .    .  . .         ...           ..        . ..    .    .           .   ..  . .           . ...  .   .       ...   . ..
.   .       .   .     . ..       .  . .  .  .               .    .  .    . .     .    .        ...   .     .     .       .              . ..
.       . . . .       .   .                      ..  ..                .  . . . .     ..          .    .   .   ..  .  .      . .     . .. ..
..     .       .         .  . .    .  .. . .        .    ..       .     .  .  .    .  .    . ..     . .    . .                       .     .
.  ..            ...     ..  ..  .        . .  .     .    ..    ..     .            .               .    . . . .  .   .. .      .          .
. .   .  .        .  .       .   .   .  .  . ...             .        .     . . .   . .  .  ..     ...     . X           .      .     . .  .
.      .   .    .  .      .    ..    .  . .    ..   . .           . ...  .     .  .    .  .  .   .            . .   S...  .. . ..    ....  .
.     . ..      .  .    .       ..   ...    .  .     ..        . .   ..           .  .             .     .        .   .  ..  ...     .     .
.  .   . .      .      .  ..   .     .   . .        .   .                 .   .  .      .    .  .   ...        .  .          ..    . .    ..
.      . ... .    ..          .    .     .    .  .      ...  .            .    ... .  .         . . . ..  .    .       ..   ..    .      . .
............................................................................................................................................
