......................................................................
. ..   .    . ..   .         . .. . .     .             .  .. .    ...
.  ..  .  .    ..        .. ...   .  .            .  .      .        .
. ..       ...  .   . . .  .          .  ...  .S . ..          .  .. .
.       .            .            . .  .  .   . ..    ..   ..    .   .
.  .. .  .  .  .             ..        ....      .. . .     ..    . ..
.          .   . ..   .      . ..  .     .. .    .. ..        .      .
.  . . . . .   ..       ..  . .   .    .     ...    ...    . .   . . .
.    .   .       .    .   .   ..          ..        .   ..    . . .  .
.  .     . .  ... .        .     ..  .   ..      ..  .     .      .  .
..      .    .      . .               .  .     ..  ...          ..   .
. .          . .            .    . . .  ..   ..  ..        ..    .  ..
.     ..  .       ..... .  ..      ..   . ...  .. .   .. .    .  . . .
.      ..  .    ...  ..         ..  .           ..    .. . ..   .    .
... ..  .   . . .  .  .  .     . .. . .  .  ..  .        . ..    .   .
..             .  .    .     .  ..        .                ....      .
. . .         ....      . . .     .  .   .  .      .    .        .   .
.        . .. .   ...   .    ... .  .      . .   . .  ... .          .
.     . . . .     .  .  .  .  .   . .  .     .   .        . .  .. .  .
.   . .. . ...   .  . .  .  ..   . . .                ..  ... .      .
.      .    .    . .        .      ..   .   ..   .  ..  . . .        .
...       .   . .    .   .  .    .  ..  .    .     . .      .    .   .
. .    ..         ...     . .    .     . . .X .   .                . .
.     . .  . ..  ..  ..     .  ..   ..  .   . ...   ..    .. .   .. ..
......................................................................
