.............................................................................................................
.    .           .   .       ..     ..    .       . .    .              . .      .. . .   .  .    .. ..   . .
.             .                  .    .  X....         .      ..  .  ..  .      . . ... ..  .  .        ..  .
.       .      .  .        ..      .     . .  . .  .  .   . ..  .                   ..      .     . . .     .
..          .     .    .  .  .     .. .  ..    .   .  .. .          .           .          .   .            .
..  .                   . . ..   . .               .. .     ..     .      ..    . .    ..      . .          .
.. .. .    .        .   .   .   .  .   .        ..  .      .    .       .     .   . .   .  .     .   . ...  .
. .      .      .   . . .                     .    ..     ...     .       . . ..     .      .             . .
.   .   .   ..   .   .       ..         .       .. .  . .                                ..  .           .  .
..   .             ..        .  ... .    .                      .     . .   .. .       ..   .        .  .   .
.      .      ..     ..      . .          .        .    .       ... .  ..   .          .              .   . .
.     .   .    .  ..   .   .  .         .  .     .  .       .  .   .  .            .   .         .  ..      .
.    . .          ..      ..      ..   .   . ..  . .        .    .              .  ..   .        ..   . .   .
. .   ...     .   .       .  ..     .            .  .         . ..      .       .  ..   ..  .  .     . .    .
.        .          .      . .       .         ..  .   .    .   .  .     . .  .  ..              ..       . .
.       . ..  .      . ..   ..    .      . .            .                  .     .     .     . . .  .   ... .
.  . .  . .          .. .  .                 ..      . .   .   .       ...                 .  .             .
.   .  .       .      .  .    .     .    .         .       .  ...     . .   .            .  .  .        .   .
. .     . .  .      .    .        . .        .      .  .      . .                              . .    ..   ..
.           .  .       .     .           .      .  .    .S  .   ..      ..           .    ....  .   .       .
.   ..      ...     .     .   ..  ..   .        .        .   .    ..  . .   . .       .        .            .
.       .             .     .         .      .  .                 . ..            .  .       .. .     .     .
..            ...     . ..  .    ..                  .        . .  .      .  ..    .   . ... .           . ..
.  ..        .     . .   .  .  .     .   .                .. ..  . ... .        .     .                 ..  .
.  .  ..   .             .     .     .   .    . . .     . .. .        .   .  .      ..         ..       .   .
..            .                   .       . .      ..    ..       .         ..    .       ..    .   ..  .   .
..      .        .  ..  .    . .      .     .  .   .   ....  .                .    .         .     . . .   ..
.        .         .     ..  . .     .  ...                           .     .     . . .    .         .. .   .
.              .    .  .                  .      . .  .     .    .  .           .      . .   .   .         ..
.............................................................................................................
