....................................................
.       .         . .    . .      X..      ...    ..
... ..   . .   ..    .        ..  .         ...    .
.  .           . .  .. ..     .      ..         .  .
.     ... ...     .    .  ..  .  .   ..        .   .
.   .  . .         ..... .. .        .   . .  . .  .
.   .. .. .  . .  . . .  . .  .  . .    .          .
. . .    ..  .          .      ... ..    .    .    .
...     . .        .. .   .  .  ..  .              .
.  ....       . .  .    ..        .     .   .    . .
. .           . . .. .    .         .         ..   .
.. ... ..   ..   .  ...   ..  . .        .   . .....
..      .. .  ..     . .    .  .     .. .  .       .
. . .           .  ..    ...  .     .    .. . ...  .
..       ..  ..  ..  .       .  .   ..    ..      ..
.    .     .          .  .  . ..          . . . .  .
.  .  .  . .  .... . .  .     .  .  .... . .   .  ..
.. .... .  ..  . ...           .       .   .. .    .
.. .  .     .. ...   .      .        .. .. .   ... .
..  .         .       . ..  . ..  .  ..  ..     . ..
.  ..     . ..     . .   .. . . .. ..     S .. .  ..
..   .  . . ..    ..    . .          .   .. .  . . .
....................................................
