.....................................................................
.   .         .        .   .          .              . .  .         .
.       .     .                     .        S . . .    . . .   .  ..
.        .   .  .       .  . .   ..  .  .          .          . .   .
.          .          .   . .  . ..          . . .  .          .    .
. .  .         . .   .       .  . .            . . .   .  .         .
.. X .        . .                           .      .      .  .      .
.  .   ..       .    .  .   .     . .          .  .    .    .    .  .
.  . .         .    . .    .       .  .       .. ..       .     . . .
. . .                       ..       ..   .   .     ...     .  .    .
.      .       . ..  . .     .    . .    ..  .   .       .     .    .
.      .   .                   .     .      . .         . .   .     .
.   ..   .         .         .                   .  .  .  . .       .
.            .         . ..   .         ..  ..           .          .
.        .     ..         .           .          .                . .
.        .     .            ..   .               .     .   . .      .
.               .    .     .    .                  .  .  ..     . . .
.   .     .     .           .  .    .                 .   ..   .    .
.....................................................................
