......................................................................
. . .   .   .  .. .  .   .   .      .   ..  .   ..          . .. .   .
.          .           ...  .   .. X..  .    .   .      ..   .   .. ..
....  ..      ..       .  .       .       .   .                  .   .
.    .. .        .  .      ..   .  ...   ..  ..    . . ... ..     .  .
.  .   .           .  . . ...        .   .. . ..  .      ..     ..   .
.    .       ...       .           .... ..        .   .        ....  .
..   .       .      ..    S.        .    .   .      .   ..   .  .    .
.  .    .       .          ...  .  ..  .  .              .   .       .
.      . ..      .....  ..     .     .        .    .  .   .     ..   .
......................................................................
