...........................................................................................
.                . .                    . .   .       .     .   .                         .
.      .    .       .    . .  .     .        .                       . .   .  .   .   .  ..
.        .                      .   .  .              .   .  .              .   ..   .    .
.   .      ..       .  .        .                  .         ..  .     .   .          . . .
.        .       .            ..                          .               . .   .         .
.  .    .  .      .          ..                    . .    .       ..      .    .          .
. .                .    . .      ..    .     .  .       .        .  .                     .
.    .             .                       .   .                                       . ..
.    .    X                 .. .  . .             .    ..      .      .       .  ..       .
.              .       .  .       .   . .                    . .    .     .       .   .   .
. .                   . .  .            .            . . .   . .          .       .       .
..    .                           . ..       .        .     .                             .
.   .   .     .     ..                                 .  .        .      .    .    .    ..
.    .      .   .  . .       ..                       ...  .           .         .        .
. .  .         .           .            .         .    ..  ..        .          .         .
.      .      .           .                    S ..       .     . .           . .     .   .
. .    .                        ...        .        .    .     .                          .
.                       . .  ..    .                                  . .  . ..         . .
.                    ..  .                                                             .  .
.    .    . . ..    . .     ..    .           .   .        .        .   .   .   .   .     .
. .       .       .         . .         . .                .           .     .   ..       .
.    .          .   ..       ..      .    .   .           ..      . .     .    .  ..  .   .
.   .   .    .     .  .     .      ..        . ..              .                .        ..
.         .     .            .    .       .           .   .    .    .   .     .           .
.           .   .                .      . .     . . .      .    ..            ..   .. ..  .
.      .     . .    .     .        .  .   .  . .       .  .  .                            .
.     . .   .        .       .      .    .    .   .     .   .    ..  .     ..     ..     ..
..                         .   .        .           . .         .              .  .   . . .
...........................................................................................
