...........................................................................................................
.    .                 .          . .   . .   .  .. .     .         .   .  .  ...             ..    .   . .
.                      .. .    .      .  .    . ..      .  .    . . .  .     .. .               . .    .  .
.  .    .             .  . . S       .           .  .  .         .     ... ...  .      .         ..   . . .
.    . .. ..  ..   .                      .   .                  ...       .         ..    .     . .      .
.   ..    ..   . . .            .    .  .   ..    . ..   ..    ...    ... .     .. .          .     .     .
.      .        . . .      .   .              . ..     .   . ...   .  .     ..  ..             .       .  .
. .     .                    . ..    .  .                           .  .   ..        ..   .      .    .  ..
.  .  .                .    .         .      ..              .         .   .                ..  .     ..  .
. .          . .    . .        .    .     .      . ..                        .. ..  .    .. .     ...  .  .
.   .   . ..   .  .  .       .                   . .  . .               ... .   .  X  .        . .       ..
.   .    .   .   . .     .  .             .   . .  .. . .      .       .. .     .              .          .
.          . . .                .     .    .    . .   .   .         . ..                         ..  .    .
.   .      .  .     .    . . .    .        .    .        .  . . .  .  .      . .    .      .   .    .     .
.  .      ... .   .         .   .         ..          . . .         .           .  ..             .      ..
...........................................................................................................
