...........................................................................................
.   .   . . .  .             . .  .   . .  .     .       . .    .  .  .   . . .. .. . .   .
.    ..       ..   .  ..    .  .. ..                  .  ... . ..           .  .     ..  ..
.. .   X    .  .      .     .          ...    ..   ...    .        .  .               .  ..
. ... ... ....      .. . .  .         .. . .         .  .  .        .  .    . .. .   ..   .
..    .. .. .    . .   .    ..     ...  .     .  . .  .         .               .     .   .
.              . ..    ..   .. .      .     .    .   .       .  ..         ..             .
. .    .           . .        . .   . . ..     . . .  .          . .  ..       ..    .   ..
..      ...... .. ..  .    .  .      .    . .    .    .      .... .. .  . .       .S.. . ..
.     .  ..  .     ... .  ..          .     .    ...       . ... ..  .  .         .  .... .
. ..      .   .    .     .  .     . .   . .  .  .. .. .... .   . .....       .     .     ..
...  .  .          . ... . ..  .  ..    ..  .   .  .   ..       .     .     . ..  . .     .
.  .   . .   .         .   .      .         .   .         . .     .    .          . .  .  .
..     . ..  .. .   .    .. ..     ..                  .       .    .. . .    ..   .      .
.    .   .      .  ..   ..    .   . ..   ..         .    .     .     .     .  . .   .     .
..    . ..    .... ... .        ..      .         .    . ..         . . .    .        . . .
.. .  .  ..   ... .    .     .     .... .  ... .          .     .  . . .                . .
.         .        .   . . .    .  . ..  .  .. ..        .           . ...            ..  .
..  .    . . ... .. .  ...  .. .                .  .  ..  .  ..  .    ..   ...   .   ..   .
. ..         .   .  .  .  .    . .    ...      .    . ..      . .. .. .  . .      .      ..
... .          .   ..        .   .       .  . .. .       . . . .       .   .  .     ..   ..
.  .  .. .           . .  .   ..   .    .   .     .          ...        .  .         .   ..
. .          .     ..  ..    ... . .   ... .  ....    .        ... ..     .         .     .
..   .   .         . .      .     .   .     .   ..  . ...  .   . .     .     .    ...     .
.. .     ..  .  . .        .  . ... . ... . .. . . ...  . .      .   .  .  .    . .       .
. ......  .         .    .   ..... .        .   .      . .  . .. .                ..   .  .
.    .     ..         .           . ..       ..            . ..    ..             .  ..   .
...........................................................................................
