.................................................................................................................................
..   .      .     .  .               ..      ..    ..  . . . .      .    .. .                        . .  . . .   .         . . .
.   .           .     .. . .  .   . .       .       .    .    .         .....    . .  ..   .. . . .         .  . ..     ..    . .
.    .   .   . .    ..      .     ..  .   .. .  .  ..     .   .   .       ...   ..    .   .   .    .        ..       ..   ..   ..
.   . .          . .. .      ....  ..   .      .    ..    ..  .    .. .. .          ..  . .. .        ... .    .. .      .      .
.   .    .           ..... .  . .  . .  ...      . . .         .   .         .      . .    .    .  .    .    .     . .          .
.     ..          ...       .       .   ...     .       S. .    ..  .     ..   .   . . .   .          .   ..  ..  ....    ..  . .
.                     .  ... ...          . .    .               .  .   .          .     ..   .   .  .  .         .     .       .
. .       .   ...     .                   .                        .  ...  . . ..      ..      ..    ... .   .        .         .
.  ...            .  ..    . .   .  .          .       . .  .     .      .     .    .   .      .        ..    .  .   ...  .   . .
.      . .       .  .   ..     .   ..  . ...     .     . .        .  ..      .   .          .     .  .        .   .       .  .  .
.       ....  .   ... .  . .       .   .  ..  ..   .    .      .   . .       .        ...      .   .    . . . . . .      ... .  .
.  . .      .                          .            .  .  . .      .  . .     .            .  .          . .    . .             .
.. ..      ...     .       .    .   .      .  .   .  .. .   .. .     .     ..  ...    .. ...   . .   .      .  .      ..      . .
.   .  .       .        ..        .    .          .   ..  . ..            .. .      . . ..  .   ..          X  .   .  ..      ...
.     .    . .       .    . .      .   .            .       .          .    ...  . . .     ....    .       ..         .         .
. ..       .            ..  .  .   ..    ..  . .   .       .   .           .. .  .. .     .     . ..  .   ..     .  .      .. . .
.         .. . .      .   .. .. .     ... .      ..   .  .     ..      . .        ..      ...   ...  .    .... .  .   ..   .    .
.  . .   .         .   .  .  ..     ..   . .  .. .   . ..  ..  . .  .   . ..  . .    .   . ....    .  .     .  ..    . . ..  .  .
.     .   .    .  .         .   .  .   .    .    .    .       ....... .      .     .   .   .    .... .    .      .        .     .
.. ..          ...  .. .. .          .  . .         .                 .  .    ...  .    . .     .        .      .   .           .
.        .              .   . .     ..      .  .   . . .. ... . . .    .    .     .   .       ..  .  .           .         . .  .
. ..   .      .  .       .  .....     .  ..          . . ....   .   . .     ...    . ..  ...   .  .         .            . . ....
.      .....               . .      .     . ..   .    .  .    .. ..  . ..   .   ..  .   .  .              .  . .     ..         .
.................................................................................................................................
