......................................................................................
.         .  .. .  .   .  .     .      .        .        . .          . .. .  .    . .
.    .     .   .      .    ..      .               . . . .    .                .     .
..        ..          .        .                       .  .  .       ..              .
.  .    .   ...  ..           .   . .               .    . .              .          .
.     .  .   .                  ..      .      . .             .. .       ...        .
.     . .  ...    .  .  ..   .   .       .      .   .             .  .       .       .
. .          .                        .   ...         .        . . .       .    ..   .
...    .                 ..   .  .  . .   .        ..  . .      .       .            .
.     ..   . .         .  .       ..  .   .         .   . .       .     .  .         .
. .      .         . ...    .        X.      ..      .   .        .   .. .           .
.  .    . .   ..  ..             . .                          .  .        .     .    .
.  .       .     .              .    .     .        .  .. .  .                 .     .
.     . .       . .      .      ...    .        .. .        .  .  .      .          ..
.                .          . .     .        ..  .      ..  ..   .    .        .  .  .
.  ..       .  .  .  ..   ..         .            .       .               . .     .. .
. .      .     .        .... S     . ..   .  .     .               ...               .
.   ..    ... .  ..          .                  .      .  .  .      .  .             .
.              .   .      .        .   .          .  .      .        .       .       .
.    ..  . .        .   .          .  .  .         .     .                     . .   .
......................................................................................
