..............................................................................................................
.     .      ..  . .       .  .       .      .   .    .       . . .    .       .    . .     . ...   . ..  .  .
. . . .  . .    .    .           .    .   . .   .       .   .    .   .   .  .  .                .. . . ....  .
..  . . . .        .       ..     ..                      .      .  .        .   .. . .   .        .  .    . .
. .  . ..  .  .       . .. .       .      ..  ..     .   . .  .      .   . .S  .   .   .  .     .. .   . ... .
.       ..  .   .           .      ..    . ..    . . ..  .      ...    . .          .    ...             .. ..
.   .  ...X . ..   . ....        .   .  ..                    .  .  .  . .      .          . ...  .   .... . .
.  ..            ..   .           .           .                  .  ... .    ...  .   ..  ...       .  .     .
.     .    . . ... ..     .          .   ..     .  . .     . .   .    .       .  . .       ..      . ....  . .
.. .     .  .       ..     .       .. . .  .  .       . .  ..  .    .  .   .      ..   .  .          .   ..  .
..       .        .. .    . .. .. . . .  . .  .   . ....  .   ..       ...           .. ..  .. .. ....  .   ..
. .. ..  .   .     .   .    .  .  .             .       ..  .        ...       ...       ..   .    .   . . . .
.   ..               .        .  .   .   . .  .    .    .   . .   .. ... .      .   . ..  ..     .    . .   ..
..  .     ..  . .   . ..  ..       .  .     .. . ..  .      .  . .  .. . .  .. .  .            . .. .       ..
..    .     .     ....          . . ..   . ..  .      ..    ..       . . ..               .      .  .        .
.   ..        .... ..    .               .      .    .    .   .   .         .   .       ..    . . .       ....
..............................................................................................................
