.........................................................................................
.     .   .    .         .    .             .  .    ... .        .        .             .
.             .  .            . .         ..      .   .     .     .      .              .
..   .    .                                                       .         .        .  .
. . ..                       .                       .  .  .             .      .       .
. .                .         .           .                 ..   . .    .  .    . .      .
.  .                       .S.     . .                      .  .   .          .         .
.         .                                  .                    .          .          .
.                        .  X                       .                      .     . . .  .
.          . . .     .                                 .     ....      . .    .  .      .
.                       ..            .   .   .         . .      .       .              .
.  .                  .              . .           .                                    .
.          . .                                  .     .   .                   .         .
.             .   .  .  .     . .                              .  .   . .   .   .       .
.   .            .    .                            .                  .   .             .
.     .         .   . .            .               .                .    .            . .
..         . .     .    .      ..     ..                       ..  .     .        . .   .
.                .     .         .       .               .                    .  .      .
.             .         .                 .      .                               .      .
.    .  .       .           . .     .          .            .. .     . .             .  .
.........................................................................................
