.................................
.         .   .     .  .      ...
.    .     .    .  ..    .      .
.     .      .  X   .     .     .
.                         .     .
.  S.               .     ....  .
.  .      .                     .
.     .     .           .       .
.                   ..  .    .  .
..              .      . .   . ..
.      .          .        .    .
.................................
