........................................................................
..  .   ..         .    .          .               .   .        .      .
.  .   . ..          .               .        .      .     ..          .
.   ..   ...   .           .   .                    .    .   .       . .
.    . .    ..           .     .  .     .   .      .    .         ..   .
.  .  .   .     .   .S                 .      .  .   .            .    .
..    .        . .   .  .    .  .              . ..  . ..   . X   .    .
.      .. .    .   .      .. .. ..       .  .    .  .         . .      .
..    .  .  ..          .. .     ...  .  .    .           .      .     .
.     .  .     .   .      .       .  .    ..  .    ..  . .   .   .     .
.          ..   .   .         .                      . .   ... .     . .
.     .    .  .              .          .                    .       ...
.  .   .     .    .  .      .. .      .    .   ...        . . .  .. .  .
.                       . .. .             . ..   ..  . .  ..  .     . .
.     .           .  .  .             ..   ... .        ..         .   .
.    .     .   .              .     .   .    .       .       .  .      .
..     .     .    .     .. .     .   . . .            . .       .   .  .
. ..  .             .   . .         ..        ..   . ..    .           .
.    .     .    .  .                  .          .  ..         .  .    .
.            .     .    .     .             ...            .  . .     ..
.     .         .     . .         .  ..           . ..             . . .
.        .  .           . .    ..           .       ..    .    .  . .  .
........................................................................
