..................................................................................
.         S            .            .                       .   .  .   .    .    .
.            .  .               .   .   .        ..   .         . .       .      .
.                  .   .           .            .      .                    ..   .
..    .             .               ..     .             ..       .              .
.     .   .     .  .         .  . .       .       ..        ..        .        . .
. .   .                            .             . .          .    .     .   . X .
. .          .      .   .                      .                    .            .
.               .                    .    .      ..                  ..        . .
.      .         .   .        .   .            .            .    .           .   .
.    .         ..  ..  .    ..       .         .    .           ....             .
..................................................................................
