..........................................................................................................
.         .           .    ..  . .   . . .     .    X    .   .         .    .          . ..  .    .      .
.        .     ..  .   .            .       . . ..          .     .                   ..  . ....     . . .
.. ..     .  .    .      .   .  .      ..     .. . ...  ...  . .     .  ..     .      .     .  .         .
.   ..      .     .  ..        . ..           .   ...        .       .     .    .  .  .        .  .      .
... .     .    .      .   ..        .     .    . .         .    .             .  .    .  .              ..
.     .              . .    .           .   .   .   .                    .         .    . .       .  .   .
. .   .   .     . .     .   .     .   ..    .   . .   .. ..    .          .    .   .   .                ..
.   ..    . .  .  .     ..     .     .               . .    .     ..         .    .     .              . .
. . .   .            .            .    . .      .      .             .       .                    .      .
.S       .   .     .         ..     . . .                  ..   .      .       .        .. .             .
.  .        . .       . .  .        .   .        .          .. ..     .     .  .    .  .            .    .
.   .           .            .  .       .   .   .   .    .   . .          . .                  . .   ..  .
.     .        .    .     . .      .          .       .  .    .  .    .       .. .          . .        . .
.. . ..             .          .         .    .      .. .   .                                 .          .
.. .  .     .   . .        .     .    . ..  .   . . .      . ..   .    .     ...        .                .
..........................................................................................................
