.............................................................................................
.      .  ..        .                    .   . .    .                        ..      .    ...
.        .             . .      .    .        .  .      .   .     .                         .
.                .                        .           . . .          ..    .                .
..          . .                              .            .      .          ...     .      ..
..       .    ..  .       .             .                 .             ..               .  .
. .             ..        . .  . .               .     .     .     .   .   .      .     .   .
. .              .         . .         .             . .                          .     . . .
. .    .         .          .       .                ..                     .               .
.  .                            X.  .    .  .    ..   .              .       .          .   .
.              .   .  . .                 ...   .             .                      . .    .
.                   . .   .    . .  ..                       ..  .  .           .    .     ..
.     .   S.  .   .              .            .     .   .  .             .     .       .    .
.   .              .       .             .        ..  .  .       .             .           ..
.   .             .        .   .   ..      ..          .                 .             .   ..
.             .  .                  .   .  .             .     .     .   .    .  .    .     .
.   .     .    .    ..    .           .   .              .    .      .   .            .     .
.                       .  .  . .  .. ..  .         .          .                           ..
.  .   . .         ..   ....         .       .         .      .     .                .      .
.         .   .    . .   .               ..    .             . .       .                    .
.............................................................................................
