...................................................
. .   .   .  .   . .                           .  .
.   ..       .   .    .         .     .     .     .
.      .     .           .       .   .          . .
..            .    . .  X.  .    .      .      .  .
. .          ..     .     .    ..           .  .  .
.           . ..       .  .     .   S.  .  .   .  .
. .    ..         .       .         . .  .       ..
.      .  . .                .    ..   .    .  .  .
...         .    .        .     .  ..             .
.     .                           .           .  ..
...................................................
