...................................................................................
.    . . .   . ..                     .         ..   .  .    .   ..        .   .  .
.    .      . .     ..  .   .        .     .  ..     .   .     .  .           .   .
.        ..  ..         . ..          . .    ..    .     . .    .     .   .   . . .
.  .  .    .         . .            .               .        ..   .   . .    .    .
. ...  .  .    .  .      .       ...  .     .  .     .            .             . .
.          ..    .      .      S       .     .      . . .    .   .   .       .  . .
. .   . . .  .           .      .      .      .      ..    .  .     . . ..       ..
...    .    . .  .          .           . .      .      . .       . . .          ..
.   .      ..             .                  .         .     .             . . .  .
.   .         .. . .  .    . ..       .    .  .   . .    ..   .   .               .
.               .      .   .       .                .      ..  .      .    . .    .
...      .. .        .. . .   .          .      .        .  . ..       ..       . .
.    ..  ..        .         .  .     .        .            .      ..      . . .  .
..                          .     .      .    .  .            .      .   . .   .  .
..  .  . .          .  .    X .  ..  .    .                         .    .        .
.    ..            .          .        .          .     .  . .  . .. .    . .   ...
.       .   . ..    ..  .  .       .    ..        .        .     .. ..    .       .
.                      .    ..     .    .         .  . ..                      . ..
..      .  .         .   .       .   .   .       ..   ..      .                .  .
...................................................................................
