..................................................
.        .  .  . ..               .  ..  .      ..
. .. ..          .  .    .         . .      . .  .
.   ..  .                .    .  ..        .     .
.         . .       ....       .         .. .    .
..    .            .  .       ..    .. .     .   .
.  .  . .        ...           .            .   ..
..    .  ...     . ..         ..         .       .
.     .     ..   . .  .  .    ..       .     ..  .
.   ..    .  .    .    .    .. .       .  .      .
..   ...    .                   .        . .     .
.    .   .. .          .     .       .       S   .
.   ..      . .      ..        .    . ..  .     ..
.   .     .  .  ..  .       .    ..   .. ..     ..
.  ..    .   ..  .  ..      .  .    ..         . .
.   .   .  . .     .       . ..    .          .  .
.    ..    ...        ..  .   .   .   .          .
.            . .  .      X               .    .  .
.   .        .           .   . .  . .           ..
.       .           . . .    .  .    .  ..       .
.                 . .   ..      .  .  .   .   .  .
.             .              . .    . .  ..      .
.     . ...    .         .. .    .       . .  .  .
.         .     .. . . .       . .    .          .
.           .  .      ..  .  . .           . .   .
..                  .  .       .        .   .    .
..................................................
