.....................................................................
.     ..        . . .   .  .  .     .      .    . .   .       .  .  .
.   .  .          ..  ..        .    .           ...   . .     .    .
. .          .     . ...             .  .            .     .   .    .
.         . .     ..   .    .         . .   .        .       .  ..  .
.    .   .           .. .    .    ..   .     .   .          .  . .  .
. ...  ..  ..          .     .. ..   . . .   .   .  . ..  ....  S   .
. .    .     .  .    . .      . .   .   ...   X      ..  .   .     ..
. .            . .    ..  .   .  .   ..       .           . .       .
..             .. . .           .      .     ...       .  .   . ... .
.   .   .     .  .   . . . .  .   . ..        . ... .    .         ..
. . .        .  .       ..       . . ...  .   .                 .   .
.  .                   . . .     .  .  .    .     ..           .    .
..   .    .  .    .      ..    .        .    .      .. .    ..  .   .
..       .. .. ..    .   .....       .   . .. ....            .     .
.        ..    ..   .   . .          .  .  .     .  .    .  . ... . .
...  . .   ...    . . . .    .   . ..   .      .      ..        .   .
.                 ..           .      .       .                  .  .
..  ..    .  .  .  . .           .  .  . .           .         .. . .
..... .                 .       .   .  .    .. . . .      .. .   .  .
..    . .  .         ..                 . . . .    .. .  .    .  . ..
.    .     .  .      ..  .       .   .                  ...         .
.  ..    .      . .    .  .   .   .           .      . . ..   ..  . .
.  .      .  . .  . .        .....   .   .    . ..  ..  .  ..   ... .
..   . .   ..   .  ..          .  ...     . .. .      .    .        .
.  .      . .. ..        .  ...   .   .     .. .            . ...   .
.     ... ..    .   . .  .... . . .   .    . .        .   .   ..    .
.  .       ..             . .          ..    ..                .  . .
. . ... . .    .            ..     .. ..   . .   ... .. .    .   .  .
.....................................................................
