..........................................................
. .            .        .  .    . . .   .        . ..    .
.       S    .  .   . .   .     . .    .         . .  . ..
.  . .....    .  .  . .  .       .   .         . .  .  . .
.  ..       .   ..  .         . .  .  .  .      .      . .
. .         .    .  .  . .   .  ..  ..     ..      ..  ...
. .  . ...          .   X .  .     . .  .   . ...  .     .
..   .                  .   . .  .   . ...      . .      .
.    .      ..       .    .  ...    .... .     .  ..     .
.  . . ..       . .  .  .              .    .           ..
.   .   . .   . ..       .     .. .   .  .     .         .
..........................................................
