.........................................................................................................................................
.          . .    .                           .                    . .   .   .   .             . .     .    . .        ..  ..           .
.        ..          .          .      . . .   .    ..        ..     .  .            .      .  .                            .   .     . .
...    . .          .     .          .                .  .            .. .    .            ..      .          .         .      .        .
.          .                                     .    . ..     .   .                 .   ..       .          .                ...      ..
.   .  .                   .     ..       S  .               .     . .  .                .              .              .      .         .
.   . .         . .  .          .           .         .. .  .    .                       .. .      ..  .              ..       .  .     .
. .            .  .   ...     .                 .                      .          .                    .X           .   .               .
.                 . .    .                .     .               .  .       .        .          . .              .    .                  .
.........................................................................................................................................
