...............................................................................
.     .      .    .  .    ..  .  .            .               .   ...  .  ..  .
.          .  ..   . .           .           .     .     .    . .          .  .
..            . .  .     ..      .           . ..       . .           .. .    .
.                     .     ..  .      . .        .        ..  .      S       .
.         .       .           .               ..  ....         .     . .      .
.                 . .                    .             .  ...   .  . .  . .   .
..           .             . .    .     .  .  .  .    .   .             .     .
. .         .        .      .  .           .   .  .        X    .  .      .   .
.      .    .  .   . .              .      .     . .  .     .        .      . .
..  . .   .        ..      .        .          .                    .  ..     .
.    .   . .         .                 ..      .. .           .              ..
.    .  .  . . .. .                      .     .  .        .       .   .   .  .
.              .                  .                                         . .
...............................................................................
