...............................................................................
.                 .          .       .       . .    . . .             .. .    .
.          .    .         .  .    .. . .                              .  .    .
..            .         .                   .     .     .        ..           .
.           .                  .  .          .           .S       .           .
..                 .      .               .   .                               .
.  .            .                             . .                       .     .
.  .      .  .          .              .    .   .             X       .       .
..                   . .                 .               .  . .               .
. .                  .             .          .              .   .    ..      .
.        .  .        .  .   .  .   .                          .               .
.                 . .          .   .         .              ..  .    .       ..
.                . .  .  .               .    .         .                  .  .
..           .                                          .                     .
.     ..                  .  .  .     .  ...  .     .      .     .     .     ..
.                  .  .             .          .    .           .    .        .
...............................................................................
