..................................................................................................................
. . . .        .    .. . .  .              .      . .  .   .    .         . .        ..    .           . ..   .  .
.         ...   .  .   . . .     .     . .   .       .     . .  ..           .     . .    ... .       .       .S .
..   .      .. .  .  .      .       .     ..        .     .  .  .     . .   .            .          .   .        .
.    .  .                  .  ..      .          ...  .  .         ..... .  .  . .      .   .  .     .    .  .. ..
.  .   .    .   .....        .        ..  .        .    .              . . .       . . ...       ..     .   . .  .
...          .    .   .  .      .    .     . .          .    ..     .   .  .  ...     .   .     .             .  .
. .                   . .  ..... .                .  . .            .     . .     .                .    . .  .....
.  .    .    . .       . .  .         .        ..     .        ... .     .. .               ..      .    .  .    .
.         .        .     .  ..   .    .    .        .                 ...   .    .    . .     X. .     .   .   . .
.    .     ..      .                                 .            .                .              .  .    .      .
.          .. .        .          . .  . . .      .   . .  .              .    .      . .            .         . .
.        .     .            .      .                   ....      ...      ..             .        .  .  . .      .
.      .    . .  .   .   .                      .   .          ...                   . .      ..     .        .  .
. .     .    .  ..      . .                   .       .  .  .  .       .  . .... .           . ..  .       .     .
.    ..     .                   .       . .   .   .   .   .    .       .      .            .   .     .  .     .  .
..................................................................................................................
