...................................................................
.       .   ..   .. .       .     .          ..                 ...
.     . X . .            . .    . .    . ..       .        .  .   .
..  . .        .   ..     .         .   . .      .         ....   .
.  S            ..             .     .     .        .      .  .  ..
.         .   .      ..                      .   .    ..          .
.      .   .....           . ..      .       .     . .     . .    .
.            .        .           .      .. ..       .       .  . .
.         .   .    .. .     .   .      .    . . ..      .         .
. .           .     . ..    .  . . .  .  .  . .      .      .     .
..  .                         .    .      ..     ..               .
.              .   .         .   .       .   .  .     .        .  .
.    .  ..     ..              . .      .     ..  .   ..  .  .    .
...................................................................
