....................................
.        .....      .  .     . ..  .
.. . . ..   .     . .  .       .  ..
. .  . ..  ..       .  .   .  .    .
.    ... .   .  . .  .  .. ... .   .
..    ..    .  .  ...        .  .  .
.  .    .   .     .            ... .
.       .   .    .                 .
.       .      ..  .  .   .   .    .
. .   .  .     ..    .  .          .
.                . .        . .. . .
.     .                   .  .   . .
.... .     .  .  .      .     ..  ..
. .                   ..  . ...    .
.   . .  .. .  .     .   ..   .    .
.      ..    .  ..  .       .      .
.   . ....          .     . ..     .
.. .  .. .      .   .      .     . .
.   .  .  .  . ...         .       .
. ..    . .  .                   . .
.  ....  ..     .  .               .
.    .   .    . .     .   ...      .
. .          .     .      .   .    .
.            S .  .    .        . ..
. X  .   . .            .     . .  .
. ..   ..  .. .  .   .   . .. ...  .
....................................
