.................................................................................................
.  . ..  .      .       .        ..            .   .            .   .. .           ..   .       .
.  .     .   . .  .    . . .  ..       ..             .  .                  ..              .   .
.     .  .     .        .. .      .  ..          ..  .      .... .    .  .           .     .    .
. ... .          . .          .   .   . .  .    .  .  . .   ...   .  .           .    .   .     .
.. . .  . . .                 .. .. .        ..      ..  .     .   .                  ...  ..   .
.     ....        .     .           .      .   ..    .           .                   .   .      .
.     . .   .         . . .        .. .    .   . . .   . .     . .   ..   .   .      .       . ..
.  .         . .               .     .  ... ..      . .    ..       .    .         ..  .      ...
.        .  ..   . .       .    .      ....           .     .       ..  .  .    ..  .   .  .   ..
.    .   .    .      . . ...     .       .      .      . .             .. .            . .   . ..
.    .   .         .       ..     ..           .          .     .  .     .    ..        .       .
. .                       .   .. .  . .         .   .  .     .     .        . ..    .   .. .    .
.      . .   .   .        .  .     ..   .   .   . .    .  . . .   .. ..       . .  .    . ... . .
..    .                .      . .      .  .   .         . ..          .    .  .      .  .. . .  .
.  .     . .    .                 ..   .   ....      .    .          ..      .                . .
. X  .         ..  .  .  .     . .     .        .  .   .           ..      .           .    .   .
.           S  .  .       . .  ....       .      .  . . ..  .           .          .    ... .  ..
. .        . .  .  .     .                .     .    . ..       .  .  ....  .   .        .      .
.      .. .          . ..      . .  .   .    .    ..    .   .      ..             .     .      ..
.             .. .   ..           .. .  .   . .       . .               .                    .  .
..  .                . .        . .                 ..  .         .                .   .  .  .  .
.   .    . . .    .        .  .         .               .   .      .          ..  . ..     ..   .
.      .  ...   .            .            .     . .     .  . .       .    ..     .    . .       .
.  . .       .  .          .    . .  ..    .     .                                 .  . ..    . .
.   ..     .        . ....  .     .   .              .    .     .     . .  . .         .       ..
.        .      .               .   ...          .  . .  . .       .         .    ..     ...  . .
.        ..    ..    . ... .  . .           . ...        .          .  .    .  .       .  .    ..
.  .        .     .   .    . .             .    ..     .            .       ..        .    .    .
.................................................................................................
