...............................................................................
.   .. . .   .  ..  ..   .   .. . .      .   .... ..  ..    .   .       .     .
..          .   . .   .      .       . .    .    ..     .    .      .   .     .
.      . .. ... .  ....  .     .   .  ..  .  .    .   .        . .  ..  .  . ..
. . . . .  .  ... ..    .          ..   .    .    .  .         .  .  .   .   ..
.  . .            .. .  .   .     .       .   ..   .    .  . ..   . .   ...X  .
.      .    .  .. .  .  .   ...       .     .    ..        .    ...    .     ..
. ...     ......     ... .  .  ..         .    .      .. .   .              . .
. .    . . ..               . .  .      .    .    .  . ...      . . .     .   .
.... ..    .. . ..              ..    .     .. .  ..  .          ..    ...   ..
...  .    .     ..    .  .  .             .                 .       ..    .   .
.... .       . .    .   .      . .   ..             . .  .  ..    .      .    .
.   .  .   . . .    .... . .      .    ..       ..     .. .. ...    .     .  ..
. .    .         .. .    ..  ..          ..   .     ... .     .    ..  .  .  ..
..                  .. .    . . .. ... .   .  . .        .   .  ..  .  .  .   .
..  . . . ...          ..  ..    .            ....   .          ..   .   . .  .
. . .   .    .       . ... .. .  ..     .      .    .  .. .   . .   ..   .    .
.. ...          ..         . . ...         .   .        ... .  .  . ..        .
.     .    .S. .   ..      .  .              .. .   .   .   .     .           .
.  ..   . .      . .    .   .   .     .       .  ... .      .  ...   .    . . .
..   . .   . .       .     .         .       .   .. ..      .    . . . .      .
. .  . .  .         ...  ...  . .           . .    ..  .      .  .. .    .   ..
.   .    .    .   ..        ...... .. .   .. .  .    .  ..       .  .   .     .
...        ..         .   . .  . .. .        .  .  ..       .     .       . ...
...............................................................................
