..............................................................
.         .     ..  . .  .      ..   ...           .         .
.    .. . .. .   .    .   ...  ..   .       .      .       . .
.      ..   . ..  . ..  .     .           ....   .   .    .. .
.   .   .            .  .   .   ..   .      . .     ..   .   .
.  ..  ..   .     .  .          .    ..  .  ..   .... . .   ..
.    .   .  . .    . X  .. .     .          .    .    .     ..
.           . .     ..        .. .    .   .       .    . .   .
...           .           .   .    . .   .. . .. .   . S... ..
. .   .    .  . ..... .            .   ..   .     ..         .
.     .    .    . .  .     . .  .     ..        ...   ..     .
.    .  .     .          .  .     ...    ..   . .    .   .   .
..  .    .     .     .  ..                      .. .. ..  . ..
. .    .    ..         .   .   .. .   . .  .....    . . .. . .
.           .     ..  .     . .   . ...... .  .       ...  . .
.  ..  ..  . .   .  .  .. .......  .    .      . .           .
..............................................................
