.....................................................................
.        .      .            ...       ..        . .    .  .   .    .
.      .  ..   .. .  . ..     .  .   .      .     .  ..    .        .
.     .   .      .     .      . . .    .     .   .          .       .
...  .          .                    .        .         ....  ..    .
.  .         .    .    .  .             S.    .        ..    .      .
. ..     . ...  . .        .   .    .        .   .   .  .        .  .
.   .  ..     .                      .     .             .      ..  .
..             .. . .   . . . . .   ..              .      . .     ..
. .    . . ..      .   ...          .  .     .  .         ..  ...   .
. .         .. . . .   .    .       .    .      .. . .   ...  .    ..
.  .         .    .    ..    . .. .            . .  .     .    ..   .
.. . .   .     .      .       .   .       .         .    ..         .
.          .         X  .   .    .  .  .      ...     .       .     .
.  .  .       . .  .            . . . ..      .   ...    .    ..    .
.   . . .   . .. .  . . ..    ...  . . .  .  .         ..   .    .  .
. .    .   .     ... .           .... .  .      . .        ...    . .
.               .  .  .         .  . .  .        .. ..     . .    ...
.         .            . .  .     .   . ..    . .  .             ....
.   . . ..  .  . ...    ...  .    . .  . ...       . .  . .    ..  ..
.  .  .  .  .  .    .        .    .    . .    .      .    .. ...  ...
.   .       .   . .    .    ..             .         .  .         . .
.             .. . .          . .  .        .  ..  ..    .        . .
.....................................................................
