..............................................................................................................................
..                  .       ...    ...              .             .                     ..      .  .. .   .   .             ..
.   ..   ..   ..  ..    . .. .         . .                  ..  ...  .    .     .       . .       .   . .   .     .   .    . .
.    ..  .        .  . .  .      .. . .      ..      . ..   . ..      .              . . .  .   .     .           .. .    .  .
.   .      ..   ....  .   .      .                  . . .   .     .   . . ..     ..   .    .   ..  .  . .   .  . . .         .
.  ..            .          .                     .. .      .     .   .         . ..      ..    ..              ..       ... .
.   . .         .       .    ..            .         .              .    .. ..    .    ..       ..         . .   .    .      .
.. ..       .  .  . .   . .          .   .     ..   .     .      . .     .        . .   ..       . .  .        .   . ...     .
.  .     .   S. ..   ...  .         .        . .  .  .       .  .          .       .        ....... ...  .   .               .
.      .    .X . . . . .      . .   .     .     .  .   .            .    .        . .       ..    .    .  .      . .  .   .  .
.      .   .       .    . .   ..           .      . .     .. .   .      .     . .    .             .          .   ...      . .
.. . .    .    .  ..    ..       ..    ..    . .     .     . .        .             .            . .        .    .           .
.     . .   ..     ..      .    ..      . ..  .       .      . . . .          . ..    .             .. . .     .     .     ...
. .      ..             .   ...       .  .    .. .     .  .          .    . .  ....        .   . .           .       .     . .
.            .   .            ..  .                  ...  .         .  .  .  . .       . ..    . .   .    .       .   .  ..  .
. .     ..    .          .    .   .    ..     . .         . .             .       .  ...     ..    .   .       .       .     .
..    .    ..          . . .         ..     .          .         .  . .      . .   .   . .         ..  .       ..   .   . ....
. .. .              .  .              .  . . ..                .   . .               ...    .    .          . .       .   . ..
.  .  .            .        .       .                    .    .  .    .   .        . .  .    ..    .  . . . .    .      . .  .
..      . .          ..      ..    .   .  .  ...         . ...        . .  .  ..     .  .     .     .   . ..   .      .    . .
. .  . ...       .   . .      .    . .. .      .    .          ...      ..  .  .  ... .     . .  .       .  .    ....    .  ..
...           .   ..                       .. . .   .  .   .    . .            ..  .     . .. ..   .    .. .  .       .   .  .
..............................................................................................................................
