..........................................
.  .      .                    .         .
.                       .     . .        .
.   . . . .                .         .  ..
.   .  .     .  .           .   .   .    .
. .... .   .       .         X         . .
. ..     .        .    . ..  .   . .     .
.     .     .      . .       .   .    .  .
...     .    .          .          .   . .
.  .             .  ..     .  .        . .
.                         .   .          .
.    . . .  . . .           .   . .     ..
.         .  .  ..            ...        .
.       .. .   ...                 .     .
.  S       ..    .    .   . ..           .
.       ..    . ...    .                 .
.   .      . .                .         ..
.  .                 .            .    . .
.      .  .      ..                      .
.     .  .    ..  .        ..          ...
..          ..  .               .        .
.  .   .   ..       .      .  .    .     .
..        . .. .    .  ..      .     .  ..
...     .  ..    .  .  ..      . .       .
.            .    .                      .
.     .    .   .    . .  .    .    .. .  .
.   .             .   . .   .      .    ..
..........................................
