.................................................................................................
.       .        ..          . . .                                     . .   .        .   ..    .
.                    .                  .              .      . . ..   .  .         .         ...
.    .    .    .  .                        . . ..                  ..    ..  .                 ..
.       . .  .          .      .   .               .              .            ..        .  .   .
.   .           . .     .                            .    .            .             . .   X .. .
.            .    . .. .    . .  .   ..     .     .     .    .            ...  .            .  ..
..                       . .      .          .  .    .         .  .  .             .           ..
.    .       .                         .      .          .     .   .   .           .  .         .
.      ...   .            .  .          .    . . .      .    . .        .                .      .
.   .            .     .    .             .     .  .. .   ..   .   .   .          .    . .S.    .
.   .          .                  .                  .  .     .                   ..    .  .    .
.  . .        .   ..        .  . .     .   .        .      . .           .    .       .   . . ...
.................................................................................................
