..........................................
.  . . .             .  .     .      ..  .
..          .S..        .     . .    ..  .
. .. .      . .  .      .      .     .. ..
.      .  .    ...  . . .   .  .    ..   .
.  .           . .            . .    . . .
.   .           ..    . .    ....X.  .. ..
..    . .   . . .  .  .  .     .       . .
. .   ..   .     .. . .. . ..   ..     . .
. .    ...    .  .  .  . ..  .  .. ..    .
. ..    . ... .       . .    .     ....  .
..........................................
