.......................................................................................................
.   . ... .     .      . ..     .  .        ..   .      .       .         ..    .   .     .. .        .
. .          .  .   .    ..           .  . .              ..   .   .      .   ..     .       ..     ...
. .            . .                .   .  .   . . . .  .          .  .      .   .    .         .    .  .
.  .      .   .          .          .                   . .   ..       . .        .       .       ..  .
.              .     . .      .           . .         .     . ..   ..     . .               . .       .
.     .         .               .       . .       .   ..       .   .      .   ...     .   . .         .
.   ..      . .  ..    . . ..  ..   .   .. ..         ..           ..    . .           . ..         . .
.  .  .  . . .    ..     .S .                .  .      .       .          .        .   .  . .  ..     .
. .. .      .     .   .      .   .    .. .   .     ....       . ....          .     . .. .       .. ...
. . .   .       .   .     .    ..    . . .                          .      ..     .     .   .   . .   .
.           . . ..                       .     .   ....     .           ..    .   .  .    .  .  ..  . .
. ..   .. . ..    .     .    . .      .         .            ...             . .   .       .      .   .
.   .   .... .    ..      .   .        .  .       .           .....     . .    ...  .                ..
.        .            ..    .      . .        .  . .         .               ..  ..   . .   .       . .
.   .        .  .             .           ..       .     X.    .        .  .      .  . . ..    .      .
.          .      . .              .         .              .  .            . .. ..     .    .  . .   .
.  .     .  ..    .                      . .     .     .   ..      ..    .  .          .      .       .
.    .   .     .  .     ..    . ..               .    .     .  .  .   . ... .  .        .. .     . . ..
.  .        . . . .. ..        .          . .  ..         ..      .  .             .            .     .
. .  .    .   .          .      .                  .                 .         ..      . . ..    .   ..
.....     .    .   ...   .             .     .               .     ...  .   .  .   .    ...   .  . .  .
.         ..           .    .   .       .    .    . . ...                 .  .   .        .        .  .
.......................................................................................................
