.....................................................................................................
.        .     .             .      .          .                                                    .
...    .             .   .           ..      .       .                         .    .               .
.                       .                                                 .                 .    .  .
.        .    .            .      . .              .  .    . . .                                  . .
.                           .   .   .             .  .  .                     .  ...                .
.    .         .         .   .        .. .   ..    .               .                       .        .
.          .    . X    .                     .           .          .    .  .          .       .   ..
.                   .                           .       .   ..                 .  .                 .
.  .                   .     .  .   .     .            .  ..                                 .  ..  .
. .                 .       .   .   . .       . .                    ..                          .  .
.  ...                        .         . .      .     .     . .     .. .       .       .           .
.                  .       .  .                           .     .    .          .  .       . .      .
.  ..              .  .         .           .        .         .                                   ..
.  .      .    .   .        ..   .            ..   .      . .    .     .                            .
. .                     .        .           ...           .     .            ..      .      . .    .
.             ..   ..     . .              .           .    .        .              .          S .  .
.   .                     . .                    .                .      .        .                 .
.  .            .        .              .     . .  .     . .                      .    . .          .
. .   .   . .               .                             .              ..    .       .  .      .. .
.           .      .      .        .        . .     .         .       .    .        .      . .  .   .
.                       .     .   .          ..            .                            .           .
.                .              .       ..                . .   .           .    ..    .            .
.    .. .                               .      . . .                  .          .     .  .    ..   .
.....................................................................................................
