...................................
. .     .   ..      ...  .     . ..
.  .           .. ....      .. . ..
.            .   ...  .         . .
..    .     .          .          .
. .     .   . ..    .             .
..   .  .      .   .          . . .
..        . . .   .  .     . .    .
. .       .       .            .  .
.   . .   .    . . . .   .. .     .
. .   . .      .       .   .      .
..      .  .  . . . .   . . .  .  .
.     .               .  .       ..
...   .   .          ..        .  .
.            .   . X         .    .
..  .            .     ...  .     .
. .  .  .  .                      .
.     .. . ...                   ..
.  .     . .   .              . . .
.. ..    ..    ...        .   .   .
.      .               . .        .
. .  .    . ..       .  ...  .    .
. .          .     .   . .        .
.   .    ..  .  ..  . . . .      ..
.   .  .    ..  ...  . .   . .  ...
.          .  S    .    .  .      .
. ..    ..   ..        .     .    .
.. . . .     .   .       ..     ...
.        . .      .       .     ...
...................................
