........................................................................................................................
..    . . .   ..  ..         .    .  .   .    .    ..       . ..      .      ...     ..             .          ...     .
... .              .    .             . ..   .      ...   .           .   .           .          .    .   .  ..   . . ..
.   .    .    .         . .         . .    . .  .   .     ..       .   ..  .      . .  .   .     .  .      .   . ..  . .
.  . .           .      .        . .      . ..         .           .      .    . . .   . .   ..    ..      .      . .. .
..           . . . .  .      .         ..            .  . .          .    .  ..    ..         .    .  ..    .     .    .
.          .   .   .   .  .  . .    .                .   .. .   . .   .  .. .         .  . ...    ...    .    .   .    .
.  .     .   .  .  .  .  ..     .       .  .        . .   . .  . ..      ..  .     .      .                    .    .  .
..  .  .. .       .. .         ..  .    . . .    ..    ...                 .  .        ..  .  .   .    . .  .    .    ..
. .  .   .       .    . .  .          ..     . .          .       .    ..         ...  ..   .          .        .      .
.         .       .   ..  .      .            .     .   . ..             .   .        ..           .      . .    .    ..
..  .     .  .     ..      ..           . .  .      .. .      ..     .  ..   .   S    .     .       .  .    .  . . .  ..
.     .. .  .     .       . .  .      .           . .       .    .    . . ..      .   .  .      ...            .     . .
.  .         ..  .     .      .   . .     .  .     .  .    . . .    .       .       . .  ..     .     .  .       . .   .
..   . .. . .      ..            . .        . ...   .             ..        .  .          X .   .   .    .    .        .
.  .             ..   .       .     .   . ..  .    .    ..       .      . . .. . . . ..   . .....       .    ...       .
. . . .             .. .    .              .     . .    .          .    .     .     .  .   ... . .   .  ..   .   .  .  .
........................................................................................................................
