.................................................................................................
..   ..        ..   ..  .    . . .      .      .  ..    .  . .  .      .   ..  .. .  .     .    .
.  .  . .  .   ..    .     .  .  .     . .    .     ..  . .. .   .             .  . ..    . . ...
.  ..  . .      .         .   ..      .             .        .       . .     ...  .      . ..   .
.      .. .  .   . ..   .   . ..        . ...... . .  ..       .    .    .      . ..   ..    . ..
.      ..   .  .  .           .           . .     .         ..   .. . .  .    . .  .       .    .
.  .   .   . .  .  . . . .    ...   .. .   ..  .     . .            .    ..     .    .   ...    .
. ..    .. .        ..  . .   .     .   .  .      .. . ..     .    .    .. .  ..  ..  .   .     .
.      . .  .  .    ..  ....   .. . ..     .        ..    .   ..   ..  ..   . .    .      . . . .
. . .      .  .    . ...  .  . .  .          .   ..   ..  . ....S . .. ....      ....     .    ..
.   .. .... .. . .    . ..    . .     .   .  ... . .. .   X       ..       .      . .     . .  ..
.  ..                    ..          ..    ..    .  ....     ..  .  ..  .    .  .    ..         .
...  ....  . ..    ..  . .   ..         ......        .                 ..  ..    ... .   .    ..
..  . .  ..  .   .  .    . .    .. . .  .  ..  ..       . . .  .           .. .  .       ..  .. .
.. . .     .      .     .. ..   .   .  . . . ...  .  .      .  .        .  ...  .   ..    .     .
..  . .      .. . . ...       . ... .     .  .     ..    ...  .    .       .   .  .    .   ..   .
.. ...   .  .      .      ..                .... .  .             .   . .       . .    .      . .
.      .  .         ....   .    .         . .    ....    ..     .  .     . . . .      .   .   . .
.................................................................................................
