............................................................................................
.  ..       ... .. .        .                           .      .  .     . . .    ..        .
.        .   ..... .  .   ..    ..  . ...       .   ..  .                 .     .  .       .
.  .      .     ..    ...  .                                   .  .         .  .    .    . .
..       . .  . . .  .     . .   .  .  .  .  ...    .       .   . .    .               . . .
.     . .      .   .  . .     . ...    .  . .        .   .   .   .       .      ...   .    .
.              .      ..  . .  .   .          .   .                    .. .             .  .
.  .   .    .  .   .             .        .   ..   .   .  S                X .           . .
.                 .  .     .      ..     .  . .   .  .    ..   .         .      .   .      .
.     ..  .   .  . . .  ..              . . .. .    .   .  .       .        . .  .  .      .
..   ..  .      .   .   ..    .    .   .   .    .   ...  .   ..         ..   .         ... .
..  .   . ...  .   .  .      .  .                 ..  .   . .            ..   .  .         .
. .   .          .    .       . .    ..   ..            .     .      . .    .. .   .       .
.           .    .   .     .   ..               .     .   .. .     .      .   ..     .    ..
..  .  .       .           .         .             .  .  .  . ..    . . . ...  .  . .      .
.. .     . .        .. ..  .                     .     . .   . .  ..          .  . .  ..  ..
.  .   .            .     ..     .      ..   .  ..   ..      ..         ..      .  .  .  ...
...        .     ..  ..        .       ..     . .        ..      .   ..      .             .
.    ....  .      . .  ....   .       .. .   .          .    . .          .  ..  .. .      .
.   .         .     .  ...     .  .       ... .       .. .            .   . . .   .        .
.  .     .        .. ..  .   .  .      .  . .         .     .  . .   . .     .     . .. .  .
............................................................................................
