........................................................................................................................................
.    . .    .    .    . .  ...      ... .  ...    .  . .  .  .           .  .  ...   . . . .   .   ...         ...  .         . .. . ...
.      .     . ..    ..     .    ..           ..   . .     ..     .  .  .. . .. .   .  .    ..  .   .. ..   .    ..      . . ..       ..
.  ..         .    .  ..       . .  .  ....  . ..     .   .  ..  .     .   . .   .  . ..  ...         .  ..          ..   .  .. .      .
. .  . ..             ... .     ..     . .  ...                 ...  .   .   . .... ... .    ...     ...    ..   .    ..  .   .  ..    .
.       . . .. .    . . .  . .        .        ...  .      .   .        .   .   .    .  . .  .  .  . ..   .  ..  .    . .. . . .      ..
..       . .     .  ..           .. .  .  .     .  . . . .   ....      ..   .      ..     .   .  .  . .. ..   . ..        . .  .     ...
.     ... .    .. .. ..      . ..           .. .  .  .      .       .  .      . .    .        .     . .       .   .   .. .     ..     ..
..       .    .        .. .......  .   .        .        .  .    ..  ...  .     . .           .  . .  . .. .   .           ...  . . ....
.  ..    . .            .   . . . .   ..    .  . . . ..  . ..              .... .  . . ... . . .  . .    .  ..      ...  .       ..    .
.  ..  .      .    .    .  .    . .   .       .    .    .  .     . ..          . .    .      ..             .   .  ..    .    . X  .   .
.     .    . .       .   . .       .                 . . ..  .    . .   .  .      ..  . ..   ... .    .  .  .       ..       .         .
..   .       .    ..   . .  .    . ..   .     .   .  .   .   .  . .     .  .. . .     ...       .  . ...  . . .     .  ...    ..       .
..  . . .   . . ..   . .       .   ..  . .  .  . .     ..      ...    . .  . .   .   .    .      ..    ..   . .     . .  . .  . ..   ...
.  .            ..   .       .   ..   ..   . .  .       .. . .    .      ...  .     ...     . .   .      .      .. .  . . ..   . .     .
. . ...  ...  .    .   .    . . . .   . . . .       ...                ...   ... . .  . . ..            .    .       .           .. . ..
..    .    ....   .. .  .  .  .  . .. .    . .. ..  .    .   . . .  .    .     .. ... .     .      .      .   .. ..       .    ..      .
.  . . . ..  .    .  .   .   .   . .           . ...  . .      . . ..       . ..  .   . . .  .    .     .      .  . . .      .  ..  .  .
..    .. . .. . ..  .  .      .          ...    . ..     .  . .  ...        .   . . ..  ....         .      .      .       .    .    . .
.      .    .  .   .       . ..  .. . .    ..    . .       . . .        .        .    .      .  . .   . ....  .  . .   .      . ..  .  .
.... ...        . .   ....    .  .. .     .      ...  . ..           .  .   .        .                 .  .          .    . .  .   .. ..
. ..    . . .   . ..   .. .  .          .  .. .. ..  .. .  ..   .   ..   .  ..  .       ...            . .  .       .  .  ... ..   ..  .
.    . .      . . . .  .   .. ..       . .. . S            . .. . ...      . ... . ..      . .   .. .        . .. ... .. .             .
... ..      . .. .    .        ..    .  ..    ... ...  . ..    . . .  . . .      . ..    .   .        ...   ..       ..  ..       .  ...
........................................................................................................................................
