................................................................................................................................
.      ..   . .   . .      . .  .       .                 .  . . .  .    .  .        .       .      .. .    . ..  .  .   .   . .
.   .  ..       .    .     .              .  . . .            .   .      .             .       .     .  .         .   ...  .   .
. .  .  .    .                  .           .        . . .            . .       .  .       ..         .            .        ....
.                  .    .   .       .       .        . .  .      . ..      . . .         S                  .     .     .   .  .
..         ...    .    .       .  .   .      .            ..               . .   .      .. .. .. .  .                        . .
..            .   . .    ..   .  .. . .       .       .  .         .  .    ..                 .   . .           .      .       .
.      . .      .     .   .    . .              .            ...  .                       .    ..    .    . .   .      ...     .
.         .  .        .   .     .                          .   .   .             .   .   .   .    .   .            .     .    ..
.  . .      .         .       .      . ... .   . .   .   .    .       ..       .               ..           . .  .  .          .
.   .     ...                      .                      .     .             . . .      .   .       .  .     .         ..     .
.    .               ..      .     .  .   .         .  .        . .  .    .  .            . .  . .    .   .    .     .  ..     .
.         .      .      .   . .              .       .    .   . . .                               .   .       .          . .  ..
. .  .       .      . .   . .                   .  .      .  . .    . .        ..  . .    .  .    .     .   .  .  .       .. . .
.        .  .  . .              .      .   .      . .  ..       . ..    ..                                .    .     .         .
..  . .            X  .  .   .        ..       .        .            .        . .      .    .  .        .     . .    .  .     ..
.  .   .      .          ...      .  . .    ..               .    .      ..             .          . . . .  .                  .
.        .    .   .           .  .         . .  .                             .        ..  .  . .     .         .     .        .
. .  . .             ..      .              ..       .                      ..   .  .     .  ..        .   . .      .     .    .
. .    .      .        .... .       ..   .        .  .     . .  .     .            .. .  .       .     .       . .     .    .. .
.       .      .     .   ..   .   .     .         .         .      .         . .    .                . . . .   .           .   .
.     .  .    .              .             .   ..  .       .  ..            ..         . .       ..          .      .          .
.       .       .    . .        .  . . .          . ..         .  .      .    .   .              . .      .   .  .    .    . . .
.        .  .                    .       .        .        .  .         . ..        ...    ..   .  .         . .     .         .
................................................................................................................................
