..............................................
. .       .     .          .   .     .       .
.    .  .           .                 .     ..
.   .    .                   S               .
.       .                  .              .  .
.       .. ..                . .             .
.      .       .    . . .     .     .    .   .
..       .        .                    .     .
.    ..             . .       ..             .
.        .     .  ..   .        . . .       ..
.         ..            .                    .
.            .        .       .     .     .. .
.     .  . .            .     ..     .       .
.                        .             .     .
.    .   .    .  .    .              ..   .  .
.   X.              ..   .                   .
.              .   .             .        .  .
.        .                .  . .             .
..     .                  .    .        .  . .
.     . .           . . .     .. .           .
.        .      . .    .                     .
.       .   .    .          .        .       .
.           .        .         .   .    .  . .
..............................................
