........................................................................................................
.     .  .   .      .          .   .   ..  . .  . ..    ... ..      ..  .  ...      .    ..  .   ..   ..
...   . .      .          . .     . .      . .  ..  . . . .. .         .  .       .     .         .  . .
.    ..  . . . . ..    . ..    .   .  .... . ..  .  ..     ..   .      . .  .     . . ..   .           .
. . ..         .    .       .           .    ...   .   ..       .    . .  ..  . . .       . .    ..    .
...          ..  .   . . .. .    .   . ..   ...   ..   ..   . .           .      .            ...   .  .
.   .   .    .  . . .     .   .    . . ... .      .. . .   .  .  .       ...           .  ..           .
..  . .              ..           ..        .    .. . .  . .   ..   . .. .  .    .  ..          .      .
. .  ..   .     .        . ..    .          ..      . .  ..  . .. .. .        .  .           . .    .  .
. . . ..   ..   . ..  .                      .    ..      . .    ..                      .       . .   .
.  .  .   .  ..    .    . .      ..     .      . ...        . ..            . . X .  .   .    .. .     .
.  . ..  .    ..     .  .  .        .          .       . . ..         .      .     .   .    . .     . ..
. .   . .        ..   . . .  .        .      .. .         . S    .   .        ..   .          .    .   .
.  ..   .     .            .  .  .. .      .     .. . . .     .  .         .....      .   . ... .      .
.  ...   ..         .     .      .           ..        .               . .      .   .  . .  .   . .   ..
. .    .. ..    .     .  .    ..     .  ..   . .          ..  .         .  .    .    ..      ..        .
........................................................................................................
