..................................................................
.     .            .          .                 .  .    ..  .   ..
.          .      .  ..      .  .   .                S           .
..   .                               .     .  .                  .
. .         .    .         .             .    .           .      .
.    .     .    .            . .       .      .. .            .  .
. .                .         .                   .  .         .  .
.          .                    .                             .  .
.       .     ..      .     .    ...        .             .      .
.  .      .    .            .           .                        .
.....         .                             .           .      . .
.     .  .        .. ..        .  .  .         .              . ..
. .       .             .   .                          .         .
. .        ..               .  . .        .     .                .
..          .   ..          .  ....             .  .   .    .    .
.       . . .                . ..      X    .           . . .    .
.     . .      .                            .             .   .  .
.             .           .         .        .        . .    .   .
.        .   . .        ..   .   .                            .  .
.      .  .              . .       .              .  .  . .      .
..         .       . .         . ..         .                    .
.       .       .     .          ..   .          .               .
.                            .            .                .     .
.            .        .            ..    .                       .
.                 ..       . .                  .                .
.           ..        ..         .   .                 .     .   .
.          .     . .    .           .   .                        .
.       .     .       .  ..   ..  .  . . .   .       .           .
..................................................................
