............................................................................................................
.. .     .       .     ..    ..   .  .  . .          .   .   . .  ..     .      ..    .   . . .     .  ..  .
.. . .   ...    .X .   ... .. .  .       ....       ... ..         .   ...  .          .          ..  .    .
.. .    ...   .  .   .     ..    . . ..     .   .      . .  .  .   ...      .       .  ..           .....  .
.      .  ..     . . .   ..        . ..            . .  . .....     . ...              .   .   .    .      .
.  .     ..  .                ..  .  .. .  .  .  .  .  .   .   .   ..     ...   .  .. ..    ..   . . . .  ..
..  .  . ... . . ..   .  .  .    .. . .         .. ...    .    .    .     . .   ....  . . ....         ... .
.     ... ... .        .       ..   ..   .      .     . . . . .   .            .         .     .         . .
.    . .. .        .   . . .   ..      ..      .. .       .  .  S .  ..    .  .  ..         .. . .    ..   .
.       .. .   ..  .    ...  .. .. .       . .   ..     .   ...      .. .  .  .  ..     .. . .  .  .    . ..
..    . .    .      . . .       .  ..         .    .... ..  .   ..  . .        .  ...  ..       .   . .    .
. .. ...      .    .. .    .     .     .     . ...            ....           .         . ...       .   . . .
.       .  ..  .. .. .   .   . ..    . . .         ..  . .   .. . ..  .  . .           .  .  . . . ..      .
..  .  .    .    .     ..    ...  .     . .    . ..    . .            .     .   .   .     . .    .        ..
.    .  ..  . .    .. . . ..     ..   .   . ....  .         ..  ..      . ..   .    . ...  .   .. .   .    .
.  .  . .. ... ..     .   .  ... .  . .   . ..    ...    . .  ..   .. .  .   . .  . .. ..    . .     .  ....
.      .    .     ..  .          . ..  .... .     .  .       ..      ..    . .      ....  .  .      .     ..
...     .  .. . . ..  . ... . .  .. ..              .   .       ..  . ..       ...  .   .     . .. .   .  ..
............................................................................................................
