............................................................................
.        .         .     ..             .  .  .    . .  . .      .    .    .
.. .    . .     ..              . .     .   .     .  . . ..  .. .          .
. .  . .      .      .     ..   ..    .  .    .    .   . .           .    ..
.   .    .  .            .      .. .  ..   . .   .. .  .   .  .        .   .
.   .   .    .   .  .     . .    .   .   .                  .   .     ..   .
.      .    .         .  . .   ..       .     ...... . .      ..     . .  ..
.     .   ... .      .  ..     S        .    .     .   .  .   .            .
.   .      ..        ..  . .            . ..    ... .            .   . . ...
.         .    .. ..              .    .      ..  .                 .     ..
. .            . . . .      .    .      ..    .   . .  . . ..     . ...  . .
.  .  . ..     .     .   .   .  .X     ..     .  .      .  .   .    .      .
.      ..       . . .      .    .  .                 .  .              .   .
.         .  .             .   ...   .    ..           .... .     ..  .   ..
.    .    . ..       ..       ..   ....         . .   .         . . ... ....
.    .. ...        ... . .  ..     ...    .   . . .  . .         .    .. ...
. .        .     ..     ...    .    ..        .      ...    . .    .       .
............................................................................
