....................................................................................................
. .          . .       ..     . .              . . . .   .       .      .     .     .   .   .  .   .
.    .....            . .    . ..     .   .      .      .       .            .   . .  .            .
. . .  ..         . ..  .   ......      .      .   .             . .. .    .  .    .      . S    ...
.     .  . . .   .     ..   .           . . .. .           ..         . ..    .. .   ..         .  .
.   .     ... . .    .   .     . . ..      .  . ..     .    .   . .    . . . .  .     .  . .. ..   .
. .   .. ..     . .. ..     . . .    .                   . .          ...               .    .   . .
...  .     .   .     ..     .       .       .     .   ...    .    .   .    .     ..   .    ..      .
.       . .. .  .    .     .. .. .   .    .  .             .    ..   .   . ... .  .. .           . .
...    .      .   ....   .     . .           .  .. .       ..  ..    .  . ...    ..         .    ...
. .      .    ..  .      .  .       .                ..    .     .      .   . .           ...      .
.  . . .    . .   ...     .   .        .  .  . .   ..                   .     . .  .    .    .X ....
.    ..    .       . .. .  .  .. ..   .. .      .      .  .  .       .   .       .  .           .. .
.   .    .         .       . ..    . .    . .        ..     .  . .   ..  .     . .          .      .
.    . .  .   . .   ...       ..           .  .      . .  ..  ..  .   .        .    .   ..   .     .
....................................................................................................
