.............................................................................................
.  .     .            .  .        .       ..           .     ....  ..  .   . .      .  .    .
.            .   .         .  .      .. .  .    .        . ....S  .  ..            ..   .  ..
.. . . . .. ..  .  ..       . .   . ..           .  . .     .   ..  ..               . ..   .
. ..  ... .     .  .  .               .   . .  ..     . .       . .     .  . .         .    .
.     .      .      ..      .    .        ..  .   .. .   . .  . .    .. .     .  ..    .  ...
..       .    . .        .. . . .  .   .     .    .       .   .. .        . . . .       .  ..
.. .     .   . .. . .  .  ..  . .    .        . .   .      .     .     . .    .    ..    .  .
. .  ..    .   .. . .   .     .    . . ..         ..    .       .. .    . ...  ..  . ..     .
.        .         .     .              . ..     . .    ...        ..    .      ...   .    ..
. ..      ..       . .   .   .  .   ..    . . .   . ...  ..   .    ..    .   .   . ..  .    .
.              .   .          .  .     .     . . .        .  ..    .          .. ..    . .  .
.         . .    .  .   .        . ...   . .   ..   . .   ..  .  .     .  .     .  .  .  .  .
.  .. .. ..  .      ..        .         .      .  .  .      .  . . .       .    .     .. .  .
..  .    ....   .. ... .   ..  .. ..       .   .            . .. .. ..     . .     ..  . .  .
.     .        .     .. ...     .  . ....... .  .   . .   . .  . ..     . ..   .     . ..  ..
. . . .    .  .  .. .   .     . .      . .             .    ..    . . .       ... .     .   .
..  .     .    .  ..      .    ..  ..  .   .   ...     ..  .    . .   ...  ..  .   .  . ..  .
.         .      . ..      . .   .    . .  .   .          ..          .                     .
.   .  .   .     .      .   .  .  .     .     .      ..    .    .  .  .   ..  .   .   . .   .
. .   ...  . ..  .    .              . . . .  .   . .         . ..   .. .   ..      .    . ..
. . .   . . . .   ..   ..     .     . . .     ... ..  .   .  .      ..     .     .      .   .
.   .  .  .  X  . .  ... .   . .   . . .   .       .        .   .    ...  .      .   .  . . .
.              .. .       . .    .  .      ..      .   ..   . . .        .  ..      .    .  .
.   .       .. .. .  .    .     .   .  ...    ..  .  .   .   .    .      ...     .      . . .
.     .  ..         . ..    . . .   .          .      .  ...  ..  .    .             ...    .
.....            . ..         . .. . . .        .    ...  .  .     .     ...   .  .     .. ..
.............................................................................................
