...................................................
.  .       . .     .. .         .      .  .   .   .
..   .    .    .           ..  .    ..        .   .
.     ....  . ....      X         .     .    .    .
. .  .        . .. .     . .        .  . . ..  .  .
.  .            .            .   .      . . .  .  .
.    .   .. ..      ..     . ..       . ..        .
. . . .       .  .   .   .  . ..        . ..  .  ..
.     ..        .    .          . .  .  .. .      .
.    .    .   .     .   .  .         ....    .    .
...  .    .  ...   .  .. .   .   . .   .    ..   ..
.    . . ...     ..   . .   ..    .   ...   .  ....
..  .   .   .    .     .    .       .     ..  ..  .
.      .  .  .    .            .   .    ...  ..  ..
. .   . .   .    ..  .  .   ..     .            ...
.      ..    .  ..  ..    ..       .     .   . . ..
..       ..  .   ..   ....  .  ..       ..  . .  ..
.  ..     .   ..        .. . .    ..     .        .
.... . . .       .            .   .     .  ... .  .
. ..   .. .    .      .                 .   .. .  .
..        ..   .     .  . .  .     .   . ..       .
.                .    . ..   .   .    .   .      ..
.           . .      . .       .  ..        .     .
.  .    ..     ...  .         .        .   . .    .
. . . S.... .   . . .    .  .  .       .        . .
.     .  ..     . . .  .     .       ...  .   .  ..
...................................................
