..............................................................................................
.   .        .       .     .     .      .    .      .     .     .      . .  .  . . . .       .
.   .  .      .        .   ...     ..    .         . .. ..    .      .  .       .   .       ..
.           .  .  .   ..     ..  . .    S.   .. ....       ...      .    .   .  ..    . .    .
. ..         ...    .  .. ..  .         .     X. .   .     .  . .        .   .   ...   ..    .
. . .   ...   .   ..   .   .  .    . .   .         .      ..  ..   .  .. .      . .  . .  .. .
..  .      .       .. .  .    .   .    .   .  .    .  .     . .   . .    ..         . . .. ...
.         ..     .    ..    . . . .. . . ..   . ...       .      ..    .        . .  ..     ..
.... ..   ..   .          . .       ..   .  .   .   .      . .  .       .    . .             .
..    ...    . .         ..    .  .        .  . ..  .      .   .   .  ....... .           .  .
. .      . .. .   . . .      ... .... .      .  .               .  . ..    .     . .. .   .  .
..............................................................................................
