......................................................................................................................................................
.                    ...     .. .       .           .     .                           .  X  .     .   .  .                                        . ..
..  .                           .. ..      .          .          .          . .                  .      .  .    .   . .               . .          . .
.                        .            .            ..                               ...    .                          . ... .      ..     .          .
.               .                   .      .          . .  ..  .     ..                  .                               ...     .      .        .   .
..        .  .                            .   . .     .                    .. .                .            .        .    .     .    .    .          .
.                 .                                   ..              .       . .                     .           .       .     .      .   .         .
. .          .         ..      .                   .    .    .      ..  .             .   .      .       .     .                   .             .   .
.   .                          .                              .           .          .                  .  S.          .     ..   .                  .
. .          .  ..      .       .     ..         .   .     .     .     .         ..                      .         .      .   .                      .
. .               .      .        . .        .              .   .                  .             .        .       .                          .       .
......................................................................................................................................................
