.........................................................................
.   ..  .   ..     .   .  ..   .   .   .   .  .  ..   .        .  .   ...
... ..   .   .  ..     .   . .  . . ..    .      .      .   .  . .. S. ..
.     . .   . .   .      .       .    .. .  .  .   . .     . .   .   . ..
.     . .  .       ...     ...  .        . .   . .. ..     .  .   . .  ..
. .    .     .    .   .         .. .    . .        .     . .          . .
.     .. . ....   ..  .. . .      .   X       . .  ..         ..    . ...
.     .         ..     .. ..       ...    .   .       . .    .  ..      .
.    .     ..     .  ...   . .      ..      . .  .      ..  .    . ..   .
... .    . .   .   . .      .   .          ... .. ..     ..      .  .   .
..     ..       .    .  .  .  .  .  .          . .     .     .     .    .
.........................................................................
