.........................................................................
.   .  .      . .. .        .    . .           .. . .     ..           ..
.       .      . .   .  .           .   ..      .       .     .         .
..                      .              ..    .         .    .  .      ...
.   .    .       .    .     .      . .   ..         .         .      ....
..   .  .              .  ..  .     .                       .    .  .  ..
.  .    . .     .     .    .            .             .    .    .  .    .
.  ..     .  .   .                             .  .           ..        .
.      .                    .  .            .     ..       .    .  .    .
.      .     ...      .         .. .            .        . ..     . .   .
.              .           .       .   .    .                           .
..          .  ..       .  .    .    .  .   ..                  .   .   .
.  .    .                         .        .                ..    ..    .
. .               .                 . ..   .                  .         .
..    . .        .      . .           . .   .        . .                .
.    .             ..    . . .    .    ... .      .  .     .            .
.               ..           .          ..      .             ..      ...
.       .               .   S           ..  .        .     .    .  .    .
.                    .     ..     ..                 .          .. .    .
.      ..      . .              .  . .       .     . ..      .       .  .
..              .     . .    .                              .        .  .
..           .  .               .          . ... . .   ..       .      ..
.                         ..         .                       X .    .   .
.      ...             .  . .       .        . .             .          .
.........................................................................
