........................................................................................................
.. . .            .       .       .    .     . .    . .       .           . .    ...   .  .      .     .
.     . ..             .  .       ..  .      .          ..           .   .     .  .    ..    . .       .
.     . .   .  .   .      ..   .    .  ...       .        .   .       .  .          . .  .       .  .. .
.      ..   .  . .         . S .   .       .. . .       .        .          .    .   .  .    .. .   . ..
..    .             .             .   ..      .    ...    .    .   . .  .      ... .     . . .         .
...   .                           ..    ..   . .   .   .   ..          .  .    .   .           .       .
.        ..       ...         .  ..    .    .  .  . . .          . .         .           .  .  ..  .  ..
..           .      . .   . .  .       ..    ...       . . .     . . .     .                  ..X.    ..
.   .                   ..             .     .             .  .   .         .           ..         ..  .
.               .     .     .      . .            .             .     ..       .  .  .    .    .       .
.             . .        .         .  .        ..       .    .             .                           .
.           .  .          .         . ..               .   .. .          .         ..   .  ..    .  .  .
...      .      .   .          .  .. .    .          . .     . .  .       .     ....  .      .  ... .  .
........................................................................................................
