....................................................................................................................................
.        .  .              .. ..                           . .    .  . .  .         ..         . .                .        .       .
.  .  .  .   .      .       .           .  .     .  ..    ..   .         .     .             .        .   . .        .             .
.       .   .    .. .              .   ..        .      . .       .               .              .      .           .   .          .
.       . .  .  .          . .          .           ..        .    .       .      .            ..        .                         .
. ...                 .            .    .           ..       ..     .         .    .   .  .  .       .       .             .       .
..   ..                       ..       . .      .     .         .                         .         .                .    .        .
. .               .           .       .              .   ..                   . ..  .              .                       . .     .
.        .           . .  .    ..     .                     .  .           .     .  .            .    .                        .   .
.  ..   .. . .    .   .     .  . .         .    .      .            .  .          .      .             .     .         .   .   .   .
.    .        .          ..        .       .     .                                     ..       .    .  .   . . .  .        .   .  .
.        ...         ..        . ..                   .    .  .  .   .          .    .              .     .         .          .   .
.    .  .   . .  .              .           .  .   .     .. .    .          .   . . ...       .     ..      .   ..  .        .   . .
.       .   ...     ..   .       ..     .           .. .   .                             .            .           .         .      .
.        ..          .    .. .               .         .    .                .          .                        .     .           .
.           .     .               .                      . ..      .                    .   .       .     .           .   .        .
.  .   .           .   .  ..     .  .       .                      .  .    .            .            .   .       . .  .            .
.                     .   .                    . .             .               .        .      .     .                           . .
.         ..   .                    .               ...  .      .           .          .                S.            .      . .   .
.  .  .         .          ..            .  . .  .   . .          .             .        .  .   .      . .    .             .      .
.         .                .     .       .             .          .      .      .      .                          .      ..        .
.  .         .          .       .       .. .          ..     ..                       .      . .     .  .                          .
.             ..         .     .  .                                          .              .    .       .           .     .. .   ..
.    .     .          .    .         .             .   . .      .       .   .. .          . .         .        .         .         .
.              .           .        ..    .   ..  .        .     .                                      ..             .         . .
..         .                          X     . .                         ..           .             .         .  . .      .     .   .
.         .                   .       .  .                                     .     .       .   .         . ..  . .               .
....................................................................................................................................
