.........................................................................................................................
. .         .   .      .          .  . .          .              .   ..   .    .               .              .         .
.. .            .                ..     .           . .     . ..         ..           . .               .               .
.       .     .          .     ...          .           .  .        .                          .  .         .     ..    .
.   .   . .       .     .           .          .    .  .    .     .     .           . ..  .           . .     .         .
. .           .         . .                       .                     .             .      .   .                      .
.      .                            .   .  . . .          . .     . .     . .          . .            .         .       .
.   .           ..      .  .            .                               .        .  .             .       . ..  .       .
..                ..                              ..                   .             .                         .. .     .
.    .              .             . .            X   .   . .       .                    ..          .        .      .   .
.   .            ..  . .     .          .                               .                        .       .              .
.                 .                         .          .                  .           .   .     .. .            .       .
.                   .     .        .     .       .     .   .        .                  .                .  .            .
.            .   .   .     .                      .  .  .    .   .                           .        .  .              .
.  ..     .     .                . .      .      .     ..       .       .                .        .                     .
.                       .      .                .   ..      .    .              .      ..    .               .   .   . ..
.                .               .                             ....       .                                       ..    .
.           .            . .         .     .        ...   .       ..    .       .  .      ..  ..   .                  . .
.     .    .    .     .       .                   .      ..     ..          .              .      .           .         .
.      .         .             .      .    .    .    .       .      .       .   .     ..   .     .         .            .
.  .       .       .     .         .     .   S    .      .           .         .    .             .    . .  . .    .    .
.     . .                   .    .                     .      .         .            ..   ..       .          .         .
.   .       ..   .                  .    .. ...         ..               .                                            . .
..  . .              .  .   .         .     .                                  .                     .             .    .
.             .      .         .   .. ..   . .                           .  .   .         .            .                .
.........................................................................................................................
