................................................................................................................................................
.           .   .           .  .    .                                                        ..    .              .   .   .                    .
.   .       .              .          .  .                      . .   .             .           .   . ...            .    .                 .  .
.  .           .                     .                          .       ...               . ..  .  .    .    .           ..   .                .
.       .   ....   .                        .                             .                  .  .               .         ..  .                .
.   ..                            .           ..    ..  .         . ..                             .           .            .         .     .. .
..                             .                                 .         .       .           .               .   ..         .    .           .
.             .        .   .     .    .       .S  .                          . .  .  .    .   . .    ...  . .       .    .      .       .      .
.   .             .     .. .           .            . .      .   .     .        .    .  .                   . .      ..             .   X     ..
. .              .                      ..       .          .                   .     .        .    .                    .         .   .    .  .
.      .    .  .    .          .        .     .                .  .    .                                     .       .               .         .
.  .       ..       .   .   .   .                  .      .  .      .   .    .  .   .  .     .                  .         .   .              . .
.           .  . .                   .     .                   . .                .  .         .           .  .          .  . ..          .    .
................................................................................................................................................
