............................................
. . .         ..   .. .       ..        ....
..  . . .  ..          ..S.   . .  . .     .
. . . .  .  ....  .  .    .      . .   .   .
.   .... ..  . .    . .        . .  . .   ..
.  .    .  . .. .             . . . ... .  .
.    . .   . .  ..  ..            . ... .  .
.  .     ...   . .   . ..      .         . .
.. .      .. .  ..  ...    .  .  .. .     ..
.    . . .        ..    .  .     .  .     ..
...    .  . . .  .     .    ..  ..... .. . .
.  ..   . . . . ..       .  .    ..    . . .
.   .. .   . .    .  . .       .   .. ...  .
.  .       .X  . . .   .  .      ..  .  .. .
..           . ..     ....           .  .  .
...  ..   .   ...  ..       .       .      .
.. . .. ..          .           .   ..   . .
.    .     ..      . .  .   ..        .    .
.             .. .  .   ...  . .     . .   .
.  . .  .. ... ..            ..    . ... ...
.   . . . .         .  .             ..    .
............................................
