...........................................................................................................................................
.  . .     .          .    .    .       .     .            .    .     .             .   .                   .        .        .  .  ..    .
.        ..      .     .                        .  .  .      .   .       ..    .          .     .  ..        . .. . .             .       .
.   .   . ..                 .     .  .        .  .   .                .            ..   .  .      .  .      .             .   .          .
.    .   .                               . .       .       .  .       ..    .         .   .                      . . .  ..    .   .       .
.               .      .  .  .      .    .   ..  .       .              . .    . .   .         .    .             .    . .       .        .
. .    ..      . .       .          .             .     .      .                              ..               .   .               .      .
.         . .      .                .      .    .      .     .           ...      .                                .   .  .              ..
.       .   .      .         .     .  .  .   .         .          . .   .       .         .     .                .             .  . .   . .
.                ..         ...              .                .                      ..           .                 . . .             ..  .
.       ..                             .  .    .    .  .                         .   ..         .    .                .        . .        .
.         .                             . .       .       .     ..    .     .                          .    .  .       .      ..          .
.        ..               . .                   .             ..     ..          ..   .     ..  . ..     .       ..                       .
.   .                 .                 .      ...    S  .       .        .      .   .  .     .                               .          ..
.                      .         .    . .           .     .          .   . .  ..       .               .              .    . .            .
.                              . .           X                 .   .    ..      .      .      . .   . .                        .          .
. .    .      .     .     ..     .            .     .  .                              .        .   .        .           . . .             .
.    .              ..        .     .         .   .             .     ..    .            .                          .         .   .      ..
.       .    .           .                             ...        .  .      .            .     .    . .  .                       .   .    .
...........................................................................................................................................
