....................................
. .    .      .   ..   .   .   .   .
.        ... ..        .     . ..  .
.    . .       .   ..   ..    .  . .
..   .  . .  .   . .      .  . .   .
.  X      .  .    .        .      ..
...   .   . .      .  S    .  . .  .
.   .  .         .     .         . .
.  .     ..        .      ..      ..
... . ..            .  .. .     .  .
....................................
