......................................................................................................
.     . .  .  .   . . ...  . .  . .   .            ...   .     .       .  .  .         .        ..   .
.      .   .       ..  .   . . . . . . ..        .         .  .     .         . . .            .     .
..                . .    .     .   .         .  . .            .       ..   .           .  ..    .   .
.       .  ..   .       .    . .                     . ..     .  .    .  .     . .        .         ..
.  .        .  .                 .       .  ...    . .  .       .  .     .    .      ..       . .    .
.                 .   .    .   .      ..  .   ....    . ..          .   .     .     ..   ..    ..    .
..  .   ... .   .    .       . . . .. .   ..        .      . . .   .        .         . .    . . .  ..
..  . .  ..     ..     . .       .    .        . ..   . .  .       .    .     .    . .               .
. .  .     .    ..        .       .       S.    . .     .                  . .   .    .  ..   .   .  .
....    . . ..   .            . .       .          .   .       . .  X  . .            .           .  .
.       . ..      .      ..        .           .         .   .    .   .                 .   .  ..    .
.     . .      .   ..            .   ..   . .              .     .   .                              ..
.    .         .  .  .                      .  . ..  . .      .  .  ..   .   ...   .                 .
.        .      .         .  ..                           .    .  .    .       .  .  .               .
.   .     .      ..    .   .. .      .     .             .   .            .       .    .            ..
. .   .          .              . .   . . .     .    ..   ..        . ..    .       ..   . .       . .
.   .    ...    . .       ....     ..      ..    .   .                   .  .      .   .  .  .       .
......................................................................................................
