...............................................................................................................
.  .   .   .   .      .  . .   . .        ..   ..                     ..    .  .    .  ..    . .    .     ..  .
.   ..   .   .    .    .      .    . .  . .     ... .. ...       .  ..   ..  .S . .        . .   .. . . .  ....
. .   .    .  . .       .    .   .. .          .        .   .   ..  .  .                 ...   .   .    ...  ..
.  .    .      .  .     .     ..    .    .   ...    . ..        ..     . . . .  ..   .    ..  . . .   ..  . . .
.    .   .   .      ..    .     .    . .... . .                 .                 . .   .   .      ...     . ..
.                              .  .       ..        ...        .  .         .  .      . ..   . .. .     . .  ..
.      .          .   ..   . .   .  .  ... .     ..    ...  .  ..   .. ..      .   .        .  ..     .  .    .
. ..  . .        ..      .    .    .          . .        .... .  .. . ... .  .  .   .  ...    .           .   .
.     .      .                  .     .      .      ..   .          .             .   .  .   .  .   ..       ..
.  . .      .            ..    .  . .. . .       .     .  .. .        .     .         .   .  . . .. ..        .
. . .   .... .   . .      .     . . .       . ....         ..  .      .. .      .    .    .    .    .  ..     .
.  .             ..  ..       ..   .    ..      .     .    .. .    .  .X    .   . . . . .  .  .            .  .
. .  .     .         ..   . ..            . ..   .   .        ..          . .  . .    .. .      ... .  .     ..
.    .      .    . .               .   ..    . .    . .  .    .          .        .       .  .       .     .  .
.          .               .    . .   .  .        ...      .            .                       .   .   . .   .
.    ..      .        . .          .  .        .      .   . .     .  ..  .        ..   .     .   . . .        .
.   .  .  .                   .  ..  ... .   ..     .. .     . .          .         .   .       .....     .   .
.         .  ..   . ..      ...  ..   .      . ..     .      .   ..   . .. ..         .                       .
. . .    .   .       .     .   . . . ..   ...       .  ..  .  .. .   .  .  .. .     . .        ..             .
..         .  . .        .       .    .. .              .. .      ..    .     .      .   .            .       .
.   .     .           .    .. .           .. .            .  .  . . ..     ...        ..       ..    .  .     .
..   .    .. .    .       .  .   .      .              .      ..   .     . .. .  .    .   .    . . .          .
...............................................................................................................
