......................................................................
.                    .      .. .       ..  .     . .    . .    .  S  .
....      .           .   ..    .           .    .  .. ...     .    ..
.. .         .    .     .  .   ...   . . . ..        .         .   . .
.      .. .     ..                   .        ..     .    .   .      .
. . . . ..  . .       . .  ....      .     ..     .       .  . .. .  .
. .. .   .            .      .   .   .     . . .  .  .   .  .   ..  ..
.    .   ... ...   . .     .  .   .   .          . .     . .      .  .
.     ..          . . .   .   .  .            .  ..  .     ..        .
.   . .  .   .. .. ..  ...        .   ....              .           ..
.. . .  ... .  .        . .  ..   .     .  ..   .   .         .   .. .
.  .                . .    .     .      .   .       . .       .   .  .
.       .        .. . . .   .   .  . . . .           ..  .     .  .  .
..   .  . .    .      . .   ..    ..    .           .   . . ..  . .  .
..              .    .  .. . . .       .X    ..       .  .  .     .  .
.  .         .       .      .  .  .    .       .     ..   .    ..    .
.       . .            .   ...     .     .            ..    ..  .    .
.             ..    ....           .     .    ... .   . .. ..       ..
.      .          .     . .                              ..    ..   ..
.    .. .     .              ..  .      .      . .       .    .      .
.          ..           .                ...  ...   .            . ...
..           .      .       . .          .          .   .     . .. . .
..    .       .     . .    .     .      . .  . ...     . .           .
.                    . .         .  .     .          .  .  .       ...
......................................................................
