...........................................................
.                    .   .        .           .  S.       .
.               .   . .      . .      .                   .
.    ..   . .         . ..                    .     .     .
.       .   .  .            ..  .   .             .       .
.         .            .   .    .       .                 .
.    . .         .   . ..               ..   .            .
..          .   .    .     .              .               .
.    .    .  .                  .   .                     .
.   .    .                ..          .             .  .  .
..      .        . .   .    .                  ..         .
..    . .        X            .      ..    .     .        .
.    .  .   .            .    .      .                    .
.                                      .   .              .
.                .            .   .          .           ..
...........................................................
