...........................................
.        .  .         .. . .  .    . .    .
....   .      ..     ...     X  .         .
.      .   . . .    ..  .                 .
.      . .   .            S    .. .    . ..
.. .     .    .        . .   . ..     ..  .
..  .  .. .        .      .         .     .
.      ..           ..   .  .       .     .
.     .  ..               .    ..     ..  .
.     .    .       . .              ..    .
. .            .   ..   .           .   . .
.     . .             .. ..        .     ..
...........................................
