....................................................
.   . . .  .   .     .. .  . .   .   .             .
.  .. .     . .    .                .   .    .  . ..
..         .                      .            .   .
.. . . . ..           .        .   . .       .     .
. ..       .   .         .        .      .    .    .
..        ..             ..  .      ..    ..  . .  .
.. .  . .               .  . .    .  .      .. .  ..
. ..                      .    ..    ...     . X   .
.  .  .  .  .    .    ... .     .    .   . .       .
..    .    . .     .     .     .    .   .  .  .    .
.      .           . . ..    .     .         .   . .
.    ..  .. S ..       .          .          .     .
.    . .   . .  .               .  .   . .  .      .
.    .   .   .  ..     .     .  .   . .    ..  .   .
.    ..  . .  .  . ..    ..     .  .     .         .
.         .             .    .   .   . ...  .   .. .
.       .. .  .    .     .      .    .  .  .       .
.       .   .    ..           . ..        .    .  ..
. . .     .     .       .         ... .        .   .
....................................................
