..............................................
.      .  . ..  .   .    .       .    . X.  ..
.   .      ..  ..      . .  .             .. .
. . .         .  .          ..     .. ....   .
. .          .     .. .     .         .  .   .
..   . .  .    .      . ..            . .  . .
. ..      .  .                .      . .. .  .
.   S .   .  .        ..   .  . ....      . ..
.         ..      .    . .    ..  . ...   . ..
.   . ..  .   . ..          .    .  .       ..
. .  ..       . .     . . ... ...   .   .    .
..............................................
