..................................................................................................................
.   X.   .       .  .  .     .     .      .       . ... .  .       ..    . .   ..    .      ....  .  .      ..  ..
. .  ..  .    .. .   .      .           . .   .    .         . . .         . .   . ..     .    .     .   . .   . .
..  .. .  . ..  . .    . .       .     ..  ...  .     .     .  .      ..  . .   .   .  .   .   .       .        ..
. .   ....  .  . ..  ..  ..  ....      .             . . ..    . .       .    .  .     .     . ..  ..    ..  .   .
.   .       . . .     .          ..  .    .    .  .  .  . .   ..      .    . ... .      . .   .     .          . .
. .     .   .    .   .. .   ..        ... .          . .   .   .... .     . .  .    . ....  ..    ..  . .   .  . .
.    ..      .  . .   . ....  . .... .     .  . .. .     ..    ..  .. .       . S  .     .     ..           .. ...
.   ..  ..              .   .      . . .   .     . ..           .        ..     .  . ..   . .    ...  .   .      .
. .       .   . ....    ..  .. . .        .   .  ..    .  . .       .. .  .. ... ..  .    ...     .. . ..   .    .
.. . .    ..           ....      . . .  . . ...  . . ..           .       .. .   .  .   ..      . .    .   ..    .
... . .          . .     .  ..    . .  .  ..  .   ...    .              .. .   .  ..   . . ..  .  .    ..    .   .
.    . .  .   . .   .         .     ..       .  .  . .       .  .  ..  .    . .  .        .  .   .   .  . .    . .
....  .  .       .  .  .  . .      . ... ..    . .   .  .  ... ..     .   .      ..  .. .  .         ...  .... . .
...  .   .   ...      . .   ..     .    .        .. ...    ...   . ... .     . . . .   ...... . .. . ..     .    .
.....     . .  .     . . .... ...       .    .. .   ... .   . . ..     .   . ..   . .  ..                . .  .. .
..................................................................................................................
