..................................
.       ...      .            .  .
. .  . .     .    . .  S.    .   .
.      .. .      .          . .  .
....       .    .X.     .  . .   .
.        .  .       ..    .     ..
.      ..   ....  .  .    .. .   .
..      ....       ..   .        .
.     ..        . . .  .         .
..................................
