........................................................................
..     .. .   ... .  .      .. . ...     .. .     .. .       . .  ...  .
.          .. ...   .   .         .. . .           ..      .      .    .
..       ..  . . .  ... ..    .            . .        .  .       .   ...
.      ...  .... . .   .  . .                .      .       ..  ....   .
.   .         ... .. . .              ..       .     .. ...       .    .
.   .  ..  ..       ..   . ..    .  .      .   .       .     .       . .
. .       .          .. ..   . .   ...   .  . . .. .    . .   .       ..
.    .  .         ..  .     .. .    . .  .    .  .    .        ...    ..
.     ..   . .   .... .   .            .   ...  .     .    .           .
.  ... .. ...        .        .    .       .       .. . .     . . ..   .
...  .            .    . .... .          ..  . .        .. .     .. .  .
.. . .      .    .           ..  .     ..  .   ..   . ..          ..   .
...       .    .   . .    .     .  .X      .  . .... .   ..    .       .
.       . . ..  .     .  S ..   .      . .     .  .  . .         ..    .
.    .     ..  . .         .     .               .  . ....  .      .   .
.  .   .  .     .  .         . ...  . .         . .      ...   ... . ...
.              .  .  .         . .     .    ....    .    ... ..        .
. .     .    .   .  .  .         .        . . .      .   .   .  . . .. .
........................................................................
