.................................................................................................
.         .  .      . ..   . .      .     .        .       .      .   .   .     ..        .     .
. .   .    ..       ..   .       .  .               .  .              .   ..         .         ..
..   .    .            ..  .         .   .    .               .      .   .      .   .   .       .
.               .          .             .              .                         .     .       .
.  .          .      .            .       .                                         .     .     .
.  ..      .           ..  .          .  .        .   .    . .          .       .               .
.   .       .  .   .S.       .       .              .                 .  .      .               .
.          . .            .         .  .    .       . .      X                 .           .    .
.       .  ..                   .        . .  .       .            .           .   .           ..
. .            .  .              .  .         .  ..                .         .     .            .
.  .    .    .   .       .     .      .        .             . ..        .    .    .   .        .
.   ..     ...   .  .                    .  ..                       .     .            .    . ..
.................................................................................................
