..............................
.                      .     .
.   .     .       .X         .
.    .                 .   . .
.  .   ...   .  .           ..
.   .       .           .   ..
. .  .        S        .  . ..
.      ..  .   ..           ..
.   . .      .  .    .     . .
. .    .       . .     .     .
...   ..    .     ...  .  . ..
.                 ..         .
.  .      .  . .  .  . .. . ..
.   .     .        ..      . .
..............................
