.....................................................................................................................................................
.  .   .          .        .    .              .             . .      .  .                      .     .       .   .     .           .              ..
.    .         .  .        . ..  ..        .     ...X.. .                 .  .  .      .      .       .         .         .      .      .          ..
.                           .       .  .     .      .        .       . .    .     .                                  .      .     .         .    .  .
.            .    .. .            .      .    .     .        .        .  .   .       .                   .               .   . .       ..           .
.                             . . .                                    .  ..          . .                . ..          . .  .              .        .
.       .     ..     .             .     .          . .         .     .    .          .    ..        .         .      . .     ..  ..    .           .
.        . . .   .             .     .    .             S       .         . .            .        .            .                        . .     .   .
..              .     .    ..         .        .             .   .          .   .           . .       .                 .    .          .     . . . .
..     ..                                  .                                    . .        . .  .    .      .  . .    .  . .  .                  .  .
.   ..             . .    .     .                       . ...     . .            .         .  .                   . . .          .                  .
.....................................................................................................................................................
