....................................................................................
.   .         .           .  .    .  ..         .   .   .   ...  .    . . .      . .
.         .    .       . .        . .     .     ... .   .   . .                  ...
. .  .  . .  .  .       .           . .         .    ..    .  .    .           .   .
. . .  .. .              .   .. .     .     .   ...   . .         .       ..    .  .
.    .           .  ... .       ..         .     .       .       . ..     X        .
.     .    ..  .     .   ..  .     .  . .  .              .  .  .                . .
..     .     . .   .     .. . .. .. .    ..        .          .       . .          .
... ....   .     .. . .     .  .   .    . .  .  . .     .  . .  . . .       ..  . ..
.     ..  .  .   .              ... ..       .   .  .    . . .             . . .   .
. .              .    . .     .       .     .    .                 .               .
.    ..     . . .         .    .   .  .     .   .        S     .              .   ..
.. . .  .   ...      . .  .       . .     .    .          . . .. .        ...   .  .
.    .    .   .       . .      .   .              .  .  .  .  . ...          .     .
. .     .      . ...    ..  . .      .       .   .    .    .      .  .  .    .     .
.    .       ...       .  .      .  ..  .  .     .   .   . ..         .      .   ...
....................................................................................
