............................................................................................................
.   .            .     .      . ..   .            ..         . .         . .   . .     ...  .. .   .    .. .
.    ..     ..   .        ... .          .    . ..     . .    .       .               .  .. . .            .
.  .        .      .    . X  .  .  .     .   .       .         .                 .  . .      . .           .
.  ..    . .      .    .   .  . . . .         .      .        .   .           .. .      . .               ..
..   .           .   .  . .  .   . .  .        .  .  .  . .        .         .                .     . ..   .
.   .       .               ..  .. . .     .  .                      .   ..   . .  .. .        .  . .      .
. . .      .                     .       . .  .             . ..      .  . ..  . .  . .  ...    .         ..
.     .. .    .                     .         .       .. .     .  .   .     .             .     .      . . .
...     .  . .       . .     ..     ..        .  .   . .  .    .     ..         S.    . . .         .    . .
.. . . ...  .  . .            .           .      .       .       .          ...   ... .  .    . . .      ...
.         . .  . ..     ..  .     . . . .      .  . ..     .. . ..    . .    .  .       .        .. .      .
.  .. .. .   ..     .     .              .    ..       . .  . .      . .      .   . .     .           . .. .
.       . .      .  .. .     . .         .   .   . .          ...     .  .    . . ...    . . .. .        . .
............................................................................................................
