....................................................................................................
.     .     .    .              ..   .. .... ....  ...  .                  .   .  .             .. .
. .  .. .   .. .           . ....           . ..    .  .  .    .         .  ..   ..          . .   .
. . . .   . . .  .       ..     .   . ..   .   .  .      ..    ..  . .   ...       . .  . .. ..    .
..   .         .  ......   .    .    .      . .          .      . ...       .    .    .       .    .
.    .        . .      . ..    .  .     .      . .     .  .          .     ..     .      ...       .
.            .  .        .       .            . .   .        . .  . .        . ..   .      .       .
.              ..  .    ...    .. ..        .    .        .   .   ..    .. ... .    .       .    ...
. . .      .  .       .  .   . .      ..  .         .  .    .  .....        .   .   . . .    .     .
.   .    .   .     .  . ...   .         . ....  ..     .       .      .. .. . .   .    .  .      ...
. .         .   ... .    .  .     . .     .   .   .  . . . .     .    . .       .  .               .
. .     .       .. .  .         . . . ..         .         .S  .  .    .  .    .. .  . .           .
.        .   .   . .     .         .  .         .  .    .    ..  .  .   .      .        ..  . ..  ..
..   . .              .        .       .          .     .   .   .  .    .    .   . ... .  ...   . ..
.  .       ..  . ..      . ..     X.   .. .       .    .    ....    .   .. . . .. .              . .
.. ......  .    ..   .      .   .. .. .   .      .    .  .  .   .     .     . .       . .   ..    ..
.   ..   .           ...   ..   ...   .      .      . .   ..     ..   .          .    . .   ..     .
.    .. .    .        ..     ..    .     .   .  .  .     ... .   .         ..     .        .    .  .
..     .    .  . . ..         .        ..   .       .  ...      . .  .. ...     .  .    .   ..    ..
..       .    .           ... .  .       .         .                    .       .  .   ...        ..
..   . . .       .     . .   . .     .    .  .           .      .     .  . .      . .            . .
.       .  ..  .... .   .     .  .   .... . .                 . .   . ...   . .      . .    ..     .
. .  . .    .    .     .    .          .. .          .     .  .  .   .             .           .   .
. .                .     .     .   .        .   .  . .      . . . .   . .   . .   .. .            ..
.  .      ... . .  .   ..    .                          .   . . ... .  .    . .         . ..     . .
.  .    .     . . . .   .   . .. .      .    .  .   ..       ...                        .          .
..          . .            .   ... . .      .  . ..  .   . ..   .         ...        ..            .
....................................................................................................
