...................................................................
.   .    ..     . .  .                     .  .                 . .
.     .  .    .                 .                              .  .
..         ..     .    .              .             .    .  .     .
. .       ...       ..        .       .   .      .    . ..        .
.   .         .                         .               .         .
. .      ..   ..       .  X                      .            .   .
.      .  .     .      .              .       .. .    .       .   .
.       .          . .   . .     .       ...    ..             .  .
.   .      .  .     ..                .     .            .        .
.           ..          .    . .     .           ..               .
..  .   .       ..   ..       . .  .                         . .. .
.       .  .     .   .           .    .  ..                       .
.                .   .            .       S    .             .    .
..     .  .                   .          ..  .               .    .
.     .   .    ..       ..           ...        .   .            ..
.    .                 .      .       .   .               . .     .
..   ..        .   .  .                     ..           .        .
...................................................................
