..................................................................................................................................................
.     .  .       . .      .        .    . .            . ..         .      ..     ..            .  .  . . .       .  .   .             ..     .  .
..              .             .     .  .   . .             .   .      .    .           .. .  .  .   .        .  .         .       .         .    .
.                         .    . .  .   .   .     ..            .    ...  .  .                  .   .                         .  .         . ..  .
.  .                      .   .      .                ..          .          .                  .. .                .     .     .              . .
.                               .              .              .     ..              .  .            .        .  .            .  .          .     .
.. .          .       .  .           .   .       .       .              .     .          .     .                 .            .               .  .
.   .   .     .  .   .          .      .       .    .  .          . .  .         .                      .      .       .   .            .        .
.     ..        .     .               . .   . ..              .                .                       . .   . .              .             ..   .
.     .       .   .  .  .       S.  .           .         .  .  .          .                            .       .            .  . .             ..
.  .        .    .             .      . .          .  ...                                       .  .      . .                               .. . .
..      .                                  .                           .   .    .               ..     ..  .    . .   .  .     .       .         .
.   .     .          .                       .          . .               .            .        .                .  .    .     .   .         .  ..
..  .            .            .     .    .          . ..                   .   .   .        .       .                               .            .
..   .       .        .      .   . .  .   .    . .      .  . .         .   .     .  .         .       .      .        .           .   .          .
.. ..   . .   . .       ..  .  ..  .             .          .       .            .   .. .       .     .      .    .              .               .
. ..                .         .                      .                    .    ..     ..            ..       .           . .    .            .   .
.        .  .  . .          .  .         .               ..     .                      .    .                      ...         .       .  .  .   .
.       .             .                  .  .           .                             ..                      .      .    . .          .         .
.   .             .. .     .  .      .  .    .  .  . .           .                .            .  .    .                  .      .               .
.    .       ..             .       .        .                           .   .    X..           .      .     .        .  .        .  .... .    . .
..                     . .     .       . ..            .         .                    .     ...  .             ..        .      .                .
.    .    .  .                         .      .       . .   .           ..    . .                                  .      ..                 .   .
.       .             .     .        .  .           .  .. .  .          .   ...  .           ..     ..        .     .       .    .     .      .  .
.         .   .       .     .     .            ..      ..        .                    .       .           . .                    .    ...        .
..................................................................................................................................................
