..............................................................................................................................................
.        ..         .           .        . .            . .    .    .      .     .  .                                    .    .         .    .
.        .              ...                       .      ..      .   ..   .             .      .             .           ..        .         .
.   .            .                                     .                        .    .         .           .                          .      .
.       .     .   . .        .         .                 .    .   .     ..   .      . . .                          .    .        .           .
.   . .                            .      .   .    .  ..       .  .          ..           .     .         .          ..  X                   .
.     ..   .     .. .      .         ..       .                                                                  .     .    .  .  .         ..
.             .    . .                   .     ..        .       . .      .        .                 .        .             .         .. .   .
.       .           ..  .       ..        .       .  ..      .  .   .         .            .. .         .             .     . .      .       .
.  .                 .       .                .        .           .       ..     .              .  . .   .  .     .     .          .        .
.   .   .        . ..           ..     .                 .    .            ..                   .       .            . .    .     ...        .
.   .     .    .   .    .  .                                .      .                        .    .     .        ..     .   .             . . .
. .      .      S. .     .    .       .   .        ..           ..  .   .  .       . .            .                   .       .  .           .
.                 .              .  .    . .             .   .            .  .            ..                .                                .
.      .    ...     .    .                            .            .      .       .                                  .   .         .         .
.  .       .             ..        .             .                    .... .              . .   .                  .    .            . .  .  .
.            .             .                  .             ..      .                     ..                                  . . .    .     .
.                 . .  ..        .   .       . .     .  .          . .  .  .       .                  .        .             .               .
.  .    .    .      .                            .                    .    ..  .  .   .           .    .    ..      .      .     .    .     ..
.         .         .      ..        .   .  .                      .       .        .              .                  .  .     .             .
.     .          . ..        ..     .                           . .               .         .  . .      . . .     .   .             .   .    .
..............................................................................................................................................
