...................................................
.        .               .   .   .    .      .    .
.              .  ..    .          .         .   ..
.    ..                                       .   .
.      .        . .         .                   . .
..                              .                 .
. . .  .              .    .  .       .   .  ...  .
.   .           .                                 .
.                  . .       . X .      .         .
.                .    .   .        S.         ..  .
.  .      .  .       . .        .  .   ..         .
...................................................
