........................................................................................................................................
.     .. .   ..  . .        .  ..  .  .  .   .. .       .. .        .. . . .    ..  ..       ...   ...       .    ...  .  ...    .  .. .
...   ..    ..  ..  . .  ..   .  ... .        .  .       ..  .  .      .   ..   . ..        ... . . .  .          . . . .          .   .
. .   ..  .       .   ..     .    ..    .   .       .  . .     S     .. ..      .. .             ..  . ..  .. .        ..    .   .     .
. . .. . .     .  ..      ..              . ..                     . ..  . .  . .   .         .  .   .     . .  .        .         ..  .
..     .  ..  .  .          ..           .    ... .  .   .   .  .      .   ..       .           .    ..  ..   ... .     ..   . .. ...  .
.  .       .  . .        .   . ..        .    . .   .. .                    .  . .          ..     . . ... . .  .      .   . .   .   . .
.        . .   .  .  .      . .       .     .   .  .   ..              .. .    ..     .  .  .  .   ..  .       ..  .  . .  .         . .
.  .  . ....  ..   .   . ...     ..     .      . X     ....       .    .    ..      .        .    .          ..   ... .. .        .  ...
.  ..   ...    .    .      .   .     .            . .    . .    ..  ... .         .    .  .    .     .              .   . . .  .     . .
..   . .         ..     .           .  . .    .     .    ....  .    .  . . . .   .  .       ..  .  .   .             .              . ..
.  ..     .  .      .  ..  .  .       .     .       . . .  .. .      .        .      .  .  .     ..   .    .    ..    .  .. . ....     .
.    ..  ..  .      .      .        ...   .  .   . . ...      .   . ... .           .    .  .     .....  ..  .  .       .  .  .      . .
. . . .. . .   ..      .    .   . . .  .     . ..     .    .     .  ..    .    . .      ..       . .     .   . . . .  ..        ..     .
..     . .      .     ..    .    ....       . .  .    . . .  . .            .. .   ...       ..  .      . . .              .  .        .
. .   ..      ..   .       .  .. .   .   . ...          ... . .     .  .       . .. ..         .  .  ..      .  .. . .        .   . ....
.   . .        . .. .  .      . ..  ..  . .    . .. .. ..    ..     .        .    .     ..  .   . .      .   .   . ..      . . ..     ..
........................................................................................................................................
