..................................................................................
..    .      .  ..      .    .     .    .   .  ..           .          .  . . .  .
. . .    .   .  .  .            .  . .              .. .     ..        .         .
.  .  .     .  .   ..                .       .   .  .         .  .   .  .. . ... .
.          .        .           . . . . . ..    ..        . .          . .  .  . .
.   ..   .           .  .     .      .          .     .         X.       .      ..
. .  .          .           . .  .  .        .   .    .    .       .  ..         .
...   . .       .          .   .          . .       ..       . .    .  .   . .   .
.    .          ..       .   .   . .   ...      .  .    .  ..    .              ..
. .  ..      .  .   .   .      .     .   .     .. .     .        .       .    .  .
. .       .        .. .    . .      .   .   . .  ...     .     .  ..   . .  .    .
. S. .  .          .  .                  .  .    .           .              .    .
.      .   .    ..    ..  .  .. ...   .    .      ..          . ..   .     .   ...
.        ...     .. .   .   .                   ..   .                .       ....
.      .   ..          .   ..              .     . .  .         .  .   ...  . . ..
..................................................................................
