.......................................................................
..    .   ..  .       .  .         .   .        S  .. . .  .    .     .
.          .     .       ..    .         .  . . .                    ..
.   .          .  . .       .      .     .    .        ... .      . . .
.     . ..   .   .           .                        .    .          .
..                        .     .    .  .    . . .   .     .    . .  ..
.            .      . ..  .     .    . ..  .          .  .         .. .
.  .  .         .    .  .           .      .      .        .  .       .
.  .   X    .   ..      .  .. .         .    .   .  .         ..      .
. .                          .              . .              ...      .
..                         ..                           .  .     .    .
.......................................................................
