.................................
...         .             .     .
.           .          .. .     .
.  ..    .  .           .  .    .
. .       .          X      . . .
..     .  .          ..   .     .
.         . .       ..  ..   .  .
.            .     ..           .
. .          .   .    ..  .     .
..      .           .           .
. ..         .       S   . .    .
.     .     .          .        .
. .              .     .   .    .
.                .      .       .
.    .              . .      .  .
. .    .        . . .           .
.  .  .                         .
. .               .  . .      . .
. .                     . .     .
.         .                 . . .
.        . .        .  ..       .
.  .            .      .       ..
.       ..                 . .  .
.................................
