........................................
.                      .               .
.     .  .   . .  .      .     .       .
.     ..    S  . .    .        .   .   .
.   .                 .         .      .
.      .  ..  ....    .   .            .
.     .     .    .   .        .        .
.   .                       .          .
.            .  .  .     .            ..
..          .         X.               .
.       ..           .    .   .        .
........................................
