.........................................................................................................
.   .    .. ..      ...  ..    .  . . . .   .       .       ...   .     . ..   .              .   ..    .
.  ....  . . ..  .. ..   . .      .         .   .   .  .  .        . .  .. .  . ...  .   ..           ...
..         . .  . .      .    .     .       ..  .    .   ..   .     . .  . .  .           .     .. .   ..
.     . .        . .  .  . .   .        .. .         .  .         .      ..       . . .   .   ....      .
...       ..    .   . .. . ..  .    .  . .      .   .    .      ....    . ... . .   .       ..   . ...  .
.    .   .         .    .     .  ..     ...      .        .  .   .. .    .  .    . .   .    .     .    ..
.   .   . ..    . .      .. .  ..   .  .           . .     .  .       .  .  .   .  .. .    .  . .       .
..         . .   .     . . .      .     ..  ..  .   ...                      .     . ..       . . .    ..
.    . . . .  .. .              .   .        ..   ..  X      . .       .   ....  .       .     . .   .  .
.   . .         ..  . .     .             .   .  . .. .        .     .     ..    .           .   ..  . ..
....      ..     .     . . . .   .  ... ...    .  .. .       .   .   .    .            ..         .  .. .
...        .  .  . ...   . .   . . .   .  . .   . .       .   .   .          . .    .      .     .  .   .
.   . .         .     .      .              .     .     . .   . .   ..    .. . .  ..  .           .   . .
.  ..     .         ..  ..  .    .  .   . .        .   .   .   . .        .      .   .   .. .  .   .    .
...  .       .. ..       .. .     .. .   .  ..              ..    .  .  .    .... .    .   ..    . ...  .
.    .  . . .  .... .   .   ...   .   . . .    .   .   .       .    . . .       .. .  ..       ..... .  .
.     .  .   ..     ...    .   .  .  .   .   . .. .   .       .        .   ..     .      .     ..    .  .
.     .   .   ..  .    . ..                      .. . .    .  . . .    .        .      .   . ..       . .
. . ....         .   .   .   .. .    .   .      .     ..... .  ..     .. . .      .   .       .         .
.  ..           ...    ..    . ...  ..    .      .    ..  .       ..    ..   ...      .S     ..         .
..          .  ..  ...     . . .   . ..         .     .     .   .      . . . .     ..  ......  .    .  ..
.   .      .. .  .      . . ..  ..        .      ..  .    ..  . ..       .      ...      .    .   ... . .
..    .         . .     .  .     . . .       .   .     ..   . .   .      .. .  .  .   ..        .   .   .
.    .  ..  .    .  ..    .       .  .  .      ..     .       .    . .      ...  . .            . .     .
. .       . .         ..   . . ..   .. .    ..    . .    .   ..  .      .   .     .      .  .     .   ...
..    .   .     ..        .          .     . .       .   ...    .    .   .   .  .         .......  .  . .
.    ..      .   .             . . .   . ... . .  . ...    .    .  ..     .. ..         . .. .     . .. .
.........................................................................................................
