........................................................................
..  .   .  ..     ..       .    .    .   ...      .           .....  ...
.   . . .    ..         .        ....      ..      ..     .   . .  .   .
. .. .  ..  .   . . .      .       ...    .. .         . .     .. .   ..
.   ...  .    .  .    ..   .   .            ...                  .     .
.  .         .  .      .. . ..        .    ... .  ..     .. . . .      .
. . . .. . .  .     .   .. .  .    .  . .    .   .    .        ..  ..  .
.    .      .  . .    .    .       .    ..    ..   ..  . .    .  . .   .
.         . . .      ..     .. ..  .    ..   .    .                 .. .
.  . .      .. .  . .  . ..  .   . .    ....      .  .  . .    ... .   .
...        ..   ...     .   .   ..   . . ..  .   .    .    .    ..   . .
.   .    .  .  .      S     . .    .            .            .. .  . . .
....     .  . .   .   .  .                    . .      .. .          . .
..   .   .       .      . ... . .    . ..     .    ..   . .   ....X   ..
.     .     .  .. .   .    .         .. .  ....     . . .    ....     ..
..       . .. . .. . .   ...   .. .  .          . . .    .   ..  .   . .
. .         .    .  .   .     ..              .       .  . .  .  .   . .
........................................................................
