.................................................................................................................
.      .           .               ..      ..    .      .  .  .            ...      . . .  .       .   .  .     .
. .                   ..                .     .      .  .                ..    .  .  .      ..     ..    . .    .
.. .  .      .        . .                   .      .  . ..                 . .  .    S        .      .   .   .  .
.      .           .  .   .    .       .             .   .     ..          .       .  .  .      .       .       .
.     .         ..            .  . .           .          .       .       .           .      .           . .   ..
. .     .      .      . .     .    . .           .    .           .      .          .   X     .  .     .        .
.       .                  .  .  .   .       ..         . .  .                                                  .
.    .         ..  .             .      .                    .     ..  . .     ..  .                 .          .
.   .          .    .    ...       . ..              .     .      .  .    .  .              .                   .
.             .           .          .          . .             . .                     .            .          .
.      .  .    . .. . .    .  .     .              . ..      . .    .      .        .      .      .   .    .  . .
.      .         ...   .     .    ..                    .         .. .        .  .  ..                          .
.          .     .           . .            .       .      .               .    .  ..        .                  .
.   .   . ...     .    .         .  .      .        .        .  ..              . .   .   .                   . .
. ...         .          .          .     .    .          .    . .            .          .     .  .          .  .
..    .        .     .     . .                     .            .     .        .               .   ..   ...     .
.................................................................................................................
