...................................................................................................................
.. .   .    .      .         .  . .. . . .  ..            . .   .   .  .  .       .         .    .    .        .  .
. .   .    ..    .    .    .    ..          .  .   .   . . .   .    .    .             .     .  .      .        . .
.                      .        .           .    . ..           .    .     .            .         ..         .    .
..                   .    .  ..  .   .   .          .       ..  .               .         . ..  .   . . ..        .
.   .      ..     .    .  .  .. .   .   . .    .    . .   .    ..  .    .  .       S       .     . .      .    .  .
.                 ..  .    ..  ..  .           .  .      X   .     .       .                  .      . .       .  .
. .     .   .  .  .      . .               . .     .   .    .    ..              . ..    .           .       . .  .
. .             .   ..     . .  .   .     ...    ...        .     .       .   . .     .  .   .  .         . .     .
.          .     . .          .   .     .   .     .  .. .. .  .      . .  .   . .  .    .    .          . .      ..
.       ..  . .   .                 .     ..   .        .        ..   . .  .     .   .                 .    . .   .
.  .     .    .  ..                 .  .  ..   .        . .             .. . . .             . ..       .     ..  .
.    .  . .   .   .    ... .    ......     .          .             . .              .  ..      .. ... . .        .
. . ..                .     .       .             .   .    .    .      .  .   .      .  .  .  .  .  .         .   .
...................................................................................................................
