....................................................................................
.   . ...        . .  ..  .      ...               .          .  .  ..   .         .
.    .     .     .    .   .                         .     .          . .         . .
.  . .     .   .  .    ... .         .   . .         ... .       .           .     .
.... .. .  ..  ...              .        .      . .  .    . ..    .    .  ..   ... .
.        .  .        .  .  . . .      ..  . ... .  .    .          .           . ...
.    .. .       ..     ..    ...  .       .              .. . .   .  .            ..
.          ....          .      .   .    . .                     ..  . .     . .   .
.. .    ..    . .       .  .       ..     . .  . .   . .   ...        .  . .    .. .
.        .   .          . ..       .      .   .   .   . .  .        . .    .       .
.  . ...  . . .      .          .     ..        .       ..      . .   ...  . .     .
.         .  .           .   . .          .   .       . ..     . .     ...      . ..
.  ...   . .   .   ..       ..                  ..  .   ..        . .   .. .. ..   .
.   .    .   ....  .        .  .  .             . .. .. .   .    ...      .   .    .
..      .   .     .    .  ..    .  ...S     . . .    .     ..     .   .   .   ..   .
.   . . .   .           . .  .   . .  .        . ... .   .. . . ..    .    .       .
. .    .       .    ... . . .                  . .        .        .    .         ..
. .             ...  .             .      . .       .     ...      .    .  .  ..  ..
.    .  ..            .            . .     .. .             .                .     .
...  ...   ...      . .  . . . .       .   .      .  .   ..    ....  .  ..         .
.  .  ..     . .  .    .   ..  .     .    .     .   ..              .       .      .
..     .   .         .   .    . ..    .  .         .  .       . ..                 .
. .    . .         . . ..    .       .   ...  .   .   ..        . .   . .     .   ..
..      .               .     .    .         .   .     ...    .   .    ..  .       .
.       ..       . ..  .  X.    .     .  .    .       .      ..    .  .    .. .    .
.     .  ..      .  . .    .     . .       .       . ...              .  .         .
.               ...       .  . .    ..        . .            .      ..      .      .
....................................................................................
