..............................................................................................................................................
.    .    .     .                               .   .  .        .                 ...         .        .        ..  .    .   .      .    .   .
. ..          X            .        .      ..               .         . ..     .S .   .      .         .             .              .     .  .
.      .       .  . .                      .    .    . .    .     .     . .        .          ...     .    .  .   .            .. .          .
.          .      ..     .      .           .            .  .          .   .            .          .                   .  .    .      .    . .
. .  .       .        ..         .  . .   . .   .   .   .    .  ..  .      .      ..                  .  ..                .  .              .
.  .     .                        .   .      ..            .             .       .         .              .  .    ..     .  .        .       .
..       .          ..  .  . .    .       ..     .  .   .                    .      .       .  .     .     .  ..     .         .    .        .
.              .         .            .     .   .                                 .       . .        ..  .           .                   .   .
.  .              .  .  .        .        .    .     .      .  . .    . .      .                               . .   . .        . .   .      .
. . .                . .      .  . .               .                    . .   .   . .  .    ..       .       .               ..        .   . .
.    .       .        .  .          .  .                .    . .             .    .               .                                    ..    .
..............................................................................................................................................
