....................................................................................
.  .. .  .. .. .         .  ...   ..  .  .  .  ... ..  .      ..... .   .   .      .
.   .       .         . ..   .          .. .  .  . .  ..  ...     .     ..    .   ..
.  . ...      . .  . . .        .   ...    .. ...   .    .      .....    . . .  .  .
.. ..      .         .   .   .   . ...  .   ........ .             . .      .      .
..    . .  .   .   .   .  . . ..  . .       .. .   . . ..    . .. ..   ..      .   .
.                    . .  .    . ...      ..    .....        . ....   .. .  . .    .
... . ..         .  ...  .   ....        . ..         .  . . ...   .             . .
. .   .     .. . .           . .    .... ..      . .                  . ..     .   .
.  .  .     . . ..    .    ..      ..    .  .  .        .   .  . .  .   . .       ..
.   .        ..   .  .   . .  . .      .     .. .. .       .    .     . .     ..  ..
.        . ....   ..  . ..  ..      ..      .     . .      .   .     .           ...
. .  .  . .       .  .        .      ..    .  .       . .  .  ..   . ..   .  . .   .
.  .      .   . .. .    .    . .    .      ..  .   . .. .   .    .  ..  .. .  .    .
.  .       . S.      ..   .....    .    .     ..  .  .       .  .   . . .    . . . .
.   .  .  ..      .. .  ..     . .                .  . .  . . .X..       .  .   .  .
..   . ...         .   .    . ..       . ..    . .  . .. .    ..    .           .. .
.         .   .. ..    .   .    . .    .  .       . .  .              . ...  .   ...
....................................................................................
