......................................
.  .         . . .     .   . ..   .  .
.     .   .  ..    .  ..    . .     ..
.          .  .  .        . .   ..   .
.       . .          .   ...         .
.                 ..  ..      .      .
.              .  .        ...   .   .
.  .        . ..         ..      . . .
. . .      .   . . .     .         . .
.            .    .   .   .          .
.   .           .    .    . .   .. ...
..  X ..    .    .   . .  .          .
.   . .   .       .          .     . .
..  .         .  .       ..  . .   . .
.     .            .          .      .
.    .         ...    ..       .. .. .
...   .  .. .           . .  .       .
.     .            .    .            .
...          .  ..              .   ..
.  . .                          .    .
. ..      . ..  .             . .    .
.            .   ...  . . .          .
.  .  .     .    .               .   .
.  .. ..    .     ..   .       ..    .
..     ...    .. .  ..      S .   . ..
..       ..       .      . .    .  . .
.       . .    ..  .                ..
......................................
