..................................................................................................................
..  . ..    . ...        .   ..    .   .  .  .  .    ..  ..   .              .        .    .   .  .        . .  ..
... ..   .     .    .   .   . ... ..    .  . . .. . ...  ..     .....  ...   ..  .    .  .        .        .     .
.  . .         . . .. .       .      .....   . ..     .           ...          . .    ..  .          .   . ..  ...
.. ..    .     .  ..    .    .  .  .   ...   .   .     .  . ..    .  .   .      ..    . .  .          .       . ..
.          . .        .     .   . .  .  .  . X .       .          .   ... .    . .  .       ..  ..     .  .  .  ..
. .      ....    .    .  ..   . . . .  .   .     .    .  ..  ...  ..  .       ..    .       .  . . . .  .        .
. . .    .        .  . .    ..  ..   .       . . .   .  . . .  . ...  ..        .     . .      .    .. .   ... ...
.  .   ... .   .. .  ...  .   .. .   .      .  .   ..    .  . .  ..                     .        .       .     ...
.       .      .    .     . ..      . ..  ..      .. .      .   .  .     .  . .  ... .  ..   .    .     . .     ..
. .   .  .        .      .    .     ..  .     .   ..            .  .. .  .    .  ..    .     .   .      .  ..    .
.  .     . .  .    .            .   . ..  ...  .  ..  .       .  ..       ..  .     ..    ..         .   . .  .  .
.     . .  .     ...     . .    .   ..           . .    .    .  ... .     ...       .   . ... ..       ..        .
.       .         .   .   .. . .   .   .. . ..    ..  .          ..    . .  .       ..         .   ..  ...   .   .
.               .  .    .    ...      .  .. .  .   .  . .   .      ...      ..    .      ..    ..    ..  .. ..  ..
.                 ..       .   . .    . .    .   ..      .     ..          .     ..      . ..   ...   . ..   .   .
..     .    ..         ...... .   .       .         .          .  . .. .         .    ..  .  .    .  .  .  . .   .
.    . ..            .   . . .  . .               ... .   . .   ..    .  .  .     ..    .      .   .   . .    .  .
.  .     .. .   .       .      .   .   . ..         .  .. . .     ..    .   .   .    ..         .      .   ..    .
...  ....  .   .   ..       .    .. .    ..        .  .. .         .. . .. .  .   . .   .... .  ...     .        .
.     .      .    ..  ..   .      .     ...  ..  .     .  . . . . .   .   . .S    ..        .   .. ..  .   .    ..
...   . .. . ..  .  . .  .   .  .       .      ..    .     .. .   . .. .      .    ..    .. ... .        ...    ..
..................................................................................................................
