.........................................................................................................................................
. .       . .     .       .  ..            .            .  .. . .    . . .     .             .       .       .    . .  . .   .          .
.  ..  .   .. . .  .  .         .       .    .       ...  .    ..     .     .      ..  ...    .  ..      ... ... . ... .      .     . ...
.   .                   .          .... .    .     ....  ..     .  .         . . . . .   .     .. .   .        .   . ..   . .   .       .
. .    .    ...         ..     . .    .     ...       .   ..   .   .     .    .      .  ...     ..   .   .         ...        .  .      .
.  ... X . .             .      .   .   ..           .   .           ..      .   .   ...  ..   .           .   .. .     ...    .       ..
.  .       .                  .          .  . . .          ..    ...    . .  .. .   .  .   .  .   .           ..   ...   ..   .    ...  .
..       . . .    .  .     .. .      .       .  .             .          ....  .      .    .             .        .          .   . .  . .
.     .  .      .   . .   . .    . .  . .     .   ...   .  .. .   ..   .    .   .. .   .  .      .  .. .  .  .        .  ..  .     . .  .
. .    .          .         .  . .        . .          .   .         . .   .            ..    .   .        .   . .       .  . .. . .    .
.  .  .. .       .      . .       . .     ..           .      .  .          ...  .   .       .      ...  . . . .   ..     . .     . ..  .
. ..                . .  ..  . .    .  .. ..            .  .. ..   .              . ..   .  .         . .     .   . .      ..  .   .    .
.. .     .  .  .  .  .              . . .        ....    .       .          .    .        ..     .  .   .     .   ..  .   .  .   . .. . .
.   .     .. ..                    . ..      . .          .  ....        .     ..      ..      .  .  .. .. .  ..    .          .    ..  .
.  ...   .     ..  ..       ...       ... .         . .            ..      ..     .         .   .    .. ...   ..    .  S  . . .. .. ... .
.  ..      .  ..  .  .      ..      .  .   .       ..    ..     .  .    .   ... .  .   ..            ...  .   . ..       .     .   .    .
.........................................................................................................................................
