........................................................................................................................
...  .    .     .   .       .             .        .  . .     .  .                      .      .      .  . .    .     ..
.       X .         ..   S        .     ..          .   .      .       .    ..    . .     .                           ..
.  . .  .            .        .     .   .. .         .        .           .                            .  ..     .     .
.              .      .      ..     .   .  .              .   . .                .        .                       .    .
.          . . .  . .  . .                     .     .     .     .    .        .  . . . .        .     .    .  ...     .
.    ...                      .  .      .     ..             .       .    .. .   ..       .     .    .            .    .
.        . .                     .      ..           ..      .        .                 . . .         .      .   .   . .
.            .      .       ..         .  . .      . .    .          .      ..                    .    .   . .   .    ..
.     .      .     .         .          .  . .        .       .    ..        .   .        .    . . .      ....       ...
........................................................................................................................
