........................................................
.            .. .              .                   .  ..
.     .     .                              X    .   . ..
.  . .    .. .   .  .   .                .            ..
.               S                         . .          .
. .        ..          .     . ..         .   .        .
.         .  .      .  .  .             .   .          .
.     .                                     ....    .  .
.      . ..          ..              .. . .            .
........................................................
