......................................................................................................
. . .  ...   . .. . .    . ..   .    .   ..          .   . . .   .         . .      . . .. .   .  .  .
..  .  .       .      .     .      .     ..    .  . .. .        .   .       .  .   .  .  . . ..  .  ..
..        .  .   . . . ..  . .    .          .          .      .    .    ...           .     .  .    .
.  .     .  .  .  .   .  .    .   . . ..       .   .   .       . . . .   ..         . . .          . .
.       .  .  .    .    ...        . .       ..   .        ..       ..  . .    ....    .       .     .
.. .  .      .      .  . . .  . .  .             .      .  . ..  . S.   .  .  .            . .     . .
.  .   ..           . .    ..      . .        .        . . .. .     .  ..   .  ... .         ..      .
.       .                      ..  . . .  .  .       .  .  .      .     . .        .     ..    .  .  .
.    .X   .  ..   .   ...        .        ..      ..               ..      . . .     .    ..     ..  .
. . .      .          .     . ... .     .  . .         .         . .  .   ..    .       .            .
.     .  .      ..... ..  .  . . .   .    . ..  .   . .        ...      .     .    .      .  .  .    .
.   .    . .      ..  .  .     .              . ..  .    ....         .      .         .       ..  ...
.   .   . .     .                .   .     .      ..      .    .  .    .         .  .      .   .     .
......................................................................................................
