................................................................................
...  ..          ..          ..   .    . .  .    .      .       .   .  .    . ..
.   .     . .   .  S.         .  .      ..           ..    .   .        .      .
. .     .           ..     ...   . .     .  .    .  .      .. .          .     .
.. .   .   .  .          .   ....      .  . ..            .        ..    . .   .
.   . ..     . .     .   .  ..       . . X    . .     .    . .      . .. .     .
.     .               .     ..       .. . .        .   ..   .. ..   .     .    .
. ..       .  . .    .  .       .... .  ....  . . . ... ..  .     .    .   ... .
.     .         .    .   . .    .. .          .    . . .          ..        ....
.       ...        ..        . .. .     .  .  ..  ..   .   . . ..   .  .   .   .
...    ..      .  .   . .  .   .   .. .     ..       . .   . .             . . .
................................................................................
