.................................................................................................
..    .                .         .     .  .  .                    .       .        .            .
.        .   .   .   .. .    .                  .          ..           .                      ..
.   ..   .. .        X .               .  .    . ..                  .        . .  .           ..
.     ..        . . .                     ..    ..         .     .   .     .       .      .   ...
.   .   ..             .   .      .     ..     .    .   .    .  .            .      .     . .   .
.          .                                       .. .    .       .    . .   .  .              .
.. .        ..     .      .  .       .        .        .           .           .                .
.   .        .   .                       ..    . .              ...    .    .    .        .     .
. .     ...         .     .          .   .          .   .    .  .    .  . .   .               . .
.                     . .       .                 .                                   ..        .
.  .     . .        .                   .                   .          .       .            . . .
.   .  .  . .      .   .    .          ..                .           .     . .           .      .
.           .      ..          .                          .. . .      .                        ..
.      .  .           ...     .      .        .           .        .  .  .    .  .         .    .
.  .            .        .  .  .       .       .  .                 .       . . .  .        .   .
.                         .                .      ..        .                                .  .
.   .                       S           .     .       .      ..           .         .  .        .
.    .    .       .                       .            ..   .   .  .                         .  .
. .                   .       . .              .                      .       .    ..           .
.    .             ...   ..              .           .  . .     .     .    .           .    .....
.         .     .                          .                    ..          . .   ..           ..
. . .       .  . .     .                 .                   .             .                    .
.  .  .  . . .  . .  .   .       .                       .         .   .           .   .      ...
.    .                       .                              .                          .        .
.                       .    .        ..                           ..     .             .       .
.            .         ..                   .. . .            .          .   .     .    .       .
.  .    . .  .       .                     .   . .                  ..        .     . .     .   .
.       .  ..       .        .     . .    .        .                  .                        ..
.................................................................................................
