...........................................................
. .. .  ....  ..              ...        .     .  .       .
.     .. ..    . ..  .  ..      ..  ..  .  .        . ..  .
.   .  .  ..    .    . .   ...  . . ..    .  .    . ...   .
.  . .  .   ..         .  .  .   ..                ..    ..
. ..    .     . . ..  .   .    ...   .  .    . .  . ....  .
.    .   . .. . . ..  . .   . . . ...  .   .      . .     .
.. ..  . ..    ...   .   . ..     .              .  S ..  .
. ..  .. .                    ... .   ..       .   ...  ...
...    . .  .     . . ..  .   .          .       .       ..
. .. .     ....    ..        .       .  .  .    .         .
. ..   .  ... .      . .. ...             . .    ..  ...  .
. .. .   ....          ..  .           .   ..      .  .   .
. .       . ... ...   .         .   ..X ..     ..   .   ...
.  ..   ....    . .          .  .   .  .      .. .    .   .
.   ..    .   .    .  .  ..       .         . . .       . .
. .   . .         .  ..    ..   ..  .  .     ..  . .  .   .
..        ..    .    . ... .        .  .   .           .  .
.   . .   ....   .  .  ..    .  .   ..    .. .  .   .   ...
.  .  . . .   .  . .. .  .  .        .     .     .      . .
.        ..    . .     . . . ...      .. .      . . .     .
....               . . ..       .  ..   . . .. . ...   ....
.   .. .       .          .. . ..           . . .   .   . .
. .  .       .. . .   .   ..     .     .      .   .  .  ...
.         .             .   .. .  ...   .   .  .       . ..
.     .     . . .      .        .. .                   ....
.   .    .       .. ..  .   .  . .   ..       .  . .     ..
. .        .       . .  . .    ...         . . .     . .  .
.   . . .  .. ..      . ..  .  ..    .   .  ..  ...       .
...........................................................
