......................................
.  ..         .  .    .           .  .
.    .      . .     .    .  .   . .  .
.   .  .  .        X   .  . .      . .
.       ..   ..  .        .. .. .  . .
.            .     .               . .
. ..         . . .    .       .   .  .
..  .  .          .      . .. . .   ..
.  .  .   . .       .          S     .
.  . .   ..       .. ..           .  .
.  .      .                      . . .
.                 ..   .             .
.       .  . . .  .   .  . .  . .   ..
. ...  .  .   . .       .    ..      .
.     .           . ...  .. .        .
.   .   .    .    . .         . .  ...
..       .    ..  .    .         .   .
......................................
