.............................................................................................................................
..  .                . ..              ..      ...      ...  ..     .     .  .     .  . .  .        .  . .       . .    .   .
.    .      .    .    ..  . .       .        ...   .   ... .. .         ...            .                 .         .....    .
.  ..  .  .    .  ...          .  .           .  .         .  .         ..  . .       .   .  .    ....          ..  .       .
.  .    .   .      .  .. ...           . .    ..   ..   .   . . .     .   .    . . .. .. .     .      .. ...   ..  ..    .  .
.      ..  X       .       . .  .       ..  .      .  .. . .   .  .     .            .   .     .       ...     . ..  .    . .
.. ..      .         S   .  .         .     . . .. .. .            ..  ..      .    .   .  .     ..     ..  .   .  ..    . ..
.         .   ... ... . .      .    .   .     .       . .  . .    ..  ..   .   . ..                 . ..     ...  ..       ..
.         . ..        . .   .... . ..        .   .  ..                    .   .   ..     . . ..   .       .  .. .           .
..  .   .  .      ..         .    .          ..       .     ...     .   .  .     . .  .   ...  .    . . .. .     .         ..
.. .   . ...  . . .   ..     .  ..  .    .    ..   ..       ..    . .    .           .   . .          .    .     .     .  . .
.      .  .  . .      .       ..  .          .   .       .     .          ..  . .   ... .   .  ...  .  .     .   .          .
.   ..  ..              ..   .     .  .  ... . .  .           .           .  ...   .   ..  ..    ..     .       .        ....
.       ..   .          ..  .   .    . ..    ..   . . ... . .         .    ...  .. .    ..           . .  .   .  .  .     . .
.. ...    .          ... . .      .  .      . ..    . .   ..           ..    .        .   .      .. .   .. .   . .  . .   ...
....    .        .. .          .  . .   . . .  . . . . .  .  . .    .           ..    .      . .      . .  .    ..    .  .  .
..  .     .     ..  .  .  .. ..    ....  . .  .   .    .   .    . .  .    . .   .   . .. .       .. .    .              .. ..
.............................................................................................................................
