.............................................................................................................
.        .    .  .   .                  .    .          ...           ..     .     . . .    .         .     .
.    .   .         .   .     .   .. .     .    .            .    . ..  . .        .             ...      .  .
.  .     . .     ..          .     .   .      .  .        .              .      .     ..               .  . .
.     .  .     ..  .                    . .. . . . . ..                .    .           ..   .            . .
.          ..        .  .  .  ... . .    .  ..           .    ...                      .  .     . . ..      .
.  .             .   .             . .   .   ..                ..       .    .  ..     .   ..            . ..
.                .    .    .                     .         .  ..   .. .   .. .         .       .. . .      ..
. .. ..                          .    .  .      ..      . .   .                        .            .       .
..      ..           .                         .     .  .        . .             ..       ..          .     .
.        .  .   .          .   .     .   .. .               ..  .  ..  .       .          ..   .     .    . .
. .   ..      .  .  .         .  . .     .        .     X.        ...    .      .   .         .            ..
.    .          .   .      .. .  .   .         .  . .    ..                            .         .   .      .
.       .     . .          .    .              ...       .           .   ..   ..  .          .         .    .
. .   .     .    ....  ..    . .            .       .   .. .      .              .   . .  .    . .    . .   .
.   .   . .       .       .      ..    . .        .  .     .  .   . ..    .  .    .      .               .. .
.        .        .            ..         .      .   .   ..       . ...  .         .      ..         ..     .
.               .      .     .       .   .   .     .     ..       .   .     .   .  ..  .  .   .   .         .
. ..     ..    .      .       .                  .    .                         .  .                 .      .
.                     . .    .         .   .  .   ..                            .     .       .     .  .    .
. .  .    .    .             .     .    .      .       . .  .   ..                   .      . .        .    .
.       .              . .         .        .   ...       .   .     ..  .        ..                         .
.. .         .    .        .   .      .     .  .      .        .        . . ....    .  .       . .  .       .
.     .       .           .  .     ..  . .  .   . .   .   .           .  . ..  .             .     . ..     .
.   .  ..   .             ..    . .   .     .     ..                   .       .   ..   .  .              ...
.         .   .      .       .   .  .        ...          .   .    .  .. .    .              .              .
.   .    .             .    ..    ..    .  . . .  S           .       . .      .        .         .         .
.         ..      .   .  .   . . .  . . .      .                       .         . . .      . .      .     ..
..  .         .      . .    ..             ..            ..    .      .   .          .    .                 .
.............................................................................................................
