............................................................
.   ... ..     .  ..     .   . .        ..      . .  .     .
..   ...  .      ..     .  .  . .                  ... .. ..
..      .. ...   .   .      .  .    ...    .      .... . ...
.  .  .       ..        ...  ..    . ..     .   .          .
.S.      . .       .           .      .     ...       .   ..
.   .     .  .       ..  .   .           .  . ..      .. . .
.    .  .     . ..    ... ..   .   ..  .   .    .. .   .   .
.  .  .   ..  . .  . .. .        ..    .      . .  .. .    .
.     .  ..   .. .  ..        ... ..    .         ..       .
.. ..   . . .    . ..   .          .. .         .       .  .
.   . .          ..  .   .     . .  ..         .    .      .
. .. ...  .           . ..   .  X.      .      .   .. . . ..
..  .     .  .  .. .     . .    .    .   .         ..      .
............................................................
