..........................................
.   . .    ..  .      .             ..   .
.      .. .. .    .   .       .      .  ..
.             .    ... . .   ... ... .   .
.  .... .           .        .        .. .
...     . . .         .    .  .       .. .
.     ..           .   X .      . .      .
.. .                     .     . .       .
..  .   .      . .        ..   .  .   .. .
. .    .    .     . .    .    .   .   .  .
.       .      S .    .        .  .     ..
.      . . . .            .         .. ...
.             .         ..          ..   .
..           . . ..   .  .       . .. .  .
.       . .            .   . .       .  ..
.       . ..   ..     ....          .    .
.     ..  .          .     . ..   .      .
.   .      ..  ..                  ..    .
.         . .  .       ..    .      .. ...
..........................................
