...............................................................................................
. .    .       .    .    .     ...         .  .  ...  .   . .    .  .         .      .   .   ..
..     ..  . .              ..               . .           .             .    .. . ..     . ...
.  .      .        .  ..           .    .            .  .      .   .             .        .  ..
.. . .      . .     .                 .             ..     .    .               .             .
.      .             .     . . .. . .             ..      ...             .    .       .      .
.     .    .     S .   .           .    .             .       .  .    ..                 . .  .
.  ..                 . .  ..   ..     .     .                . .      .          .     . .   .
...            .                   .     .        .   .           .. . .                .  .  .
.  .     .     ..                      . .      .         . .  .   .    . .  .    . .  ..     .
..                  .     .X                             ..                              ..   .
.              .             .                . .        . .. .     .    .         .          .
.    .     .            .     .                       .     .      .       .      .   .      ..
.   ..    .  .                 .  .        ..    .         .        . . .          .  .  .   ..
.            . .  .              . .   ..          .      .          .              ..       ..
.        ..   .     ..               .            .     .            .   ..     ..    .   .  ..
.  ..      .      .     .    .             .     .    .      .    .                      .    .
.        ...   .  .     .       ..      ..       .    . . .    .              .          .   ..
.   .  .    .  . .  ..      .    .       .                       .                  .    .   ..
.     .     .  ..    ..          . .  .    .      .. .        .        .. .     .  . .      ...
.         .           . . .     .   .    ...     .                       ..               .   .
.  .               ...      .  .           .   .      . .   . .    ..     .         .   .  .  .
.       .   .    .    ..    .   .    .                    ..            ..       .     ..     .
.              ...    .         .                  .          .     .  . . .    .. .. .       .
. .  .   .       ..      . .           .   .              . .    .. . ..  ..    .         .   .
..   .     .      .   .         . . .          .              .   .     .     .     .       . .
.  .     . ...    .                     .         .      . .        .      . .      .         .
...............................................................................................
