.....................................................................................................................
. .  ..     .  .    . ..    ...         .         . . .    .  . .          .. ... .  ..     .    ..  . ..   .     . .
.  . .   . .     .. ..  .      .    .    .   .  . .   ..   .. .  .     .        .  .. .   .   .     ...  .  .. . .  .
.      .. .. .  . .           .. ...    .   .       . . .  . . ..         .       .   .     ..   ...  .  ..    .   ..
.    .  . . ..  ...    .   . .  ....   ...  .     . .  .     .   .          .       . .  .  .  .      ..  ..       ..
.    .  .. ...     . .   ..   .  .       .    . .  .  .  ..   ..      ..      . . ..     .           .   .   .. .   .
.   .   ...     .            . .  .. .        .   . .    ..       . .       . ... .  .  ...             .    .      .
.    .  .   ..    . .   ..     . .            ..   . .       . .       .               .          .   ...       .   .
. . . ....   . .  .   .   . .   ...    .   .. .       ..    . ..   .  . .       ..       ....    .  .. ... .   . .  .
. .          . . .     .    ..  .    .     . ...     .    . .   . .       . .  .     .   ..   S    ..  .   .X  .... .
. ...    ..       .        .. .  .    .   .   . .   . .   ...  . ..  . . . .   .. ... .       . .  .    . .  .      .
..   ..    .. ..    . .   . . .    .. ..  .      . . .   . .....    . .  .. .   . .   .   ..   . .  .          . .  .
.  ..   . . ..   ... . . .     .....  .   .           .   .   ...    ... . ..   . . .   .       .  .... . .   .    ..
. ..     .. . . ...  .  . .  .  .     .       .       .   ...   . . .. . .      .    . .  .   .   .         . .  .  .
.    .          . . .    .. .  .    .    .      . .     .. . .   ..            . . .    ...         . .         .. ..
. ..   .     .   .. ..  .    .     ..  .    .. .             .    . .  .   ..   .    .    ... .   .. . ..    .  .  ..
.....................................................................................................................
