.............................................................................................................................
.   .      .         . .        .   .           . . .    .      .             .     .                   ..               . ..
.. .     .      .           .    .  .    .  .         .  .  . .           ... . .        .        .         ..              .
..             . .    .       .  .      .   .     .        .     .    .     . ..    .  .         .      .    .  .   .       .
.  ..       .      .    .      .      .     .  .      .      ..     .    .    .     ..     .    .. .    .     ..            .
.            .  .     .                 . .. .   .X      .      ..  .           .            ..     .    S     .   .  .   . .
.. .   .     .        ...           . .      .       .     ...     .   .     .    .    .     .         .     . .         .  .
. .     ..  .    .  .     .  ..               ..    .            .   ..   .    .  .       .        .       .     .  .. . .  .
..        . .       .           . .  .  . . .      .   . .                   .    ...         . .  .     . .   ..          ..
.   .             .  ..   .    .            .     ..                     ..     ...                  .     .   .            .
.             .           . ..           .  . .   ..  . . . .  ..     .     .         .     .   ..        ..     .          .
.         .               .  . ...  .     .                      .    .      ..          . .      .    .   .               ..
.              . ..   .       .    .   .     .   .     .         .      ..    ..      .          ..     ..    ..    .    .  .
.    .    .         .        .               ..          .            . ..    ...             .    ..  . .  .               .
. .   .        .     .   .  . .  .  .   .       .... .              .   .          . . .  .     .   .                 .     .
.............................................................................................................................
