..............................................................................................
.                        .               .      ..   .       .  .             . .            .
.           .             .     .        ..         .     ..       .          .              .
.                                           .    .         .             .      S ..        ..
.       .                                  .               ...  .    .  .      .   .  ..  .. .
.                 .                       .              .            .               .  .   .
.     .                .     ..         .             .   .   .    .               .         .
..     .                .          .           .   . .         .   .         .      .  .     .
.       .     .  .. .        ..    ..   . .    ...             . .   .                       .
..       .  .  .       .            .       .               .    .      .       .      .   . .
.            . ..        .                                .          .     .   .   .         .
.            .          .   .          .         .       .        .           ..      . . . ..
.   ..     .      .            .                   . . .     .     .             .      .   ..
.  .      .                  ..                .                    .     .      .     .     .
. ..      .       .   . . .     .    .   ..   .      .                  .  .               . .
.       .               .    .               ..    .                 .      .               ..
.        .        .                              .   . .             .   .                 . .
.        .       ..          .    .         .        .     .      .     .                   ..
.                   X                   .            .             ...     . .    .  .  ..  ..
.  .          .           .    .     .                     ..    .                           .
. . .  . .            .     .         .      .               .     . .           .           .
. ..    .                                . ..     .   .                                      .
.   .                 .                     ..                         .                     .
.               .. .    .                        . .      .                 .      .         .
..............................................................................................
