.........................................................................
.  .   ..    .      .. .       .     S   .  .        .. . .   .  .  . . .
.       .   .                       .                .     .  .   .   . .
.                   .  .           .                  .                 .
.         .X   ..       .       . .    .         .                      .
.    .       .  ..               .        .                 ..   . ...  .
.           .    .        ..         .            .    .    .        .  .
.              .        .                            .    .             .
..          .                           .                  .   .    .   .
.........................................................................
