.........................................................................................
.        ..       .       .  .      .       .               .      ...  .     .       . .
.        ..     . .     .     .                .    X                    .  .         . .
.    .        .  .                        ..              .     .       .  .      .     .
.              .     .     .  .            .                  .       .           . .  ..
.                   . . .   .         .           .             .          .    .  .  ...
.                ..      ..         .    .    .              .          ..   .   .      .
.. . .               .          .               .     .            .    .    .          .
. .                                   .    . .          .       . .  .   .   .          .
..                                 . ..   S      .  .     . ..                          .
.    .   .        .      .        .. .             .  .   .     .               .       .
.       .  .   ..            .    .   .  .  .      .            .      .  .       .   . .
.       .          .      .  .  .   .       .  .         ..          .  .         .  . ..
.             . ..      ..                   .       .    .      ..     ..            . .
. .  .              .       .      .                ...    ..   .  .    .  .         .  .
.........................................................................................
