.......................................................................
.     .       .      X     .                                .     .   .
.     .     . .   .     . ..   .             .                  .     .
..             .  .  .    . .   ..    .                               .
.             .     .    ... .                        .              ..
.    .  .            .                        .                   .   .
.. .             .   .                                                .
.                                         .           .   .   .  .    .
.       .    ..       .     .       .           .   . .    .    .    ..
.         .         .  .           ..        .       .      ..        .
.   .      .                      ...   .             .               .
...        .                                    .    ..      .    .  ..
.                           .     .                               ..  .
.   .     .        .   .     .   .         .    .  S.                 .
.                                      . . .               .       .  .
.......................................................................
