.......................................
.   ..    .   ..  . .     . .   .     .
.  ..  ..  .      .    . . .      ..  .
..  .  ..            .   .      .     .
.                   .       .   .    ..
.  .            .  . .            .   .
.. .              ..      . . .  .    .
..             ..  .        .         .
.  ..   .       .  .      ..        . .
.         . .. .    .                 .
.         . .S .. .  .  X  . .        .
..       .  .   ...               .   .
. . ..       .        ..  ..          .
.. .      . .   ..      .    .   ..  ..
. .       . .  .      .   .    . . . ..
.......................................
