...............................................................................................................................................
.         .       .     ... .    . .                  . ..  ..  ..  .  .   .             . .            .  .  ...       .    . .     S     .  .
.   .  .  .  .       ..   .  .             .   . .     . .   .          ...               .      .           .       ...    .      .   .     ..
.    .      .      ..      ..    .     .  .     .     .           .   . ..    ... .    .  .              ..   . .   ..         .. .     . .   .
.    .           .    .       .     .                    . .            . .       . . ..   ..    .      .         ....  ..   .            .   .
. .      .   .  .          ... .  .  . . .                  ..   .   .    .     .  .    . . . .     .    .  ....     .   .      .   .         .
.          .. .  .    . .                  . .   .   ..          .          . .           . ..        .      .   . .       ...  .            ..
.   . .  .      .      .                .          .       . . .    ..   . ...       ..     . X     .     .              .  ..    .           .
.        .  .             ..               . .       .   .        .  .. .            .   .                ..    .       .    ..       .   .   .
...............................................................................................................................................
