...............................
..    .         ..   ...  .  ..
.        .              .    ..
. .       .        .  .    .  .
..     ..           ..  .  .  .
.. . . . .     . ..      ...  .
.    .     .  . . .     .   . .
.             .       .  .  X .
..    ..   . ... .    .   . . .
..    ..  ... .  .  ... . .   .
.     .        ..     ..      .
.      .     .   ..     . .   .
. . .....     .   .      . . ..
...      .    ...             .
.                    .        .
.          ..      .. .   .. ..
.  . .. ..        .           .
.        .    .  .   .        .
. ..  ...  .. .     .   ...   .
. .    . .    ....      .  ....
.                          .  .
.  . ..   .  S  . .      .    .
.    .      .     .          ..
.   .   . .    ..        .    .
...............................
