.......................................
.                                     .
..       ..           .  .     .    . .
.  .  .     .   . .  . .            . .
. .     .    .     .                 ..
.   .                                 .
.                     .               .
.  .  .                   S        .  .
. .                        .          .
.  .      .  .   . . . ..             .
.  .                  .       ..      .
. .    .  .   .                    . ..
..        . .      .      .           .
.              .         .            .
.              .      .    .          .
.    .                  X..     ..    .
.  .        ..                     .  .
.           ..                    .   .
.                      .              .
.       ..        .   . .   .         .
. .     .. .                        . .
.      .        .    .  ..     .      .
.   .                .         . .   ..
.    .    .                     .     .
.. .               .       .   .      .
.       .   .        .    .           .
.......................................
