.............................................
.    .      .   .  .       .             .  .
.          .  .     S . .    . .   .     .  .
.       .      .          ..       .        .
.      .         .    .      .  ..          .
.        .    .   .    .         .         ..
.      .. .   X    .          .  .  .       .
.            . .      .    . . ..     .     .
..  ..  ..   . .        .  .  .   .         .
.  .   .  ..                .         ..    .
.............................................
