..................................................................................................................................................
.     ..   . .              .                     ..    ...                  .  ..  ...  .. . ... .  .         . .  .         .      .   ..      .
.                              ..           .                      ..    .  .    .  .   . .     .     .                  .  .      .  .  .    . ..
.         .   ..                       .         .          .     .                                   . .     . . ..          .  ..       .      .
.                   .             ..    . .    .                 . .      .               . .             .  ..    . . .                         .
.   .    .     .      .  .              .      . .       .   .             .                         .    .       .  ..             .. .     ..  .
.  .     .  .   .          .            . .    .      . .     .              . .                             . .        .  ..        .         . .
.    .   ..   . . .     .  .                                                  .   S             .  .       .       . . .        . .       .. .   .
.    .            .    .           ..  . .     .            .   .. .            .    .                   .       .         .                     .
.                . ..      ..              . .         .          .          .          ..       .   ..           .   .  ... .  .                .
...    .               ..   .         .    .   .     .        .   .   .         . .               ...   .              .                  ..     .
..           .         .             .  .             .    .         .        .       X  .     . .   .            ..    .   ..  .       .        .
. . ..     .   .           . . .              .        .                     .             .   .                            .   .           . .  .
..       ..    .  .         .   .   .  .               .   . . .  .       . .         .     ..      .    .            .     . .        .  ..    ..
.       ..          .             .  .     ..  .     . .                      .  .  ..           .          .   .      . .  .  .     .   .      ..
..................................................................................................................................................
