.............................................................................................
.   X     .               .      .                    .    .    . ..  ..         .   .  .   .
.    .     .               .      .             . .     .   .                               .
..          .         ..     ..               .      .                 ..          .        .
..   .               . .                .  .                .  .   .     .     .  .         .
.                         .            .                      .     .  .                    .
.      .       . .       .     . .            .              ..   .        .        .       .
..  .  .  ..            .  .     .               ...         .   .  . .     .     .     S.  .
.   .     .       .        .    .  .      . .   .    .                 .  .               ...
.                            .           . .    .         .  .       .     .            .  ..
.    .                                .      .  . .    .    .                          .    .
.           .    .         .         .      .       .                  .   .  .          .  .
.............................................................................................
