...................................................................................................................
. .       ..    . ..     ....  .  .     ....  .  .  .  ..  ..        .       . .   ..            ..    .     .  ...
.  .    .  . .  . .   .. .       .  .   .   ...                .          ..   .. . . .  ....   .  .    .    . .. .
.     .  .. .  .    ..     .   .  ...  .          . .   . .  .      .        .      .      .. .   .  .  .. .  .   .
. .X..      .      .  ... ..  . ..       .   .    .   .. ..    .    .        .     ..     .  . .. .   . .  .    ...
.. .   ....    ...       . .      . .  . ..   .   .        . .              .  ...    . .         .  . .          .
.        . .   .    ..  .. .   S . .   ..  . .      ....   .  .. .. . .  ..  ..        . .. ..  .          .      .
.  . .  . .          .    .  .    . .  ...             .   .  ..          .            . .. ..              ..    .
...     .. . .     ..    .         ..   ...  .   . . .         . .  ..  .   .. .   ..     . . ..  ..   ... .  .   .
. .      .      .   .    . .   .     .  .   .  . .         . .      ..     .     .     .      ..  .    ...      . .
.        ...       . .  .  . . . .   ...  .       .          .   .. . .....    . .          .       .  .   . . .. .
.  .  .  .  .. ..  . .          .   .     .     .      .  .      . ....    .    .   .   .  .         .. ....      .
...................................................................................................................
