..........................................................................................................
.     .  .      .   ..    .  .          ..             .    . . . ..          .  . .    .. ..  .   ..   ..
..       .   .        .     . .      . ..     .    ...     .  .      .  ..    .  .      ..      .    .  ..
.  .         .      . .   .    .   .   .           . ...       .          . ...  .          .  .         .
.   .       ... ..   .  .      .  . .   .  .     ..    ....  .   .   .  ..   .    .     .      .         .
.  ..    .    .   .    .       .         ..   ...      . .           ..  .     . .   ..   .. .     .     .
.    .  .  . .  ... .  ..  .            .. .    .   .      ..   .    . .        .      .  ....  .  . ..  .
.   . . .     ..              .    .   .  .... .        ..     .             .        .  .     .. .      .
.     .    .         ..  . .           .       .    .       .  ..     . .   .. .    .        ..       . ..
.                 . .   . .   .     .        ..     .   .    ..    .          .           .   .  .       .
.      .    . .      .    .. .. .  .. . .. . .        . .     .    ... ..     ...         .        .  .. .
..    ..         ..      .        .    .   .       .    .      ..     ..  .   ..     . .         . .  .  .
.   ..   .     .   .      . .   .              .  ..    .     . .  ...         .            ..    .      .
.       . .     .  . .   .   . .                .           ...     .      .      .    ..   .   .  .     .
.   .     ...    .  ..   ..   .        .                            ..    .     .  . ..   .           . ..
.  . ...   ..     .  .       .   ..    .. .                          .. . .  ...        .           ..  ..
. .     .    .     ..    .      .   .          ..  .    .. .       .  . .                             .  .
...                   . . .         .     ..   .         .  .    .    ....   .    .   .        .         .
.     .  ...     . .   ... .   .         .    . . .    .  .             .  . .         .   . ..          .
..  S   .          .              .     . . ..     .        .           .    .   . .   .    .  .  .      .
.   .  .  .           .  . . .    .  .. . .    .     .     .     .  .. .         .     . . .   .       . .
.    . .    .  . .   .  .   . .                .   . . . ..      . .  . ..       .     .                ..
.    .   .  .  .  .   ..   . ..  .   .   . X .  ..         ..    .  . .    . .   .   .    .    .   . . . .
.    .     .    .. ..     . ... ..        .  .         .. .         .      . . ..    . . .  .        .  ..
.. ...   .  ..    .      .    .      ..    .          ..  .              .    .  .        .     .. .     .
.   .          .          .      .  .      .            .    .        .  .           .  .   . .  .       .
.   ..  .          .  .   .    ....          .   .   .   .  . .                      ..     . ..       . .
. .     .  . .            ..             ...    .        ...   .        .        .      ..   .   ..      .
.      .   ...  ...   .    ..    .    .   . .          .  ...       ..         .       .  . ..   .      ..
..........................................................................................................
