...............................................................................................
.   .         .     .  .         .         .  .       ...    .   .      . .        ..         .
. .    .  . ..    .      . .               .       . .... ...   .  ... ..  .             ..   .
.    .  . .          .   .   .     . . . .     . ...        ..      . ..   ..    .  . ...   . .
.   .    . .    . .. . .          .     .       .  .  .. . ..  .  .   .               .  .   ..
.  .   .     ...      . . ...  ....                  .       .       .         .        ..   ..
.      . .. .  .    .      .  . . .    ..  .    . . .    .     .  . .    .. .      .       .  .
..  .  ...  .     . .  .  . ..   ..  ..         .  ...   . ..  .      .       . .          .  .
.       .    .  . ..    .    .     ..     .      .        .   .       .   .  .     .   .  . . .
.          .   .   .     .. ..   .       .   . ..     .          . ..  . .   . .             ..
. ..  . . .   .  . .   .. .  .   . .           ...          .   . .  . .             .      . .
.  .  . ..     .   . . .. ..  .          .    .  ...   .     .. .  ..     .   .          .    .
.  . .     . . .  .    .  .   .   . .      .        ..    .      .  . . . .     . ....  . . ...
. .     .                ..    .                       .. . ....     .        . .   .      .. .
.  .      . . .      .    .     . ... .   ..   .       ..   . .    .   .       .              .
. . .              .   ..  .     ... .          .       .           .    .       .X      .  . .
.      ..      .        .. ..      . .     .    . ..                 ..            . .    . . .
...         .  . .    .      .  ..      .     ... .  . .                 .            .     ...
.   .  ..    .                    ... . .    ....   ...    .  .   . . .           .  . ..  . ..
.    ..   .           .    .      . .   . .   .  .  .   ...   ..     .     . . . .   . .  .  ..
.           .   .    .      .   .                . . . . .    .     ..   . .     . .    . ..  .
..   .  ..  . .   . . .   . .   .      . . .         .    .    .  ..          .     . .    .  .
.             .    . .. .  ..  .        ..     .  .  .   .  .    ..           .. .            .
.  .   .   ..          ..  ..   .    .   . S       .  .         .       .   ... .      . .    .
. .    .    .  ..  .    .    . .  .     ..       .. . .  .   ..   .      ..  .   . .  .       .
.  . .         ..     .     . .          ...       . .                       ..  . . . .  .   .
.         .     .. .  .. .    .    ..    .   . ..    ...       .  . .    .          .     .   .
...      .  .            ....  .     ...         ..       .  .        ..  .        ..        ..
...............................................................................................
