.............................................................................................................................................
.  .      .    .     .      .       ..              .              .      .           .         .  .   .    .  ..         .   .            ..
.      .  .  .   . .              .   .   .     .    .         .               .                                                     .      .
.         .      .      .        .   .  .        .. ..  .         .  .      .  .                .    .         .   ..       . .     .  .    .
.       .   .    .                 . . . .   . .  .         .                .         ..       .                              . .          .
.                                                                           ..                                             .    .  .     .  .
.          .   .. .  .   . ..    .     .          .            .       .    . .  ..   ...              .   .   X   .      .   . .   . .  ....
. . .       ..           . . .          . .          .           ..       .      .  . .         ..       . .             . .         .  .  ..
.     .      . .                 .     .   . .     .    .S  . .     . .                .  .     .         .        .       .  .    .        .
.   .              ..            .             . ...    . ..       .   .    .    .                  . ..      .   ..             .     . .  .
. .                        .         .     .           ..      .  .  . .                .         .. .         .      .  ..        .        .
.           ..                          ...      .                        .. .       .    .              .      .          ..    .          .
.............................................................................................................................................
