..........................................................................................................................
...       .     .    .  . .  .  ...           .                          .   ...     .             ..    . .             .
.    ..   . .           ..       ..       .         .      .                        ..              .      . ..    .     .
..      ..  ..  .            .   . .             . .       .            . . .  .           S      .. . ...       .       .
.  .     .                     . .     .   .   ..     .    .   .     .         .        . .   .             .            .
.  .     . . .  .  .       . ..     .   . . .       ..    .              . .   .    .          .       .   .  .  X     . .
.   . .   .        .       .         .              .             . . . .     .                   ..      .              .
.        . .       .        . ..  . .    .   .          ...        .       ..         . .   .  .          .  . .       ...
.          .       ..      ..      .           .                   ..     .      ...          .    .           .         .
.      .   .       ...  .    .. .     .     ..  .  ..                    .          .   .    .   .                 .   . .
.      .   ....        .           ...    .  .                        .             .. . .          .  .   .      .    ...
.         .      .                  .       .  .    ..              .   .     .             .    .       .     .     . . .
..   .         .        .            .  .  . .   . .  . .      .            .            .         .      .     . .      .
.     ..       . .. ..  . .   .  ..        .     ...     ..       .                      .       .  .   .     .   .   .  .
.  .  .       . .  .  .     .   . . .  .   .                  .      .         .        .     .   .  ....    .. .        .
..........................................................................................................................
