................................................................
.     .        .  . .       .   .       ..            .  . ..  .
. .        .    .       .     . .      .             .     . . .
.  . . ..            . .        ...   .         . .  S       . .
.  .      .    . .     .   .    ..    .              .         .
.        . ..        . .               .      .      ...       .
.                           . ..       ..   .          .. ..   .
.   .   ..      .     .      ..       ..   .      .  .   .. . ..
.   .   .    . . ..      . .    .  .      .    .     ... ..   ..
.       .  . .  . ..   .   . . .          .            . .  .  .
.    .    ...            .    ..   .                  .. .     .
. .    ..  .   .            ..         .      .          X     .
.    .        .   .       ..     ..      .   .   ..      .     .
.          .                        .    .  .              ..  .
.   .       .  ...  .  .  .        .. .   ... .   .   . ..    ..
. .  ..    .     .    .          .    .  ..           .        .
.     .      ...       .       . .     .....    .. ..     .    .
.        . .                              .  .     . .  . .  . .
..  . .         .    .    ...  .   .        .             ..   .
. .          ..    .   .       .       .         . . .    .    .
.                .     . .. .       . .       .. .             .
..      .      .   .                   .      ..  .            .
..           .  . .  ...    .    .     .    .       . .. .   . .
...               ..      .  .  .          .   .. .  .  . .    .
................................................................
