................................................................................................................................................
.                  ..      .     ..     .       .  .      .        .    .    .      ..               .                             ...   .     .
.  . .  .  .                    .          .   . . .     ..      .  . .       ..          ...   .                   . .   .      .         .   .
.      .         .     . .   .     ..    ..    .  .    .      .      .        .  .                   .  .              ..        ..          . .
.     .     .          .   ..             .      .        . .          . .  .   ..      ..          .          .   .          .      .       ...
.               ..      .    .      . .              .     .                . .                 .  .    .    .  . .  .      .    .  .          .
.      .  ..   .                   .  .     .       .     S. .    ..  .           .                      ..         X.                .       ..
.       .              .             . .  ..         . ..             .           . .   .  .         .                . .                   . ..
. .          ..     .       .         .                 . .       . ..    ..       .    .   . .  .               .              . .      .     .
.  .               .   . . .                           .  .      .  ..   . .        .     . .   .   .   ..        .          .         .      ..
..   . .      .   .                    .       .  .     .  .    .     .           .      ...            .    .            ...          .       .
.  .  .     .                  . .         . .               .    ..  .              .      .    .                    .                .       .
.   .     .    .  .                 .      . .         .. .     .   .            ..   . .     .   ..   .  .                                    .
.         .          .                . . .   . .                                  ....              .       .     .           .      .      . .
.  .        .         .                   .   .              .     ..                . .    .                   .      .        .     .        .
.       .  .  . .    .                          .             ..  .  .         ..           .     .  .  ..          .       ..             .   .
.               .                          .   .  .                             .  .   .                    .  .      ..            .         ..
.         . . .                 .  .       . .. .           .       . .        .    .      ...  ...  .     .        ...      .      . .        .
..   .  . .       .                   .       ..       .       .  . ...    .      .. .            .  .      .  .     .               ..    .  ..
. .   .     . .   .                  .    .           .      .      .      .   .           .     .        .       .       .                    .
.   .          .             ..       .         .         . .          .             .     .           . .       ..  . .     .       .. .      .
.  .                .     .         .                .        .. .                    .         .  .           ..      .             .    .. . .
.                  .       .    .  .  .        .                 .      .    ..             .   .                ..                     .  .   .
................................................................................................................................................
