.......................................................
. ..      ..      .  ..     ..     .         .. .  .  .
....  .     ..     .      .       .     ....      .  ..
.   ..  ..      ...  ..     .                .   .   ..
.   .  .      .  .     . . . .    . .  .     .     .  .
....         .           .   .    . .  . .   ..  .X   .
.   .   . .       .  ..      .  .   .   .   .    . .. .
. .     . .                    .   .. ..       ..  .  .
.   .   .    .   ...  .     .   . .     .  .     . .. .
...     .          . .     ..      .      .    . .    .
....   .  .   . . .    ..          . .   .      . .  ..
. .. . .  .   .. .   .     .. .. .   .            . . .
.     .            .        ..  .             . .  .  .
. .         ... .. .S  ...     .  .  .      . .      ..
. . . . ..   .  .     ..                           .. .
.  . .        .  .   .    ..  ..    .     .           .
.   .    .   . .   .      . .      .   .  .   . .     .
.     .. .         . ..   .   . ..   .  . .    .      .
.......................................................
