............................................................
. ..         .     .   .  .     .                       .  .
.. .     . ...  . . ..   .     ...                .        .
.   .              .      .  .  .  .     .         .  .    .
.    .   .         .   .   ..           .   ..        .    .
.   .        .        .. .   .   .         .    . . .     ..
.  . .    .      ...    .    .    ... ..              . . ..
.  .                     .      ..    .     . .  .  .     ..
..          .   ...   .         ..   .    .     .  .  .    .
.     .                .        .             .       . ....
.   .  .    ..      ...     . . .       .        ..     ....
.     .  . .       ...              .        .  .  . .     .
.      . .         .   .   .. .    .     ..   ...       . ..
.     .                   . .     .    .    . . .    ..   ..
..      .      .   .   .   .       . ..      .     .  .. ...
.  . .    .     .           .           .  . . . .         .
.   X  .   .    .      .    .. .         .    . .          .
.        .    .. . .   . ...                      .   .   ..
.        . .   .     . . . ..   .           ..    .       ..
.  .  .        .    ..   .  ..   . . . . ..      . .       .
.      . .      .     ..         .   . . .     .  .        .
.  .          .          .   .                   .    S.   .
.. .                               .    .  .    .  .     . .
..  ..        ..   .         .    .   . ...     .   ..     .
.     .              .   .               . . .  . .   .   ..
..    .           ..                        .  .  .     .  .
..     ..     .  .                      .           . .   ..
. .                                 .   .                  .
............................................................
