....................................................................................................................................................
.   .       .            ..        ..          .  .    . .   .       .           .           .   . .      . ..   .             .               .  ..
.  ..           ..                  .   .. .               . .       .             .  .     ..    .      .           . . .   .   .         .  .    .
. .  ....               .          . .      .  .     .            .     .. .    . .             .            . .    .  .  .  .    .         . ..   .
..      ...  .. .        .  .  .  .          .  .         .... .    .        .      ..  .    .         .                                     .   . .
.           ..     .      ..           . . .        .         . .         .       ...  .  S .            ..     .  ..       ..   .  .       .      .
.                        .       .             .                  .   .... . .  . .   .                         .         .. . .          ..... .  .
.              .  .    .    .           .. ..   .   .       .      ..  .       .                .  .                   .       .    . .         .. .
.     .  .   . ..   .  .               ..         .        .         .           .  .    .                      ..  .               .  .          ..
.  .      .            . . .               .   .   .    .  .. . .  .    .     . .    . ...     .    .      . .   .  .      .       . .         .  ..
.         .  .    .      .  .   . ..      ..      ..        .      .     .. . .   .    .. .    ..       .    .      .  .    ..      .   .        . .
..  .      .  . .  .   . .   . .   ..               . .     .    . . .  .           .  .  X                 ..    . . ...                          .
.     .   .   . . . . . .        .            ..  .      . .   .  ..      .     . .     .          .   .  .   . .        .      .    .             .
.            . .        .    .                      .            .  .        . ... .      .. . .  .      ..   .    . .  .          ..       .      .
.  .   .  .  .  ..  .      .  ... . .         .            .   . .     .          .     . ..                   .  . .         . . .    .  ..      ..
.  . . .    .   .   ..                 ...   .          . . . .                             ..   . ..    . . . ..      ... . .                     .
.  ..    .         .   .  .          ...       .           .    .    .   .          .  .    .        .   .  .                      .        .      .
.         .                .         .. .       . . .         .    .               .               ..                          .        .  .     . .
. . .   . .. .        .   .       ..        ..     .          .. .          . . .  . ..         .     .      ..   ..   .     .        .. .  . .   ..
.  .  .       .   .          .   ... .  .     .  .    .   ...   .           .   .    . ..     .     .         .              .     . .  ..        ..
.. .. .         .   .       ....   .                  . ..      .   . .              .   .           ..         ..     ..     .    .    ..       . .
.     .                    .             ...             .   ..     . ..        .  . .      ..        ..           . .  .   . . ..  ..     . .     .
....................................................................................................................................................
