..........................................................................
.  . .    .   .             .  . .  ..  .  . .    .   ..      . ..    .  .
.           .... . . . ..  .         .    .       .         .            .
.              .   ...   .                 ....        .          . .   ..
.. ..   .   .    ..  ..  .   .    . .   .           .   . .          .  ..
.     . ..        . .   .                      .  ..             .   .   .
. .  S.              .           .         .       ..     .       ..  .  .
.     ..  .         ..   .     .    .  ..          .   .         .    . ..
.  .     . .   . .      ...  ..  . .   .         ..   .  ..      .       .
.                   .        .        . .    .    .          .   .     . .
.           .   .     ..  .    . .     .      .      ..             .    .
. .  .           . . .   .    .  .   .   . .       .         .  .  . . ...
.  .     ..    .X      ..    ...   . ..                 .   .      . . . .
.    .   .   . .               .                     .    ..      . .    .
. .        .   .  .  .   .            .      ..   .   . . .   .   .  . . .
. .   . .. . ..  .     .       .           .    .     .           .      .
.  .   .           .   .   .    .          .            .     . .        .
.                     .  .   . .   .                             ...   . .
..      .              .               .. .    .    .    .        ...    .
..    .   .       .   .    ..     ..    . . .     .                      .
...      .            ....    .       ...    .      ..        .          .
..     ..      ..     .      .          ..    .        .          . .    .
.     .                       .. .      .      .    . ..         ..   .. .
..........................................................................
