..................................................
.      .       .. .    .  .       .. . ..    .  ..
.          S.. .       .. .        .            ..
.  . . .    . .   .     .       .  X   . . ..    .
..    . .   .          .     ...   .     . .     .
.   .     ..          .  . . .  .   .....  . .   .
.  ..   .      .    ...    .         .     .  .  .
.. .            .  .  ..         . .             .
.       .  .    .            .              .    .
.          ..  .  .   .         .    . .    .   ..
.         .. .  .           .           ..  .    .
. .          .       . .                       . .
.   .  .   .     .            ..   .   . ..    . .
.          .       . .     .       .           . .
.  .  .     ..  .         ....    .  .  ..    .  .
.  .           .  . . . . .   . ..   .     . .   .
. . . .. ..   . .     . ..        .    .        ..
.     .    .      ..   .  .         . ..   .     .
.    . ..  . .   ..  ....         . .            .
.        .. .      .  ..    .    .. .       .    .
..................................................
