.............................................................
. . .  .       .   .   . .    . .   . .     . . .  ...    . .
....     ..    ...     .   . ..    .      .  ..     .       .
.     .   .       ..         ..  .    .            . ..   . .
.  .     ....    .  ..   .   . ...  .  .    .  ...    .  ....
.   .   .. ... ..    ..   .      .   .. .      . . . .  ..  .
.   . ..  .    .    .   .  .            .. . .      . .   ...
. .. .. .   . .. .   .      ..   ..    .      .  .   . .... .
.   . ...   ..      .   .  . .       .  ..   .. .    .   .  .
.  .    .    .. .    . .  ..  .   . .             ..     .  .
. ..  . .  ... .       .   .  .        .  ...    . .       ..
.    . .   .  . .     .. .....      .           . . ... .  ..
.      .    ..  .  .   . .   . .   .   ....    .  .  .   ....
.  .          .   .   .. .   .  . .    ...   .   . ..       .
. .   .....          .  .  ..   . . .      . .     .  .. .  .
.   . .   . . .  . .  .        .  .  .  . .. .   .    .. .  .
.              .    . . . .    .       . .     . .     ......
. .   .    .  .  .    ..  .  ..    ..   . . .. .     . .  . .
.. .  .. .  .  .S.. ..       . .       . X..     ... .   .. .
.   .     . . . ...  .       . .     .    ....   . ...      .
.............................................................
