...........................................................
.     .  .            .             .             . ..  . .
.       . . .  .  . .    ...   .       . .            ..  .
.    .        .                 .  .   .                  .
.     .      ..    .                    .   ...  .   .   ..
.          ..    .     ..   . .       .    .      .       .
.         X   .     .                                . .  .
.  ..          .   .  .    .  .    .    .  .     .      . .
.                 .              ..   .  .. .   ..        .
. .    .                       .         .   .   .     .. .
.  . ...                . . .             .      .        .
..     .   .   .. ..      .      ..        .    .  .    . .
.            .. ...   .     . .         .      .    . .   .
.                  .  ..      ..  . .       .     .       .
..           . .               .      .           .      ..
.          .        .            .    .                   .
..  .. .. ..        . .    .   .          .          . .  .
.    .          .        .     .. ..                  .   .
.      .                   ..     .. S          .     .   .
.   ..         .        .   ..      .          . .        .
.     .             .           .          .          .   .
.      .       .               .   ..       .  .      ..  .
.  .           .   .    .      ..            . .   .     ..
. .                .             ..                  ..   .
.      ..  ..  ..                .             .        . .
..       .      .                  . .      .            ..
..   .    .  .              .               . .  .        .
.  . .   .             .   .   .     .     .    . . . .   .
...........................................................
