...........................................................
..  . .  .        .                       .    .   .      .
.  .     .              .   .             . . .    .    . .
.                                     .                   .
.       . .         .       .       .             ..      .
.           . .                    .. .                .  .
.     .   .     . .       ...    ..             .         .
.     .           .               .                     . .
..          .       ..   .                 .  .   .      ..
.  ..  .     ..      .    .       .                       .
.S                                                 . .    .
.       ..     .  X    .     .     . .                  . .
.       .         .    .          .           .           .
.  .         .     .             .   .      . .           .
.                .     ..                         .  .    .
.          .             .       ...             . .   .  .
.              .          .    .   .    ..      .        ..
.           .   .               .     .                  ..
..        .    .                            .        .  . .
...........................................................
