................................................................
.       ..     . .. .... .    .  .   .  .      .  .           ..
...  .  ..   .  .      .. .      ..         .    . . .   ...   .
.   ... ..     ..   .  .      ..  ..    .      .   .  .. ....  .
.  .   .. . ..         .     .  . .   .. .  .   .  .   . . .   .
.     .  . .   . .                             ..    .    .   ..
.   .  ..     . . .        ..       .         ..   .        .  .
.               ..             .    .  ..               .  .   .
... . ...  ..      ..     .        . .     . . ..  .. .   ..  ..
.       .  .   .. .      .   .. .     .    .        ...      . .
.  .  .   . .     .     ..   . . .    .   .  .     .. .   .    .
..    ..   .   .      . .  .  S . . . ..     .      .   .....  .
. . .. . .          . .   .    .. .    ..       .        ...   .
.        .    .    . . ..    . . .. .  ....   .   .        . . .
..           .. .  ..    . . . ..        .      ..          .. .
.   . .          ... . .     .... .  .  .    .    .. .   .    ..
.. .   .      . ..     .   .     .  .    ..  . . .        .. . .
.     ..    ..     . ...  .      . ..  . .. ...   .     ..     .
.. ..           ..  .       ..   .    .. .    ..          .  . .
. .   .   .  . . ..          .    ..         .   . .   ...    ..
... .. .      .  .         .     . . .        .  .         ..  .
. .  . ..       ..  ..  .   .        ..  X   .   ..... ..      .
.  .  .             .     .  .  .. .  ..                 .  .  .
.         .        .      .     .  ..  .     ...    .   .  .. ..
.. .  ...    .     .    ..   ... .  ..   .  .... .     .  .    .
................................................................
