.....................................................................................................
. .    .  . .  .      .                                         . .               .   .    .        .
.              .            .. . . .   . .. .   .     .     .      X   . .           . .  .     .   .
. .              .     .     . ..        .     ..        .         .  .    .                   .    .
.                 .       .    .  .   .   .     .  .            .       .    .      .   .         . .
..            ..                     ..     . .   .     ..   .    .           . .   .    .          .
.   .                    .     .  .  .    ..   . .       .         .   .. .   .            .        .
.                  ..             .    .S.   .     .      .     ... .       ..   . .  . .           .
.   .               ..  .   .      .                   .  .      . .. .                     .       .
.....................................................................................................
