..........................................
.               ..           .           .
...   . .      ..    .   .       .       .
.          .      .   .          .S      .
.               .                . .    ..
.                        ..      .     . .
.   .             .      .        .      .
.           .           .                .
.          .                             .
.  .                  .      .           .
.  .   . .  .    .               .    .  .
.  ..         .  . .    .  .   .   .     .
.    .     .         .   .               .
. .  .  .     X.          .              .
.   . .            .     ..        .  .  .
.      .   . .                   .       .
. .            .           .      .   .  .
...          .                      .    .
.                   .        .  . . .    .
. . .        ..                          .
.    .                      .        .   .
..   .  .     .      .                   .
. .     .        . .      .    .     .   .
.            .              .     .      .
.   .       .               .            .
.                         .        . .   .
..........................................
