.....................................................................................................................
... .       ..   . . .      .   . .      .   .    .     .      ..   .   . .     ..   ..                        .    .
..  .    .   .    .          ..  ..  . ...   .         .. . . ..   .     . .  . .               . . .  .           ..
. .  ..  .         S  .      .     .   . . .                    .      .       .   ..   .                  ..  ...  .
.  ..           .                 ..   X                 .     ..         ..    ..  .  .         .  .  .         .  .
. .  ...   .  .    .   .  ..  .         ..        .. . ..  . .         .           .     ...     .               .  .
.   .      . ..  . .   .  ..            .    .     ....      . . . ...    .  .     ...   .    .   .   .. .        . .
.  . .   .. ..        .  .   .   .      ...                     .       .    .  . .        ..     .   .     . ...   .
.  .           . .    .   .  .. .    .. .   .  .      . .                           . .... ..     .        . . .  . .
..  ..       .    .. . .. .   .     ....    .  ..  .  .  .  .. .    . . . ...  ...          .    . .   .   .   .  . .
.  .    .    .   .       ....       .    . ..     .. .     .         .    ..     ...    ....        .      ..       .
.  ..          .          . ..    .. . .    ..  .  . .    .. .  .    . . .  .    .        ..      .     .    .    . .
. .. . .  .    .  ..      .   ..                 .           .      .  ..    .  . . .        .      ..   .   .      .
.        .   .  .  .     .   .      ..  .   .  .   .      .  . .   ..                 ..  .        .. . ...   .   . .
..            .  . .     .  . . .  ..     . .   . ..    . .. . ..   ... . .    .   . ... .     .  .    .  .      .  .
.            .   . .   ..     . . . ..         .         .      .     .      .  .    .     .      .                 .
.   . .     .   .     ..     .   ..  .. . .   ..           .  . .     .  ..   .       .   .  .   .        ..      . .
.    .  . ..                     .   ...     ..    ..               .         .       .  ..  ..       .        .    .
. .     .    ......         ..                  . .   . .            .....   .     .    .    .  .   ..          ... .
.        ...   ..          . .    .            .      .  .     .     .   .      .      . .  ..   .   .  .  .   . .  .
.. .   ..   .   ... ...       .      .      ...   . .         . . .    .     .. .. . . . .         . .  ..          .
. ..  .      .         ..  .  ..   .   .   .     .  .  .       ..   . . . ...      .            . ...    ..      .  .
.....................................................................................................................
