...................................................................................................
.   .     .  . .                                            . .                          .   . .  .
. . .       .       ..    .                    ..   .      .                     .              ...
.    ..   .     .         .       .          . .         . .          . .      .      .           .
..     ....      .  .                    .           .                            ..            . .
.       .    .           .   ..            .        .                  .    .       .    ..     . .
.        .  .   .          .          .          .         .    ..   .             .             ..
..  .    .  .      .    .. .     .        .     .     .         .     .    ..      . .      .     .
.  .   .       ..            .     .    .  .            . .. . . .    .  ...   .         .        .
..    .     .         .         .           .  .  .        . ..          .       .     ..    . .  .
.                .          .           .                                      .    .         .   .
.                       .       .       .  .               X.                      .        .     .
. .    .     .   .  .          .     .     ..   .   . .    .         S    .       .    .          .
.         .    . . .       .              .    ..           .            .          . ..       . ..
.       .  .    . .                 ..     .       .   .      .     .         . .      .   .     ..
.   .   . .       . ..      .    .        ..                   .   .    .  .    .  ...     .      .
.     . .. .        .    .   .         ..           .             .         ..   .      ..   .    .
.    .     .     .   ..  .      .         .              .                . .     .     .         .
. .    ..               .                        ..   .             .   .               .     .   .
. .      . . .       .              . ...   ..     . .            ...     .                .      .
...................................................................................................
