....................................................................................................
..           .                     . .     ...              . .    . .      .     .    .    .   .. .
.        .                 .       .       .     . .      . .  .               . . ...    ..      ..
..                  ..      ..   ..              .                  ..  . .    . .. .    . .       .
.      .       .     .    .    ..   .  ...  ..          .                 .      .                 .
.     .           .        .    ..  .   .   ..                   .     .   .         .. .  .     . .
. .        .  .       .                           ..        .                   .   .      ..    . .
.        .       ..  . .     .  .         ..     ..  ..     .   .              ..       .     ..   .
..       .  .      . ..         . .       .    . .. .   .    .      . .                     .      .
.   . ... .    .   ... .        .    .       ..  .  ..                      .     .   .            .
..        ...                      .                .                . .  .   ..     ..     .  .   .
.   .  ..   .               ..           .   .           .        .                        .       .
.  .       .   . .   .  .       .   S .      ..            .     . .    .     .         .  .   .   .
. .   .  ..    .          .  .  . . .          .                  . .   . .  ..   . .        .     .
.             .   .  .   .   .      .       . .  ..            ..     .                            .
.    . .            ..     .    .                  ..        . .      ..       .  .     .    .    ..
.       .      .              .      .   .  .              .   .  .                    ..          .
.      . .  .            . .  .  . .         .  .  ..      .  .                      .  ..        ..
... .        .         .  .                 .            .          ..      . ..      . .  ..   .  .
.                       ..          . .    .   .        .      ..   .. .   .. . .         ....     .
.. .    .                  .             . .   . .        .             .       ..  .    . .     . .
. .     .               ...      .  .   .     . . .               .                .  . .  .. ...  .
.     ....  ..                           .                   .   .  . .     .               .      .
.           .              . .           ....    .              .         .    ..         . ..    ..
. .           .     ...  .                .    ...      .    .  . .       .      . . . ..          .
. .   . .     .             .        .            .           .      .  ..              .   .     ..
.     .      .   .     .             .         .    ..     .     .  ..      .  .     .  .       .  .
.                   .          .. .  .    .             X. .                                       .
.           . ..           .  .   .  .       .                        .        .               .   .
....................................................................................................
