........................................................................................................
.        .  . .   .      .  .   . .         ..   .   .  ..  .     .     . .       .       ..         . .
.               .      .  .      X      .       .      .    .   .         .         ..   ..   .. .   ...
.                 .                  .      . .             . .      .   .         .      .  .         .
. ..     .  .        .   .   .                    .           .     .       .   .. .       .  .  .     .
. . ..                          .               .         .         .      .  .     .    . .    ..     .
. .    .                           .     .              ..                   ..   .        .  .   .    .
.   .   .                      .     .         .   ..   .. .         .              ..            .. . .
. .    .      .    . .   .         .  .  .    ..  .   .            .    .                  .        .  .
.  .       .     ..        ..  .       .  .. .   .  .           .   .     .  .                  .      .
..      .           .  .                                           .       . ..   .        .     .     .
.           . .       .       .     .          .   .    .  ..      .      .  .    .        .           .
. . .      .   .                .          .      .                      .      .     .   . .  .      ..
.                               .    .              ..   .   ..            .  .       .         .     ..
. ..                    .                       .   .                         ....   .     .  .        .
.  .        .       ..        .    .              .   .                      .     ..  .  .    .       .
.                .                                        S   .     .                        .      .  .
..                 .  . .           .       .. .               .  . .   .                              .
.     .                   .   .    .  .        .                  .                .   .          .   ..
.                 .. ...             .  .    ...  .. .  .   .      .            ..  ..  .           . ..
. ..  .     .    .  . .    .      .         .      .                  .   .   .    .        ..        ..
.       .        .     .  . .            . .                              ..                .       .  .
.      .     .                      .          .          .     .     .            .         .   .    ..
.                  .    .                     .  .      .            . .        .  .   .            .  .
........................................................................................................
