...........................................
..  .   . .        .        . .  ..   ..  .
.     .     .  .  . .  . .     .  ...     .
. .       .     .    .   .        .X   .  .
.            ..         .     .  .        .
. .      .             .         .     .  .
.   .   ..             .     .    .  . .  .
.            .   .    .   .    ... . .   ..
.       .  .          ..     .   .  .   . .
.       . .     .      .    ..      .     .
.     .  ..      .          ... .         .
.   . .    ..  . .   .                    .
.     . . .   ..      S      .        ... .
. .     .. .           ..    .         .  .
.  .  .    .   .        .    . .   . .    .
. .    ..   . .  .    .. .        .  .  ...
...........................................
