...............................................
. .       .       .   X       .       .       .
.      .   .       .        ..                .
.  .   .                       . .            .
.         .   .           .        .   .   . ..
.       .      .           .          .       .
.  .       .     .    ..     ..    S    ..    .
.    . .    .    .       ..     .    .      . .
.   .                  .  . .                 .
.  .      .    .    .  .     .     . .  .  .. .
.  . . .   .          .                       .
...............................................
