...............................
.  .  . .     ..    .   .  . ..
....     ..     ..        ..  .
.  .    X .       .. .        .
.         ..      .        ....
.  .   .. .     .    .   .   ..
.                     . .    ..
.          .                  .
.  ...   .          .     .  ..
.     . .        .  .         .
.. . .    .    .. ..  .  .    .
..   . . .     .   ..  .....  .
.. .               .. .       .
.   .  .        . .     .   . .
.          . ..  .     .      .
. .  . .            .   .     .
. . ..  .       . . .  .     ..
.  ..     ..    .       . .   .
.   .      .    .         ... .
.      . .          .. .     ..
..      .     ..          ..  .
...      . .           .      .
.    ..  . .. .  .          ...
.  .S           .       .     .
..   ... .         .. ..   .  .
...............................
