.......................................................................................
.   .        .             . ..   . .            ..        . .            ..   ..  .  .
.      .       .        .     .     .                           .   .  ..  .      .   .
.        .    .      ..  .    .       ..         .                  .        ...      .
.   .. .   .     .    .                 .  .     ..       .  .  .  .      ..     .    .
.....            .             .  .      .    .     .. .  . . .      ..       .   .   .
.        .     .                  . .     .     .   ...      .          .. .          .
. .      . .         .      .   . .  . .    .   .    .                              . .
.        ..     . .       .    .    . . .  .       .    . .   . . .          ..     . .
.         .....   .     ..               .  ...      .             .      ..    .   . .
..  .      .        .             .      ..    ..  .      .. .    . ..              . .
.                     ..    . .        ...     .. .      ..   . . .   .       .      ..
.         .       .     .           .     . . .     . .        S   .            . ..  .
.   .           ..          . . .  .  ..         .    ..   .     .     .  .         ...
..  .     .   .   . ..  X..        .  .   .   .       ..     . ..                     .
..                                     . ..    .    .   .          ..        . ..     .
.  ..           . . .  ...  .   . .  .        ..   . .               .  .          .  .
.......................................................................................
