...............................
.. .   ...              .     .
. .  .     ... .            . .
.    . .          ..        . .
.   .           X .   . .    ..
. .  .           .      .     .
...   .    .      .. .        .
.    .  .  .    ..    .       .
.       .      .   . ..  .    .
.            ..   .      .    .
.  .S  .  .   .      . .   .  .
.  .      ..  ...  .      .   .
...       . .  .       .   . ..
.    . .  .   ..   .      .   .
.  ... .    .       .       . .
...... .. .     ..   . .   .  .
.. . ..    .  . .. .        ...
...       .  ..    .         ..
.     .   ..      .     .   . .
.         .         . .    .  .
.     .. ... .    .  .    .  ..
.   . .    . .   .    .       .
...............................
