.....................................................................................................................
.       .    .      .       ..        .         . .   .  .    .    ..       .      . .  .   .. .     .... .   ..  ...
..             . .    ... .    .        . .     .       .  .   .      .        .  .              ... .  .    . . .  .
..        .   . . ..   .    .                  .  .      .. . ..           .. ... ..   . .              . .      .  .
.                   . .      .     ..     . . ..    ..      ..         .  .. .     .     .  . ..     .  .    ..     .
. .        .    ..         ..     .      .  .      ..        X  . .    . ..    .. ... .     .... .    . . .     ..  .
.      .       ..          .  ..    .  .   .     .   .   ..      . .   ...     .  .. .  .   .  .. S...   .          .
.      .  .  .   ....      .        .  .    .  .  .     ..  . .  . . ..      .      . .  .        .      .   .      .
. .           . .    .    . .    .  .  .   .  ..  .    .    . .    ..            . .    . . . .  ..        .   .  . .
..       .          ..   .  ..           .      .  ..               ..   . .     ....   . .      .  . .            ..
.. . . ..       . .   ...     .   .   .  .   .    . ..   ... . .  . .  . .  . .   ...         .       .        ..  ..
..              .. .      .    . .  .    ...      .    . .  . . .  .      ..      .         .     ...          ..   .
. ..   .      . .  . ... .     . .. .   ..       . ..  . .   .      ...   .  .   .      .  .     .  .         ..   ..
. . .          .  .   ..  ..                 . .....    ..  .    ..   . .   . .   .  ..   .          ...    ..  .   .
.. ...      .          .  .         .       .         ...      .    . .  . .. .  .           ..     .     .    . .  .
. ...         .  .               .   .  .         .      .   . .    ..  . .        .  . ..  ..               ..   . .
.....................................................................................................................
