....................................
.  .    ..         . .             .
.S       .   .    .             .  .
.  .  . .  ... .    .    .. .      .
..    .  .    .    .               .
.             .      .             .
.           .    .  ..    .       ..
.   .     .    .      .      .     .
. .             .           .   .  .
.                      .  ..     . .
.  .  .  .      . ...   .   .  .   .
.     ....   .             X.  .   .
.        .                        ..
.      .     .       .        . .  .
.   ..  .        .      .      .   .
.  .            .      .      .    .
.                    . .   .       .
.  .                               .
. .         .                      .
..  .. .      .              .     .
....................................
