..........................................................................
.   ..      .     .  .   ..  . .     .    ...   .                    .  ..
.. . .. .           .  .    .   .    .    ..   .    . .               .  .
..   ....  .          ..      .  .    .                           .      .
.   .    .   .       .   .      ...   . . . .  .        ..   .       .   .
.         .   .   .    ..     ..    ..   ...           .          .  .. ..
...  ..   . .      .         .  .  .. ..    .       ..  .  .   .     . . .
. .    ..  ..  .   .  .     ..   .      ..        . . X  .   .         . .
.  .        ..   .   ..  . .  .      ...                  . . ..     ..  .
.              ..       .   .   . ..    .       .       ..  ..   .      ..
.     ....        . ....  .       .                 ..        .    .    ..
. .  .       .    .  ...   .    .   .     .   ..    . . .        .       .
.         .               .    ..     ..  . .                .    .     ..
.    ..  .           .   .    .   .     .. .  .     .    .. .        .   .
.     . ..           .       .    .          .                      .    .
.      .    .   .   .     . .    . ... .   ...         S           . .  ..
.   . .  .      .. . ..        .   . .              .. ..       ..       .
..........................................................................
