...........................................................
. .          ..    .  .        .       .  .       .  .  . .
.     .      ...  .       ..    .                  . .  ...
.               .        .   .      .    .     .     ..   .
.        . . . . S          .       .  .  .  .  .  ..  .  .
.             .      ..   X..  .     . .  ..   .        . .
. .    .. .       ..      .  .       .   .   .    .       .
..     .       .  .      .     .    ...   . .        .    .
.         .    . .  ..  .     . . ..        . . . .      ..
.     .      .   .  . .  . . .   . .     .  .      . .    .
.   .. .  ..         .   . .  .     . .             .     .
.  .   ..      .             .           .   . . .  ..  . .
. .       .  .      .  . .          .      .        . .   .
.   .  .     .                 .    .    . .  . .  .      .
. .    . .                 .     .         .  . ..        .
.    .  .   .   ..       .  .   ..              . . .     .
. . .       .   .           .     .    .      .     .     .
. . .  ..     .       ...          . .        .       .   .
.  ...     .    .                  .  ...  .     . . .    .
.. .                    .  . .     ..                ..   .
.         .. .   .        .    .  .   .    .            . .
.     .    . .  .  .       .         .       . .    ..    .
..   . .    . ..   .   .            .. .         . .  ... .
.   .      .  .                     . .      .      .     .
.     .            ...   .  . .      .        .    ...    .
.     .     .       . .        .  .    .. . . .       .   .
. .       ..  .           .  .      .   .  ..     .      ..
.     .    .    ..    ..    .  .  ..  .        . .  .     .
.. .    ..      .            .           .  .       .     .
...........................................................
