..............................................................................
..   . ..   .. ...               .  .. .             ..  .    ..  ... . .    .
..         .   .          .      .   .  . .   .  .       .  ..             . .
.  .   .  . .  . .   .        . .   ..  .   ..     . . .        .  .         .
.   .   .    .    .   .            .  .   ..  .          .               .   .
.         .  ..   .  . ..         .  .   ..    .   .      .      .  .      . .
.        ...    .     .     .    . .    .          .       .    ... .     . ..
.          .    ..   . .     .  .            ....   ..  ...  .  .  .  ...    .
.      ...  .        . .  . ..   . . .    .         .     ... ...            .
.   ..  . .. . .    .     .   .   .  .. .      .        .       .    . .     .
..   ..  .. .. .     .   .  .       .        ..  .. .                        .
..  .  . .   .  . .      ...   . .     .   S  .          .  ..  ...     .    .
. .       ..   . .       .   ... .     . ....   . .   . . .  ...  ...  . .   .
. . . .    . .   .. .. .   ..   ...     . ..      .. .. . . ...  . ..  .    ..
.. .   . . ..    ..   . ..        .    ..   ..                       . .    ..
.. ...      .  .    .      .   ... .   .        .   .  . ..  .   .      .  ...
. .    .  .. .   ..  ....      ..  ..   .  .      .  .  ..  .    .          ..
. . .   ...   .         .. .       ..                .. .  .. ..    ...     ..
.    ....     .  .     .   . ..   ..  .  .          .   .  .   . .        .  .
. .         ...       .    .     ....  .   ..         .  .         . .  ..   .
.  .   .              .   .         .   ....   .. ..  ..  .             ..   .
.  .   . .  .        .         ..           . .  . .  .    . ..  .  .    .  ..
.  ..     . .     .         .    .    ..  .  .... .    .. ..      ...     .  .
.        ..  .... .  .    . .     .     .  .   ...  ..  . . ..  . ...  .  .. .
.    ... .      .   X..    ...    . ..   ..       .  . . .     ..       ... ..
. . ..    .. .      .      .  .  ..   ..        .        . .    .            .
.... . .  .      .  . .  .  . .  . ..      . .  . . . . . .  ..    . ...  .  .
.     . . .  . .               . .              .  . .     .       ..    .  ..
..............................................................................
