...........................................................................
.  .  .       .                 .... ..   .      .     .  .  ..  .       ..
. . .         ..     .   .     X  .     .  .   .  .                     . .
.  .  .         ..  ..     .    .   .        . .      .  .          .    ..
.  . .        .        ...  .. .   . .. .   .      .    .   .    .   ..   .
.    .     .    .  .  . ....   .     ..      .           .     ...       ..
.    .  .    .   ..      ...     .    . .  . .               . .     ..  ..
.        .  ..    ..    .   . .   .... . .      .. .         .     .  .   .
.. .   .   ..  .         . .   .   .  . .      ..      .       .    .     .
.S .. .  .      ..    .  ..    .      .         . . . .  .       .    . . .
.    .   .    ...           .   ..   .. . .   . .    .           .. .  . ..
...   .   ..    .    ..  .          .. ..     .              .    . . .   .
.     ...       .  .     . .  .   . .    .. ...             .        .   ..
.  ..   .       .      .       .    .   ..    .   ...   .      .     .    .
...........................................................................
