.........................................
. . .  .    .          .. .       . .. ..
.       .   .      ..   .     .  . .   ..
..  ... .   . .. .   .   ...        . . .
..    ..  . ... ..    ..                .
.  .  .  . ..  .   . . .     .       .  .
.  .  .   .      .  .   .  . .   .    . .
.   ... .   .  .      .  .  .  . .      .
.   .      . ... ..   .S..    .         .
... .   .    . .       .     ..   ..    .
..      . .  . .     ..       .. .      .
. . ..  .. .      . . ....  .        .  .
..  X                . .. .   . .    .  .
. . . . . . .    .       ...      .   . .
.. .  .   . ...  .  . . .     ...  .. . .
.........................................
