.................................................................
.   .      . . .       .   .   . .  .                .          .
.    .                  .    .          .      .  .    ..       .
..        .           .            .     . .        .     .     .
.  ..            .     . .. ..         .    .  ...   .          .
.                           .                ..   ....  .  ..   .
..       ..                .           . .            .  .      .
.      .    .            .  .. .      .                         .
.      .. .  .          . .      .  .   .      .  . . . .       .
.X     . .                .              .   ..               . .
.      . ..          .  .      . .    .      .     ...  .      ..
.      .          . .  .             .   .       .             ..
.    ..        ..         S.    ..    .    .         .   .  ..  .
...  . .     .             .                             . ..   .
.  .   ..   .  ..                .         .           .  .     .
.        .    .  .                 .                  .         .
.   .   . .       .   ..      ..     . .           . .          .
.................................................................
