............................................................
.       .  ..    .  . .     . .            .      . .    X .
.  . .     .      .         . ...   .   .  . ..    .  . .  .
.      .  ..   .       . .         .  ... .      ..      . .
.       . .     .     . .. . . . ..    . .    .         .  .
. .    .       .     .  ...  . .          .       .    .   .
. .   .       .  .  .           ...          .     ..      .
.       . .  .               .       .. ..   ..       ..   .
. ..    .     .  .          . .    . .     .               .
. .. .     .      .    ....          .    . .... . .  .   ..
.      .  . ..  .    ..     . .  .     ..   .      .  . .  .
.    .   . ...   .    .  ..             .        .         .
..       . .  .  .     .  .   .         . .   .      .  .  .
.. .   ..  .   .  . . .       .   .  .  .        .    ..   .
..    .                        . ..    .      . ..   ..    .
.  . .   .  .... ..            .     ..        .        .  .
.    .  ..    . ..     .  .    .    ..      .. .  .       ..
. .        ..  .  .                    . .  .     .        .
..  .              .   . . . .  ..      .   ..  .     .    .
. .                   .. .     ...    . .  . .   .         .
.   . .      . ..   .  .            .        .     . S.    .
. .       .    .    .     .      . .    ..    .           ..
.   .  ..     .         .     . .     . ... . .     ..     .
..   . .    .    ...   .  .   . .      ..    .       ..    .
............................................................
