................................................................
.  ..          ...  ..  . S     ...    .     .      . . ..     .
.  ..  .      ..   ..  . ..  .  .        .   ..  ..   .    . ...
.   ... .     . .    . .     .     .  .    ...       .         .
.   ..         .     ..   .  .    ..  .. ..     .  .  .      ...
.  .  .  .    . . .   .          ..  .      .    ..    .  .    .
. .    .   .      . .    ....   ...   .     ..              .  .
. .            . .     ...  .  . ...    . . .    ..     ..   . .
.     . .       . .       .     .             .  ..   ..     . .
.       ..   .      ..    .       .    .               .. .    .
.. .     .    .    ..   .. .             ...   . .             .
.     .  .  .   .        .  .  .    .  .. .   .       ..       .
.         . ..   .  .   .   .  .     ..   .   ..     .    .  ...
.         . .  .  . .  .         .. .. .            .   .  . . .
..         .       .        .      . .. .        .  .          .
.      .  . .       .    X ..   .   .     .               .   ..
...    ..  .  . .  ..       .    .    . .  .    .. .   .  ..  ..
................................................................
