.....................................................
.     . ...  .    ..   .   .      .    S     .      .
...   .  X . . ..  . .   .    . .        ..        ..
.    ..      ..       . .  ..     .  . . .   ...    .
.    ...  .  .      .  .   .   .    ..    ...  .  . .
.             .     .   .  .  . .       .    ..     .
.       . ..      ..  .  . ..     . . .     .. .   ..
.   .   . .  .  .     .     .   .    . .  ..   .    .
.. ..      .. ..     .. .       . ..  . .   .  ..   .
.             .  ..  ..     .  ..     . .     .. .  .
.         .   ...    ...          .           .     .
.  . .     .    .    .        .            . ..     .
.   .  ... .     . .  .. ... .     . .  .       ..  .
. ..       .       . .     . .  ... ..      ..   .  .
. .            .      . .   .... .         ... .. . .
.....................................................
