................................................................................................................................................
..   .      .           .         .   ....     .                  .      .  .         .          .      .                         .  .         .
.        .         .       .              .  .       .             .        .    . .          . .  .       ..       . . .    ..  . . .         .
.. .           . . ..     .           .  .         .  .        ...   .  .            .       .    .                       .   .        .  .    .
.        .  .                           ..    .   ..           .    .   .   .  ..            . ..  .  .    .   .    ..    .   .            .   .
.          .         .     . .  .   .        .. ..           .                   ..  .   .  .   ..          . .   .  ..        ..   . .  .     .
.  . . ..       ..   ..       .. .      .     . ...             .       .            ..                .    .         . . ..              .  . .
.             .        .                 .        .       X     ..      .       ...          .          .. .   .. .       .  .            . .  .
.      .  . . . .. .           .    ..   .              .   . .           ..          .  ..   . .              .   ..        ..   .       .    .
.      .   .. .                     ..                          ..      .                       ..    . .    ..   .      .      . ..    .   .  .
.     .  .       .     .               .             . . .                 .        .   .. .         .       . .   . .    .     ..             .
.. ..  .                       .       . .       .       .  .         .         .        .   .   .                     . . . .  .              .
..  .       .    .        .     .         .          . .       .          .  .        .   .  .     .   ... . .  .    .    . .  .   .  . .   .  .
.        .       . .      .     .      .  .         . ..             .           .. . .       .     .    . .    .   . ..   .      .   ..  .    .
.            .         .        ...      .                   .   .            .  .   ..       .     .   ..    .   .  .   . . .       .         .
.          .  .     .        .  . .   .  .      .    .      .. .     . .                .  .   ..   .     . .    .    .   .           ..       .
.   ..             .   .     .   .       .      ..               .       ..       .    .       ...  . .             . .        .        ..     .
.    . .    .     .  .          .  .     ..  .     ..   . . .  ... .  ..             . .    .         .              .                   .     .
.       .  .  .            .          .             . .. .    .         ..   .        .                  .   .         .   .  .           . .  .
.         .            .            .     .               .      .    .       .    .          .       .  .    . .    .              .          .
. .  . .             .           ..   .   .. . .               .. .    . .    . .     . .          . .              .    .  . ..  .            .
.         . .   .      .  . .   .          .   .           . .     . .  .      .                  .      .            S    ..       .   .     ..
.    .          .     .   . ..  .        .  .   ..    ..  .        .  .      .    . .  .            . .. .     .  .  .                .        .
.   .  .  .    .          . .    ..    .   ..     .. .        . .  . .        ..    ..   .    .      .       .  .. . ..     .     .            .
................................................................................................................................................
