...........................................................................
..          .                  .       .    .       . .   .        .      .
. ...         . .        .  .       .         ...     . .          .      .
.                 . .      ..          .    ..   ..   .           .       .
.                        .     .  .    ..      .         ..               .
.    . .   .      . ...         ...               S          .   .        .
.         . .  ..   .   X                        .  .           . .   .   .
. .  .            .            ..  .  ...    .      . .      .   .    . . .
.              .              ..                  . .    .         .      .
.   .. .   .  .      .     .           .            .   ..           . .  .
. .   .      . . .  .           ..       . .  .      . .            .     .
.  .                 .    .. .    .       .   .           .    .          .
..        .   ..   ..  . . .        .  . .                        .   .  ..
.  .                .              .    .     .         ..  .             .
..       .          ..       ..     . .      . . .  ..               ..   .
.         .  ..           .  .    .   .         .       .              .  .
.     .  .  .       . . .        .       .      ..   .     .     .  .     .
.         .   .   .   .       .               . .   .          . .      . .
. .     .  .       .    .                      .    .                  .  .
.   .     .  .                      .                           .   .     .
.   .    . .       ..      .   .                   .    . .          .    .
...........................................................................
