...................................................
....  .. .  .   ..  .     .  .   . . ..      . . ..
. . .       .       ...   ...           . . .  . ..
.   . . .  . .. .   .  . .    ...   .  .  .  .   ..
. .        .  .     .      . .    .      . ...    .
.                ..  .    . .  ..   .     .   .   .
.. . ..   .    .. ..     . .    . .      .   .    .
.     .        .       ..    .. .   .  . .  .  .  .
..      ...      .    ..   .   .   . ..   .. . .  .
.          ...          .  ..   . .   . . . ..    .
.  . S  .  ....   .      X.     .   .        .    .
...        ..    .     .   .    . .   .  . .  .  ..
....  ..  ..  .       ..   .   ..            ......
.        .      ..        .    ....     .    ..   .
.       .  .   . ..  .. ..        ...      .    . .
.         . .    . .          .  .     .  . . ..  .
.  . .                     .    .. .    .         .
...    .. . ... .     .  ..   .  . .. .   ..      .
.  .  . .    .  .   . .. .  .. .   .  ..  ..  .  ..
...................................................
