.................................................................................................................................
.. ..   .  ..   ..  .            . . . .. .. .  .       .          .   .. ...    .  .  .           .  .  . ...  ..    .     ..  .
.        .      ..       .            .   .  .  .    ..... .    . .    .   .       ..       ..  ....  .  .     .  . . .   ..    .
.    .           . .     .. ..         .    .... .  .. .         .      .  .      .. .     .      ..   .  ..   .  . .   .      ..
..  . .      .  ..    .      .  .    .. ..  .  .    .. .   . .  .  .  .  .  . ..    ..      .    ..   ..     .   ..    .        .
.... .   .    .       .    .   .         ...    ..  .  . . ...  .     .  .  ...    .   . .       .       .      .    ..   . .   .
...      . ..  .              .     .  .     ..  ..  .. ..  .  .         .   .      ..    . .    . .   .    .      .  ... ..  . .
.       ..  .   . ..  ..   .. .. . .. ...     . ... .  .  .   .        .   .   .   . .     .    .  .  . .     .      .   . . .  .
. ...     .  .... ...    .  . .. .  ..  . S .    .     .  ..               .  ..   .   . .   .   . . . .      .    ...  . ..    .
...  .        .. . . .  ... ..   . .  . .   ..       .         .        .  .  . .          ..     . .   ..  ...           . .  ..
. ..     ..  .  .   .     ..    ..         . ...  .   . ... .. .        .    ...   ..       . .. . .     .     . ..   . . .  .. .
.  . . .   .         .  .      ... .       .     . .         ..  .  ...  ..  .     .     ...           .    .. .  .. ..  ...   ..
.   .  .  .     . . .. .  .      ... . ..  .  .   .  ...                .     .  .   .    . .  .  .  ..   .   .   .           . .
..  .    ...     . . .   .  . .....  .    .   . .       .. .      ...        .    .     .  .  .   .    ..        ..        ... ..
. . .     .       .    . ....  . .     .  .    .  ....   .  .        .  . .  ..   .   ..  .                  .  .. .    . ..  . .
.  .         ... ..     .   .  .   .       .   .  .  ..     .. .  . .   . .    .  .. .   .       ..   .      .          . ... . .
..            .           .        .   ... . .  .       . . .   . ..  ... .. ...  . .. .  .    .  . .  .  .   .. . . .    . ..  .
. .       .         ...     .         . ..  . ..  .        .  . .        .       .  . .         .  ..     ..     ...     .  ..  .
..   X    ... .  .   .         .  ..   . . .    ....  .  ..  . ..    .. ..   .. .   .  .... . .     .. . .   .  .          .   ..
..  .  . .    ..        .    ..       .  ...     .     .... . .  . . .  ...            .   .   .   . ..   .. ..    .  ..    ..  .
. .. .   . .    . ..  ..               .          .    .   .  ....           .       ..   ...   ...     . . ...   .     .     ...
.     ... .    .. .      .   .    .         ...     .    .... ..  ..    .  . ..   . .    .            .    .  . .   .      ..   .
. ...    .    .. . .     .  .   ..    .   . ..      . .      ..         .  .  .   . .   .. .   .  . . .             ..   ... .. .
.................................................................................................................................
