.......................................
.    . .                  .  . .     ..
. . ..         .     X   .            .
.         .  .    . .    S  ..      . .
.       .            .  .             .
.    .   .              .    ..      ..
..              ..   .          .     .
.     .         . .          .        .
. .          ..                .    . .
.   .    .       .     . .   .      . .
..             .   .              ..  .
.     .         ..      .       .   . .
.   .             .        .  .       .
.......................................
