..............................................................................................................................
.   ..     .             .                  .     .          .    .         .          .              .        .             .
.        .                     .    .               .           .  . .      .  .        ..   .      .            .           .
.          .  .                       .   .          .      .    .                 .                                         .
.    ..   .         .     .    .   .                 .    .        . .  X      .    .        ..     .          .             .
.          .    .       .     .        .    .      .     . .       .   . ..              .       .       .  .              . .
.     .       .. .           ..   .    .      .  .              .     .   .. .    ...                   ..  .          .  .  .
..        .    .                  .   .             . .       .       .       .  ..               S .   ..   .     .         .
.     .       .  .     ..        .. .  .   . .  .      . ...                       .                  .    .     .           .
.         . . .    .                                 .         .          .  .. .   .  .          . ..               .       .
.                   . .     .      ..     .         .    .     .      .         .                                       .    .
.                                 .     .                   . .               .       .     .                                .
...     .                      .     . .   .  .     .            .  .    .   .. .   .             . .                 .      .
.            ..   .                    . .                   .              .                          .               .     .
.  .          .   .   .    .     .     .  .   .            .  .          ..       .                                          .
.   .        .  .          .            .  . . .    .         .     .                     .  ..     .             . .        .
.  ..     .             .  .     .    . .       . .       ..                       .      .  .  .                .  .       ..
.  .      .       . .                                   ..        .                           . .   .            . .        ..
. .                 .              .      .      .  .            ..    .           .  .      .        .              ..      .
.    .    ..            .        .               .     .       .  .             .                    .      .           .    .
.       .             .               .   .                   .           .          .    .       .      .       .  . ..    ..
..............................................................................................................................
