.................................................................................................................
.                       .   .       .  .        .   ..  .  .   .   .        ..            . .  .        .   .  ..
.  .           .            .   .   .  .   .    ..           .  .      . .  .  .   ..  . . . . . .  .  .        .
.                .                            .    .    .    . .       . .         .      .   .               . .
. ..                ..        ..            .  . . . . ..   .    .            ..      . .      .      .     .   .
.        .   . .       .         .           .     .       .. .   .        .   .         . . .           . .    .
.  .  .      .  .         .  ..  . .   .    .           ..    .      S          .   .               .       .   .
..    .       ...     .              .      .    .     .  .      .     . . .      . .                .      ..  .
.    .                .             .            .        ..          ..   . . . .           .  .   .   .       .
.    .  .   . .           .  .            . . ..   . .      .. . .    . .  .           .. .      .      .      ..
.     .     ..        ..   .      . ..           .      ..   .                       . .       .     .  .     X .
.                      .    .   ..   .               .        .        .   .  .           .              .    . .
.................................................................................................................
