..............................
. . .             . ... .   ..
.  .   . . . .     . .   .   .
.     . . ..  .    .        ..
.      .      .              .
.     .      .       . ..X   .
...    .     ..   .     .. . .
.      .      .   ...  ..   ..
.       ..   .     .  .  .   .
... .     .          . .    ..
..    .  .    .   .    ...   .
. .  .   .. ....    .        .
..  ..      .  . .    .      .
.    ... .. . .. ..   . .  ...
. .   . . .     .     .      .
.    .       .. .   ..  .    .
.     . .        .  .  . .   .
.  .   .    ..      .  .   ...
...  .  . ..    .S   ..  . . .
.         .   .. . ..  . ..  .
.        .  .    .   .  . . ..
. .   .. ..  ... .     . .   .
.   . .. ...    .         .  .
..............................
