..............................................................................................................................................
.   . .          ...    .       ..      .    ..        .   .  ....   .. .     .     ..       . .  ..   .    .     .      .   .       .       .
.  . . . ..   ..  ..      .  .     .  .     .   ..   .  .   .     .                      ..    .  .   .. . .    .  ..  . .  .    S  ..    . ..
.    .   .   .   .     .      . .    .   .     ... . .    ..   ..     .    .      ..      ...   .      . .. ..       .       .  . ..         .
.. .  ..  .  ..    .    .        .   . .       .      .             .   .     .  .    .  ..           .            . . ...  ..  ..  .  .    ..
.   ..            .   . ..    .   .. .      .    . .  .    .  .    ..     ..  ..         .      . .        ....    . .            .   . ..   .
.    ...  .        .  .   ..    ..        .   .  . .     .         .  .              .       ..     .   .      ..     ..    . ... .     ..   .
. .  .         ..   .  .    .      .        .    .         ..   .           ..       .. .  .      .. . .   .     . . .. . .     .         .  .
.. .      .    .   ..   ..   ..          ....             .  .. . .. ... ...        .    .          . .     ..  . . ..  .     ...   ..  ...  .
.  .  ..  .        .    . .       .    ..                   ..  ..   ..      .    ..   .  .. .    .      .. .        .      ..        ..     .
.  ..   ......  .   .        .  .          .                 ..       ..  . .  .    .       .    .        ... .  .    . ...     . . .   . .  .
.      .      . .. ..  ..  . .     .  . .. .       .    .....  .    .     . .      ..    .  ..    ... ..     ..  .   .  .        .  ..  . .. .
.    .      .. ..           ....    . .    .           . .  .  ..   .     .   .  .              ..       .  ..    .      .... . .    .. .    .
.   .  .    .    .       .       .             ..          .    ..   .   .  . .   ..    .   .   . .X    .  . ... .    . .             ..    ..
.  . ...   . .    . ...  . .      .      .   ..           . ..    .  . .         .    ...           .      .. .     ..   .       ...  .  .   .
.... .. ..  . .    . .. .   ...  .. .. . ..              .  .. .    . ... .  ...  ....        ...  .  . ...      .  .  .  .              .  ..
....     .  .   .   .   ...      .    .   .... .    .    .           .   .      .    .. .    . .  .  . .   . . .    .   .  . ..  .        . ..
.    .    ..   .        ..   ..                ..   ... . . .            ..        .     .   .. .      .      .          . .        ..   ... .
.   ...              ...      .       ....  .... .          .    .  .  . ...         .  .  .     ..  .    .  ..  .          .   .    .     . .
.  .  ..        . ..  .  .                 . . .   ..  . .     ..       ..     . .  .  .     .   .. .     . .   .   ....  .  .       ..      .
. .  ..    ...    ...    .. ...    . ...         .   ...  .   .  ...   .   .      .   .  . .    .     . . . . ...  .          .     .... .   .
.  .   . .. .    .     .   .   .  .. ... . ....       . .    .   .   .  .   .       ....    .   .       ..   .        ..           .  . . .  .
.      ... ...   ..  .      .    . ..           .. .    .     ..     . .        . ..   ..   . .           .    . .  ...  .      . . .        .
.        ... .    . ..  ..  .         .     .         .. .   . ....   .           .   .      .  ..                      . . ...   ...    .  ..
.   ..               .    .   ..  ...       ..    .   .. ..    . . ...  ...   .     .       . .        .  .  .  .   .     . . .      . .   . .
..    . . .  .   .   . .  .   .    . ..  ..   .       .     .  .   ..   .       .         .         .   .   ..  .   .  . .   . . . .  . .   ..
.       ..   .    .. ....       .           .  .   ..      ..            .  .  .  .     . .. .        .       . .  .      ..   . . ..    . . .
..     .   .     . ..     .. .   ..     .                         .   .      . . .             .     .     .. .  .        .. .     ....      .
.  ... .    .     . .      .   ..           .. .   .    .      . ...     .      .   . .   .  ..    ...     ......    . .        . .    ..   ..
..............................................................................................................................................
