......................................................................................................................
.  .. .   .. . .   ..     .        . .. .  .. .                . .    .     . .                . .         .   .     .
..      .. .         .  . ... .      .  .    .   .   ..      .  . . ...   .  .                 .   .  ..       .. .  .
... .   . X   .                ..   .        .  .    .    ... ..  . . ...   .                  .     . .    .    . . .
.    ...           .    ...        .   . .             .. .     . .  .                   .   .. S    .   .   .    .. .
..               .   ..     .   ..  ..    .    .   .  .   .      .        . . ...   .... .                 .    .    .
.  . .     .  .     ..    .           ..   ...   .          . ..  .  ..      .          ..  .       . .  .   .       .
..                    . .       .. .          ... .    . .      .  .    . .  .   . . .     .       .  . ..      ..  ..
. .   ...    .           . ...   .                .   .            .    ..         .     .   .                    .  .
.                   . . ...   . .       .             .. .   .     ..      .  .     .   .. .           . .  .   .  . .
.         . ..           .        . .. . .    .      .         .                . .   .  . .       .. ..      .   .. .
.   .        .          . .   .    . .     .   .        . .   .    .  ..   .     . . . . .     .    .          .   . .
...     . . . ..                 .... .        .      .   .. ..       .   . .  ..   .   . . .. .      .      .   . ...
.. .    ... .  . .  .   .     .  ..      . .      ..     .   .                     ...   .      .  .    .   .      . .
.   . .  .         .  .   .  . .   .  .    ...   .  .    .  .        ..         .      .    .        . .  .   .   .. .
. . ..     .     .    .   . . ..                . .. .     .. .  . .    . ..  .  .   .  .   .  .  . .  ..      ..    .
.  ..           . . .  ..        .          .      .    .     .                 .. .  .   .   .      ..    .      .  .
..    .. .       .  .         .       .  ..    .                   .    . .      .          ..          . .. ..     ..
.. .    .   . . .       ..     . .   . .  ..  .     ..  . .          ..          .     ..          . .    .          .
.  .  .   ..     .  . .         ... .  .       . .     .    .        .. ....  .  .... .. .   .... . .   . .   .  .   .
. ..    .    .         .   .      .   .      .   .  .  ... . ...       ..  .    .   .   . .  .       . . .       ..  .
..        . . .  ...  ..            .       .    .  ...  .    .. .  .    . .       .  .               .    .      .  .
.  .   .           .  .     . .    .   . . ..     .     .     .   ..  . . .   . ..          .. . .  .  .   . .. .   ..
.  .  .  .  .  .    .     .       .                   ..      . ...    .    . .  .           . .  .  .      .   . ....
.     ..  .. ..  .       .     .. .    .      .   .           .  .   .        ..  ..   .   . .          .       ...  .
.   .    .. .       . ..           . .    .               ...   ..      .         .  .     .       .  .    .        ..
. ..  ...     .   ..          . .  . ..  .  ..    . .    .    .   .              .   .  .           .  . .           .
......................................................................................................................
