....................................................................................
..     .      .           .                     . .      .. .   .  .               .
.   ..     .            .       . .   .     .  .       S.           .              .
.    .        .              .                         .         ..                .
.          .       .   .         .         .  .                    .               .
.     .          .         .  .   .  .      .                      . .  .     ...  .
.                                            . . .              .            .X   ..
.                    .  .  .      .        .             . . .    .                .
.               .                       .  . .    .   .  .   .   .          . .    .
.  ..      ..  .                          .                           .           ..
..         .            .                                            . .           .
....................................................................................
