..................................................
.       .          . .   .. .    .  .     . .    .
.     . .. .     ..   . .           .       .. ...
.   ..         .        .     .            . S.  .
. ..  .       .        . .   . ..      .    .    .
...X    .            .   .  .     ..          .  .
..       ..  .  . ... .  .  .           . .      .
. .  .      .      . .  . .    .      . .    . . .
..      .. .  .  .  .     .....  .  .   . .      .
..  .. .. .. .. .   .   .       .  ... .   .     .
..      .      .  .     .    ...   .       . .  ..
..................................................
