...............................
. .           .    .          .
.    .  . . .                 .
.      .       .              .
.       .                     .
.           X      .        . .
.   .   . .  . .              .
.        . .         .     ....
. .       ...             .   .
.              ..    ..       .
.   .                         .
..                     .      .
.          .   .  .        S  .
.         . .                 .
.   .. .   . .               ..
..      .         ..     . .  .
...............................
