...................................................................................
.                         .  ..     . .           ... .    .  .              ..  ..
. .  ...      .     .       .      . .   .         ... . .    ..   .   .          .
. .. .         .   ..          .      .  .   .     .               .  . .   .  .  .
.       .     .       .                       .     .  .            . .           .
. .        .            .    ...     ..           .   . .  ..                     .
.     ..  .. .                     ..  .               .    .             .  .    .
.   .  . .. . .        ..                .     .  ..   .      .    .              .
.       ..     .              ..              .       . .  ..           .    .    .
.          .  . ..     .    ..         .   .  . .      .    ..   ..         .     .
.   . .    .       .  .   .           .                 .        . . .  .  . .  . .
.  ..      ...  . ..         . .               .   .       ..   .     ..   .      .
.     . .       .  . .  .      ..       .        .       .     .  .        .  ..  .
...  ..  .                     .     .   .               .   .  ... . .  .  .    ..
.  .       .     . .             .  ..       .           .       .       ..     ...
.       . . .                       . . .  .      ..  .          . .         .    .
..      .  .     .                      .    .                .            . .    .
. . ..  .  . ...  .    .       X      . .  . .  .    .     .     .           .    .
...         . .       .    .          .      .   .  .    .  .      ..     . ..    .
.     .   .  .. .        ..     .           .  .     .       ..   .        ..  . ..
..      .     .     .      .      .                 .                       .     .
.     S ..   ..    . .       .  .           ..     .    .        . . .  ..    .  ..
...  .    .    ...       . .            .        .      .          .     .    .   .
. . .      .        .  .     ..     .  .      .             .      .        .  .. .
. .      .      .  .      .    .                   ..           ..  . .         ...
.        .    .       .. . .             . ..   ..          .         .    .  . . .
...................................................................................
