................................................................................................................................................
.       ..          .              .   .    .          .   . .   ..    . ..  .    .. .   .      .          .       .    .             .    ..  .
..    .   .  ..  .    .         .    .  .    .         .     . .   .         ... .      .       . .   .. .        . .   .        . ..          .
.    ...      .          . .          .                     . ..     .  . ..    . .. .      .   . . ..  .           .          .. . .          .
.                    .           .        .        .              .  .    . .    . ... .                 .     ..   .  .      .  .    .    .   .
.           ...    .     .      .       .    .. ..         .             .     .                    .      . ..   .              .  .  . .     .
. .. . .        .   .    ... . . . .  ..     .       .         .         .    .             .       . .            .                .  .  .    .
. .        . .   .. .       .          . .     .      .     ..    .. .  .       .                    ... . .    .           .  .     .      .  .
.    .   .  .                             .   .  .       .   .     .     .      .  .              .  ..           .  .     .         .. .  .  ..
.   .             .      .     ..  .      . . ....      .. .   .    .. .                  .     .. .      .           .   . ..   . ..  .       .
.      ..  .        .               .  .    .    .         .          . .    .   .        .         .       .. . .    .   .   .       . .      .
..   ..    . .       .   .          .                  .      .             . .            .    ..            .  .                     ..  ..  .
.           .    .        .   .             .       .      .. . ..                 .  ..     . .      . .          .    .  .. .  .    .      . .
...      .    .      .         .     . .    .  .       .  .      .           .      .        .  .     .   .                  ..   .       .  ...
.    .                     .     .   .     . .   .         . . . .     .   ..  .          .   .  .       .           .  .     .    .    .      .
.          .    ..      .   .                                        .     .  . .       .    .       ..              .   .            . .    ...
.       ..      . .       .    .  .  ..    .       .  .   .     . .              .  ...   . ..                        .  .  .       .    .   ...
. ....      . ...      ..  .   . ..... .     .   ..   . ..  . .  .  .    .  .    .    .          .   .     .        .         ..         .    ..
.   .           .    . .       .   .            .        .      .    .                 .           .           .      .           .            .
...  .      .  ..             .  .    .       .     .      .    .          .         .   .   .    .    .     .     .   .       . ..    .   . . .
..   . . ..   .    .  .                      .      .     .   . . .  .           ..      ..    ..    ..               .   .  ..      . ..      .
...         ..                .                        ..        ...  .  .  ..   ..    .     .   ..           . .     .....    .     . .       .
. .           .            .        ..          .       .    .   . .            . .        .      .  ..                 .  .    .           .  .
. ..    ..    .     .  .         .    .    ..            .      .    .     .. .        . .              ..  .      . .   .       .          .. .
.   .  .   .. ...              ..               ..  .    .    .  .   .      .       .         .        . .  .      .   .        .    .     ..  .
. .              ...   .    .     . .   .          . .  .     .. .           .  .          .    .  .   .             . .  .            .      ..
.. .    ...   ....             .     . .             ....    .     .   . .  .    .           .   .         . .  .    .  .    .  .           .  .
..    S        ..  . .   .     . .  .  .       .    .         .           .          .         . . .  X         .             . .         .    .
.        .     .   .   .  .         ..             .  .    .     .         .  .     .          .           ..  ..          ..     . .       .  .
................................................................................................................................................
