......................................................................................................................................
.    . .   .      ...  .          .   . . .    ..                 .  .    .    .        .  .            .   . . .       .  ..        .
.        .           .  ..       ..          . .      .      . .     .    .   .         .     . .                       ..  ... .... .
.        .     .     .        S     ..      .  .    ..           .   .         . ...                .    .  .               . .      .
.       ..           .      . .   . .      .. .       .                     .    .   . . .   . ..    .      . .         .     . .    .
.    .    .. . ..  .   .    .                      .            ..                        ..  .   .     . .. ...        .  .         .
..               .            ....           .     ..  .    .     ..  ..      .      .     .                                 . ...   .
..        .   .  ..    .        .         .      .   .   .  .         ... .    . .        .    .  .          .     .      .       .  .
.      ..    .     ..  .          .  .   .     .   ..   ..    .. .    . ..    .      .              .      .   .   .     .   . .     .
.. ..       .   . . .  .     .        .                    .    .  ..   .     .  ..     .   .  .        .  .     .    .     .     .  .
.    .  .         .  ..       .     .   .      .        .           ..     .  .   .    .  .      .       .                    .   .  .
...  .    .       ...              .. . .    . .     ...     .      .  . .    .        . ..              ..         .      .. ... .  .
.  . .   . .   .  .    .    . .   . .     .  . . .       .         .    .         X  .   .  ... .   .     .         ..  .    ..     ..
.. .      .   .      .   .  .         . ..  ...  .               .          . .       .    ... .  .  .     .       .  .  . .    . .. .
.       .   .     .        . ....   .    .          .         .  .    . . .           .    .                       . .    .  ..  .   .
.    .    .       .       .  .    . ..      ..    .     .   .                     .     .   .    ..       ...            .  . ....   .
.       ...   .  .      .  .   .  .. .   ..   ..            ..   .     .                .   . . .               .           .        .
.  .                   .       .     .   . .                  .        . . .      .     ..  .     . .       ..      . .    .   .   . .
.. .    .    .   ..             .  .  ..   .    .  .           .        .   ..    .     .          . .  . .      ..     .           ..
.            .       .       . ..   .   .  .   .    ..   .    .    .  .               .              .                         .  . ..
.  ...     .   .            .  .     .   .       .  .       .                 .     . . .  .        .       . . . .  .     .         .
. .. .        ..              .. . .  ..  .         ..     .  .  .   . .     ... .      .                        .       ..  .       .
.   .  . ..     .   .   .     .      . ...    .    ..    . .           .   ...     .     ..  . .     ..   .       ..     .  ..       .
......................................................................................................................................
