........................................................................................................................................
. ..  .       .  ..         ...       .    ...   .       .    .  .  .     .     .                        .    ..         .       .  .  .
..    .           .       .  ..              .. .    .     . .             .   . . .                .    ..        . .    .      .     .
.             . .   .     .     .       ..  .  .   .    ..   ..  .           .     S       .        .. . .   .        .   ..           .
.           .  .    .    . .   .      .    .    ..  .           .     .  . .      .         .     ..        . .  ..        . .  . . .  .
.           .. .         . . ... .       .              .                 .  ..   . .        . .  .             .      ..      .    ....
.. ... .   ..      . .   .. .   .  .   .   .. .        .       .  .  .. .   . ..    . .   .      . .       .  .      .  ...     .      .
.. .               .  .  ..  .          . .   .             . .   .    .        . .      .       .   .           ..       .      .     .
... ..    .     . .       .  .    .    .         .  .        .    .         .  . .   .. .   ..         ..    . ...      .          .   .
.   ..           . .  .    .         ..    .      .          .    . .    . .  . ..          ...        . . .. .     ..      .       .  .
.. ...  .  . .. .  . .  .   .  .      .     .      .  .           .   .. ..           . . ..      .        .     ...            ..     .
..     . .      .. .                   .  ...     .     .  .     .         ..    .. .              .    .   .   .   . .  .     . ..    .
. ..  .    .   .. .  . . . .                 .    ..          .  .. .   X          .  .     .   .        .      .        . .         . .
. .       .. ..             .....  .  . ..          ....           .   ..      .   .    .        .   . .         .     .       . .     .
.  .  .  .    .              .     .     ..  .   .     .   ..      .    . .       .    .  .  .  .   .  .. ..          .     ...        .
.  .  ...  . ..         . . .  .  .          ..    .           .               .            .     . .    . .   .    ..  ..  ..  .   .. .
.  .  ..          .      . .          ..  . . ..  . ..   .. ... .     . .  ..  .      .     ..  .     .        ...  ..  .  .      . .  .
....   .   .   .  . . .       .   .  .   .                   .   . ..                 .      .   .          ..  .    . .     .       . .
.      ...   ..  .  ...    .. ..  .      ... .  ..   .     .        ..      . . ..        .      . .   .  .   .     .  .   .     ..   ..
.      .   .         . .  .     .  .   .. .   .   ..    .       . ..  ..     . .    .  .   .   . .  ..     .  .   .  .   . .   .   .   .
. .  .                ..     .       .     ..      .  ..     . .  .         .  .  .        .  .       . .    . . . .        .       ....
..  . .  .    .        . .   .            .                 .     .. ..  .     .  .   .  . . . . .        .       .   .  . .   .      ..
.  . .   ..   .   ..   .   .  .      .. .   .    ..       .         .    .          .                            .    .  .   .  ...    .
. . .   .     . .  .       .          . ..     ..      ..  .      . .  .  ..     .   .    ..      ..  .       .     ..          .      .
........................................................................................................................................
