...............................................................................................................................................
.   .                    .         .        .     .             .         .  .        .   .                ...           .    .  .       . . ..
.   .          .  .           .  .   . .         .               .    ..        .   .  .      .   .     ..       X.        . . .     .    .   .
.    .    .   .    .  .                .   .             .  . ..   .          .                      .        .   ..                      .   .
.   .         .     .                              .   .   .  . .    ..     .     .                . .      .                 . . .   .      ..
.   .           .  .. . .  .         .        ..  .         .  .                .   .      .      .        ..     .            .  .           .
.       .     .               .    .  .                . . .  . .        . .  .                     .       . .    . .     .         .   .    .
.     .           ..       .           .            .   ..  .      .                               .       . ..    .                ..        .
.   .             .              .   .       .                       .       ..    .     .  .        ..           .   .              .        .
.                           .                 . . ..        ..    .           .     . .           .        .  . .                  .          .
. .     .  .      .             . .            .           . .        .             .              .    .           .   .               .     .
... . .        .   . .         .     .   .     . .          .      .       .   .       .                        ..    .      .    .     .  .  .
.            .   . .                        . S     .  .  .   ...            .      .     .                       .   .. .                    .
. .             .  .   .          .  .              ..       .           .  ... . .             .    ..       .          .        .       .   .
...............................................................................................................................................
