...............................................................................................................
.   .  ..     ..     .                   . .  .       .       . .            .      . .    . . . .      .     .
.        ..   .           .. .           .     ..    .   ..                                     .      . . .  .
. ..              ...                     .                .   .               .      .      .  .   .        ..
.               .    . .  .       .  .                .    .             .   .              .      .        . .
..   ...  .  . . ....           .  .                            ... .      .    .       ..  . .           .   .
.  . ..           .   .                 .       . ..           . ..         .     ..    .  .    .       .   . .
. ..        .    .. .        .   .  .          .  .       .    .              .  .   .  .    . .              .
..       .                       . ..                    ...        .                                      .. .
.. . ..  .   .       .   .     .          ..  .  . .     . .       .. .. .          .  .            .    .    .
.         .  .          .                 .              .      .     .  ..         .  .      . .        .    .
.   ..          .   . .                    .      .                 .   ..         .     .    . ..    .       .
.                . .  ...    .      . .       .          .    . . . .  .    .     ..          X               .
.           ..   .    ..       ..              .       .                               .          . .     .   .
..                .  .       .          .   .      .  .   .  .    .          .       . .          .  .      . .
.                     .   .      .          . .    .      .   .   .                   .              .        .
.   .   .  .    .  .       .  S .   .           .   . .   .              .     ..       .  .        .     . . .
.             .              . .    . .  ..    ..        .            ..            .      .    ....      . . .
.         .         .  ..          .           . . .                 .    ..       .  . .          .          .
.           . .    . .   .     . .  .      .      .   .        ...                    .          .    . .     .
...............................................................................................................
