.............................................................................
.         .      .                         .       .      .        .        .
.                       .                     ..              X.          ...
.                    .             .           .              ..            .
.                 .           .       .     .             .       .       . .
. ..                .                .                 .               .    .
.                 .     .  .       . .              . .   .                 .
.           .         ..              ...      .   .    .    .  ..       .  .
.    .     .                .                      ..            .        . .
.  .      .         .         ..              .     .             .    .S   .
.        .                  .   .           .             .         ..      .
. .            .     .            . .     . .             .       . .       .
.          .   ..     . . .             .                              .    .
.............................................................................
