...........................................................
. .  .  .     . .   .  .             .   ...     ..   .   .
.     .. .    .           .     .     . ..   . .       .  .
.     . .      .      .        .        . .   . .         .
.                               ..       .                .
.  ..  .                              .   .   . .         .
.. .   . .                    .   .             .       ...
.       .        . .          X  .  .            . .      .
.           .        S  .     . .            .        .   .
.        .       . . .    .   .   .         . ..     .    .
.     ..      .                    .   .                  .
.             .          . .       ...        ...         .
.         ..       ...   .  .     .   .  . .         .    .
.        .  ...                 .              .  .     . .
.           .                .     .       .       .      .
..            .  .                 .  .       . .  .      .
.       .   .                     .                  ..   .
.               .     .                    ..  .       .  .
.                        . .   .     .  ..  .           . .
.  .              .    .  .        .         .            .
.                               .      .             .    .
...........................................................
