..............................................................................................
.    .          .   .          .     .  ..  . .   ..        .     . .      .               . .
.        .                          .   .         .          ..  .            .. .        . ..
.  . ..  .   .       .     .       ..                          .  .  .    .. .  .      . .  ..
.         .   .  ..      .          .   .            ..                                .     .
..  .      . ..       ..  .   ..          .   .  ...          . .    . .  . .     .     ..   .
.    .      . .      .   . ..   .   . .  ..     .  .     . . . ..        .     . .    ..     .
.   ...     .      .      .   .     .. .   . .    . . ..       .   .       .                 .
..       . .            .           S   .  .      .              . .   . .       .    ..     .
.. .  .  .    . ..              .       . .   . . . .. .. .    . .              . .          .
.     .  .   .   ..    . . .       .  ..   .   .             ..          . .          .      .
. .        .   . .           .. .             .   .  .              ..       .    .          .
. .   .      .  .  .     ..  ....  ..              . ... .    .   .    .. ...        ..     ..
.          . ..... .    ..   .   .  ...         ..    . .  . .  .    .                      ..
.  ..  .  .      . .   . ..            .       .         . .    .          .        X..     ..
..     . .    ..      .    .. .  .  .  .   .  .  ..           .       .    . .  ..  .       ..
.           .            .            .    . .           .     .         .. .     .     .    .
.  .  . .  ..        ..    .    .      .  .        .  .  .  .   . .     ..      ..  .   . .  .
. . . . .. .  .  .  .        ..  . .       .          . .      .      ..  .   .        . .   .
. . .     . . .    .  .       .           ... .    . .     .    ..          .                .
..............................................................................................
