.....................................................................................
..     ... .  .   .   .  .      ..          .S ...     .   .    . . ....   .... .   .
.       .         . ..  . ..   .       .          .               . .     .     .   .
. ..     . .     . .          . . .   .      .  .   .         .     .      ...   .  .
.               . .         . .  ..  .          .  .           ..      .         .  .
..     . .     .  .             .  . ..       .    .    .  .     .   .   . .     .  .
.  ...    .            .         .X       ....           .       .   .  .   .     . .
.  ..   . .     .   .        .       .      .  .    .   .          ..         .     .
.   .   .    .   .    .    ..   .      ..               . .   .          . .        .
.   .   .                        .  .                       .            .          .
.....................................................................................
