...............................................................................................................................
.  .   ...    . . . .     .  .  .  .         . ..   .   .   .   .             . .         ....   ..   .       .   .          ..
..   .. .    .  . .   .       ...   .    .  .  .   ..  ..    . . .        .  .        ... ..  .  .      .       . .  ..   ..  .
.    .  ...      .      .          .....  .   .   .  .       .               . .                  ... .       ..... . ..   .  .
. .     . ..  .  . .   ....     .      . ..   . ..   .        .   . ...    .  .  . . .  .   .  . . .    .          .   .. ..  .
.        .  ..   .  . .   .   .  .     .             ..     .   .  .             .       .   ..    ...             .     . .. .
..          .  ..   . . ..        .   .   . . .... . .  .. .     ..        ..  .. . .    .  . . .   .. .  .          . .  . . .
.....  .. ..     ...  ..   . . ..   ..      . .      ... .      ..    .  .         .   .       . .       .  . .     .  .    . .
..      . .  . . . .                      .   .      .              ..    .         .  .         .     . . .          . .. .  .
..  .      ..     .        .  .     . .    . .     .         . .     .       .       .      .. . .  ..   .  ..    . ..       ..
.   .. .        ..          .           . .  .. .       ..    .  .            . ..   .   .  ..  .. .. .       .     .  .  .   .
.....     .  .   . .   ..  ...    . ...    ...           .            .  .           .     ...  . ...          .   ..       . .
.           . .             . . .  ..  ... ....       .     ..    .       .  . .           ... .     ....     .          .  ...
.          .        .   .           . .   ...     .. . .   .       .    . .   .   . .    .      .      ..  .     .  .    .  . .
. .      .    . . ....  ..  ...          .  . .    .  .S    . .  .      .  .  . . .         . .    X.   . .      . .   .   ....
..  .     .  . . .  .   . .    .       .      ..               .      ..       .     . .  .     .   . .   ..     .   .     .  .
.  . .    ...   ..   .     ..  . ..  ..       . .  . .    .         .     . .            .  ..   . .       .  ..   .      ..  .
.    . .       .  . .  . .  .     .     . . . . . .              .  ..   .           ....    .   ..    .. . .  . . .      .   .
.  .   ..      ..      . ...     .       ..  . ..  ..  .   .    ....... . .  .. .  . ...  .     .    .          .      .  . . .
...  . .      .       .  . .      . .    ..    . . .  . .    ..       .         . .   .    . .   .    .         .     .. .    .
. . .          . . .    .. ..   .  .        .   .  ..       . .. . .  . .   .  . .  .       .    ..    .  .   . . . .   . .   .
. . .  .          . .           .         . ..   .   .         . . .   .     ..      ...    ..  .                  ..   .     .
..  .  . .  .      .. .   .  ..  . . . .  .... .      .      .            .  ..       .   .       .    .     .                .
. .     .    . .    . .  .   .   ..  ..   . .     . .  . .  ..       ..     . . .     .   . .      .       .    . .  .    .  ..
.     .   .  ..      .    ..  .   .  .    . .   ..  ...     .  .    .      ...     .   ..      . .    .. ..   .  .        .  ..
.. ...    .      . .   ..   .. .    . .    .       .    .   ..    .  .    . .          . .   .    .           ..      ...    ..
.            .     ..  .  .  . .     ..     ..    ..    ..   .   . . .     .       . . ...   ..       .  ..         .      .  .
.                       ..   ..    .     .  .    . .    .           .       .. ..      .  ..      ..   ..  .. . .   .         .
...............................................................................................................................
