..............................................................................................................................................
.   .         ..      . . . .         .   .   .      ..        . .     .         .   .   ...                     ..        .  ..   .  ..     .
.. . .   .  .                         .    .    ..   S  ..    .    .     .     .           .   .          .    . .    .  .     .   .    ..   .
...   .      . .     .  .                 . .  .  .      .    .      . .    .        .    .  .  .  ..              .    .   .    .           .
.                       .        .            .   .  .  .. .  .   .    . .   .    .   .      . .   ..        .       .      .   .   . ..  .  .
.    .     ..  .       ...              ..                   ..                .. .                      .      .              .       .  .  .
.          .   . .   .           . .               .  ...        . .            .      .                 .                  ....             .
.  ..   . .      .   .       . .   .    .   .     .            . .    . ..          .  .            .             .   ..          .    .  .  .
.    . . .   .           ....        .     .   .    . .     .                     .  .         .         .        .    .    .. .             .
. .  .  .                    ..            .        . . .                  .   .              .            .     X                 .       . .
.. .. .      . . ...         . .   .      . .       .        .        .           .. .    .       .     ..  .  .     .        ..  .          .
..............................................................................................................................................
