.....................................................
..       . .                      .     .      .    .
..  .                          . . .        . .  .  .
. .      S  ..    .   . .  .   .  .  .  .        X  .
.   .   .          .   .    .       .               .
.    ..  ..              .         ....     . .. .  .
. .     ..  .    ..  .   .   .   . . . .       .  . .
.      .  .   . .          . ..              . .    .
.    .  .      .        .    .    .    ...      .   .
..     ..     .. ...      ...             .   .     .
.....................................................
