.....................................................................................................
.     .     . .    .       .       .   .   .                           ..  . .           .          .
. .. .       .             ..  .   ..                  .    ..    .     . .          .              .
.            .               .      .            .             S .    .    .  .     .               .
..                    .   .       .   .. . .   ...       ..  .            .      .  . .   . .       .
..      . . . .    .          .      .   ..  ..     .       ..         .          .  . .  .      .  .
.       ..    .              .      . .   ..     ..   .  ..X . .  .           .                     .
.           .         .   .    .     .                    .        .. . .        ..       .      .  .
. .      . .                     .     ..     . .       . .             .    ..    .     .    ..    .
.....................................................................................................
