....................................................................................
.             .      . .   . .    .     .         ..                 . .    .  . . .
.  .      . .           ..   .                 ..        .                         .
..  .        . .  .           . .     .      .                              .      .
.          .  ..                  ..  .   .            ...    .                  . .
...        ..        . . .             .  .         .     . .     .   .            .
..  .                  .           .  ..      .    .          .  .   .             .
.         .  .         .      .                .   ..               .         .    .
.   .     ..          .. .            .         .         .             .          .
.               . .              .       .  ..   .    .   .   .  .          .      .
.      ..  .    . .                 .           .                  ..    .         .
. .             ..            .     .   .  .   .  .                .           .   .
.      .      .  .       ....                     .             .        .         .
.    .                .   .         ..      .              . .    .  .        .    .
.           .        .   .  .     .             .       .     .             .      .
...S    .           .     ..                     .       .                       . .
.        .                   .          .                 .                 X .    .
.    .            . .        .    .     .            .        .      .             .
.     .               .           .                         .           .          .
.      .                             .    .  .                 . .        .. .  .  .
..    .          .               .    .     .                .   .  .              .
.  .                           .                      ..       ..        .  .    . .
....................................................................................
