..................................................................
.         .    .    .    .       . .   ..        .   .         . .
. .         .              . .                      .            .
.    .    .      .    .        .       . .     . .   .     . . . .
..    .           .                    .  .                .     .
.    .   .    .             .    . .        .  .  .         .   ..
.        . .  .         .      .        .    .             .     .
.       ..                     .         ...             ..      .
.         .   ..       ..   ..        .  .   .                  ..
..       .                      .            .  ..     .      .  .
. .  .      .          .                .    ..   .         .   ..
. .    .     .. .  .       .         .   ..  .      .         .  .
.  ..            .. .    .    .    X.. . .        .  .       S . .
.   ..    .    .              .             .     .    .    .    .
.     .. .               . .                            .     . ..
.   . .   .     .       .             .  .     ...       ..      .
.   .    .  . .   .         .  ... .       .         .       .  ..
.         .      .                  . ..     .          . .    . .
.   .  ..   .  .               .                 .     .         .
.     . ....   .            .     .  .    . .         .      .   .
.      .  . .    . .                          .       .         ..
.    .                             .   ....               . .    .
.        .     .  .  .      .       .      .      . .            .
.      .                . .         .                .   .   .   .
.      . . . .           .      . .                    .    .    .
..................................................................
