............................................................................................................
.           .  .  .     .     .       .  .    .                  .      .   .    .S          .     .   .  ..
.   ..    .. ..    ..     . ...     ..    . .     .     .   . .      .     .  .  .         .   ..      . ...
.   ..    ..           . .      .  .    .        .                                 ..   .   . .  .    ..   .
..  .  .          .    .       .   .      . .     .      .          .      .       ..      .     .         .
.   ..    .  .  . .  . .               .   .   .        . .     .    ..   .   .   .  .      ..           . .
.             ..   .      . .          .            .      . .  . .  ..  .               .   . .          ..
.              .    .     .                        ..     .  .   .  .. .   .. . ..     . .  .   .  .      ..
.                     ..    ..    .             ..         .      .     .            .        . . .       ..
.     .  .      .    .. .    .        ..   . .        .      .    .     .      ..         .              . .
.        .                      .  .    . ..                 .        .                          .         .
.   .               .    .  .   .    .                . .                X. .      .                 ..    .
.    .     . ..   .             ..         .      .        . .   .   .        ..          ..        ...    .
..      .       .   ..    .                    .                    .   .        .      .  . .  .          .
..    .   .                   ...         .  .               . .                        .      .   .     . .
..    .           .   .       . .        .  ...   .          .              .         .      .. . .    . . .
..                .   .     .    .   .          .         .          .  .  .     .      .                  .
.  .       .                    .    .        ..    .                .. ... . .                 .     ..  ..
..   .      . .                    .   ..                       .    .  .        ..    .   .   .           .
...  .       .      ..    ..                  .                  .    ..       .      ..      .       .    .
.      .  . ..     .       .  .         .   .       .       .     .        .      .           .            .
............................................................................................................
