.......................................................................................................................
..     ..  .    .. .    . .    .    . ..         .  .  . .         .    .   .      .   .    ..   .  . ..     .   .. . .
.  ..      .    ..   . ..    .     ...  . . .    . . .       .                . .   .  . .         .. . ..      .  .. .
.  .  .    .   .   .                 . . .  .   .    .         .   .      .     .  . . . . . ..  .          ..      X..
.     ..     ..    .   .      ..   .  ..     .   ..     . . .  .  .     .            ...  .    .     ..     . . .   . .
...        ..    .. .   .  .. .   .  . . . .  ..  . .      .  .    .. . .  .    .     ...      .  .      .            .
..     .  .. .   .  .   .  .     ..  .      .      .. .        .. . .    .. .     ..      .    . .      .  .   . . .  .
.    .  .     ..        .   .          . ...       .. . .    ..         .  .               .   .    .  .  .          ..
.  . .        ..     .     ..    ...  . .      .   ..      .          . . .        ..    .   .   .     ..  .    .     .
. .   ..        .   .  .      ...       .  ..   .  ..   .        . .      ..   .   .          .   . .    .     . .    .
.  .  . .  . .        ...  . ..   . .         ..  .    . . .. ..   .    ..    . . ..  ...  .    . ..     .     . .    .
. ... . . .    . .  .  .. . .       .  ...   .  .     .  .     .     .       .    .. .   ...  ...     .     . ..  .   .
.      .      ..          .      .  . ...   .          .    .     .    . .    .    .      .    . . . .. .        . .  .
.        .       .   . .  .   . .    .   . .   .        .    .      .      ...    .  .      .  . .   . .  .        ....
.  .  . ...        .     ..   .   .    . .       ..... .    ..      .       .        .   .        ..   .         ..   .
..   .    .     ..  .     ..     .. . ..   ..   .. .    .     .    ..   .. .  . ...        .  .   . ....           .  .
.   .       .            . .       .  .  .    ..    .   .  .  .  ..      .      .    .  . ..        .            .. . .
.      . .. .. .      .    ..    .         .  .    ..     . ..                 ..   ..  .    .    . .  .  .         ...
. ...   .      .    . ..  ...   .     .     ..    ...         S .      .   . ... . . .   ...      .  . . .   .   . .  .
. .....        .  . .   . ..       ...   .. ...   . . .. .   . .      .  .      . . . .      .      . .  ..        .. .
.......................................................................................................................
