.......................................................
.   . .  .    .. .     .          .    .            . .
.   .     .        .           .          .      . . ..
.       .  ..           .           .    .   .        .
.  .  .. .       .     . . .           .   .   ..     .
.    .         . .    .        .    .       ..    . . .
. .       .    .             .    ...    .            .
.   X     .    ..       .                             .
.    .    ...     .    .      .                    .  .
..       .     .         . S ..      .                .
.  .    .     . .   .  .       .       .           .  .
.                .             .    .          .    . .
.       ..   .                   ..  . .   .          .
..               ..   .   .    . .      .  .          .
.......................................................
