...............................................................................................................
.   .         ..    .                           .    .       .        ..         .   . .              .    .. .
....            .       ..   .        .                          .                  .              .  .   .   .
.      .               ..  .             .                                      ..   .       .                .
.            .           .        .     .      .                     .X   .       .  ..             . .S    . .
.             ..    . .           .       .                                 .                 .       .     . .
.       .         .  .         .    .        .                   .  .    . .         .                        .
.  ..                     .         .     . .      .       .   .   .        . .     ..                        .
.       .          .                        .  .  .                .           ...            .   . .   .     .
.  .           .                .                 .                           .     ..                        .
.  .               .                                       .              .          ....    . .              .
.      .  .           .         .      .       .        .         .          .                                .
.                 . .  .   .               .            .    .      .        .       .   .           .     .  .
.       .     .                             . .  .          .       .  .       .     .  .        .            .
. .    .    .                      .      .             . ..                    .        .   .               ..
.. .                            ..                    .   .  .       .        .     .     .       ..      .   .
.   .    .          .          .                        .    .    .          .   .     .                  ..  .
.               .     .         ..                                .   .  ..   ..          .     ..         .  .
...............................................................................................................
