............................................................
.    .    .   . .         . ..    .     .  .. .    .       .
..   . .   .        .            . .S    ..    .     . .. ..
...          .  ..     ...  . .         ..   ..     . .... .
... X     ...    ... . .        .    . ..   ..  .  .       .
.       . ...     . . .. .  . ..    . . . .. .  .   .      .
.  .  ...  . .  ...     ..  ..   ...  .   .    ..   ..     .
.   .    .       ..   .. .. .... .. . .   .   ... .. . . . .
. ..   .    .     .    .. . ....          .    .  ...      .
.   .  .  ..... .       .     .. ...     ... .     .....   .
. .   .  .    .   .        .   ..   . .   . .          ..  .
. .   .. . ...      ....... .  .  .. .. . . . .     . ..  ..
. .  ....      .         . .  .   .  .        .. .    . .  .
... .    . ..  .. . .. .  .       ... .      .      ..    ..
. .     ..  .     .         .       .     ..  ... .        .
.  ..  . ..    . .  ... .  .. .        .  .  .  . ..  .    .
... .     .   . . ..                     .  .  ...  .  .   .
. .         .     .   .    ..   . ..    . ..   .. .  . .   .
. .   . ..    . .      .  . ..     .       . .   ...     ...
.    .  ..   ...       .  .   . .   .. . .    .  . .       .
.   .  . ..  .     .    . . .    .   .   . .. . . .  .  .  .
.. .     ....    . .  .  .   .    .. .  .    ..          ...
.  ...  .  . .        ..   .     ...     .      .    .   ...
.   . . . ....   .     . .  .   .. . .  .   . . ...    .. ..
............................................................
