..................................................................................................................................
. ..  .   . .                .  .                            . .      .     .         .         .          .     .               .
. . . ...      . . .  .   .     ..           .    .         .   .           .                 .     .         . ..       X. .   ..
.  .  .  .  .    .        .     .                     .     .         . S .  ..       .             .          .             .   .
.          . .         .    .     .        .          .  .       .  . . .    .   . .       .  .   .   .   .                    ...
..            .     .   .      . ..   ..  .  .          .    . .  .   ..      .   .  . .      .                                  .
.  .  .             ... .                       ..        .   .   .       .      ...  ..            .                .    ..   ...
.  .  .     .    . .      .             .              . .        . . .   .       . . .         .    .     .            . .   .. .
.   .       .   ..          ..  .                 .                     .                      .           ...  .        .       .
.      .      .            .    .  .      .    .      .             ..    .        .  .       .  .   .             .           . .
.  .    .    .    .                              .           . .       .                               .               ..     .  .
.  .   .       .       . .       .  .                       . ..     .. .          .             .     .     .       ..  .      ..
. .     .              ...    . .    .  .  .           .  .   .          ..          .                ..    .      .             .
. .   .    .   ..    .       .    .       .       . ...      .                           .  . .     .      .      .  .         . .
.      .. ..                  .  .  ..         ..  .            .  .    ..   .           .     .                       ..     .  .
..................................................................................................................................
