.................................................................................................................................................
..  . .     .  ..  .   .. .....    .      . ..               .               . .      .  .          . ..   ..        .    .      . . ..  . . .. .
..          ..     . .     .    .   . .    .     .   ..             ..  ...   .           .  .           .      .         . ..   .      ..      .
.        ... ..  . .    .. . .   ...  . .    .           ..   .        .. .  .  .   .  . .     ..    . . ...   S.. . .. .    .  ..   ...        .
.      .   . . . .     .        .        .  . .  . ..  ..     .  ..  . .    . .....   . . .      .      .  .      ..       ..  . . ..    .   .  .
.   . .   .  ...  .  .    .  ..         .  ..       ..            . .. . ....  .  .       .    .       ..   .  ..  . ..          ...   ...   ....
..      .   .         .    .      .   . ..     . .    . .  .. .     .  .               .   ..  ...         ..  ..           . .  . .            .
.    .  .  . ..        . .   . . . .  .  ..   .  ..   ...   ....      .  .    . ..  .  ...  . ..   .        ..   .    . .. .                . . .
. ..   .      . .  .  .    . .....  .  . ..    .. .. ...   . .. . .  ..    . ..         .. .  .       . ... ..        ..   ..  .    ... .   .   .
.    .  .      .      .    .   .       ...  . .. .    .   .    . ..  .  ..       .   .     .  .    . .        . .      . .  .  .     . ...     ..
. .. ...      .   .. ... .    .         .    .  .    .. ..   .  .     . .     ...   . . .....   .    .     .    . . .        ..   . . .      ....
...... .. . . ... ..   ... .    . .  ..  .  . . ..  ..         ..          .    ...  .  .  .....   ...       ..  .    ..   X.   .       ...  .  .
..  .           ... .  . .. .   .  . .    .           ... . . .      .        .     .   . .  . .   .       .        .  ... .        . ..     .  .
... ..    .  .     .  .      . . . .       ..  .    .....  ..  ..  . . . .    ..  . .  .     . .. . .. .  .. .         ..      ..         .     .
. .    ..  .  .     .                     .   .    .   .       .. . .   .          . ... . .    .  . ...     . . .   . .   .  . .... .    . ..  .
.    ... . ... . .       .  .  .     ..   .. . . .  .. . .     ..  . .       . . .. ...        ..   . ..    . .     .  .   ..  . . .       .    .
.      . ....   .    . ....  .   . ..     ..  .   .    ....            .  ...  ...   . .     . .         ..  . .     ..   .   ..  .  .  ..... . .
.               .  . .. .     .   ..    .    .    .  .   .. .. .    .. .. .   .... .       . .. .... .   .         . .  . . .  .  . .  . .      .
.  ....   ..        .  ..      .     .   .   . .      . .. .. ...   .  .  ..   . ....       .  ...      .        .    . .             .        ..
...  ..    .       .    . .  ..        .  .....         .    ..  .  ..    ....      . . .. ... .   .  .       .        .           .   ..    ....
.   .      ..      .     .   ..  .. . .   . .            . .     .  .     ..  .. .  .             .    ..  . .    .      .   .  .      . .   . ..
.  .    .   .         .      .   ..   .  .      . ....  . . .  .  .    ..    .  .   .          .      .                      .      .   ..   .  .
.   . .   .       .  . ..   .   . . .  . . .   ...   .   . . .    ..   .    .. .  .     .                 .         .  .    ..  .           .   .
.  .  .      .       ..  .         . .   .  .  . ...  . .    .     .   . ..   .          .    ....    .  .... .. .. .  .  .     .               .
.. .   ..     . ..   .. . .  .          .    ..  ..          .   .  .           .     . .      . .   .  . .  .      .      ..  .          .  ....
.. .. ..        .        .    ... .           ..  . ..     .  ...   .. ...    . .  . .   .  . .. .  .. . .    .          .      ..              .
.   .      .            .  . .      ..   ...... ..  ..  ..            ..     .   ..  .    . . ...   . ..     .   . .   ...  .   .         ....  .
.  .     .  .  . .  .            . ..  . ..     .  .     .    .    .  .         ..... .   .  .      .      .  . .    .    .    .   .  .   . .  ..
.................................................................................................................................................
