..................................................................
.          .           .     .   .     .                . .    . .
.. .      .           .       .                   . .  .   .  .. .
.   .   . ....       .       .         ..    ..       .   .     ..
. .  .  ..            .       .   .    .    .  .  .   .       .  .
.    .      ..              .  .           ..  ..            ..  .
.       S.  .  . .. .       .              . .     .  .          .
..          .    .  .  .   .      .   .           .  .   .       .
.. .  .   .     .    .    .      ..      .                .      .
.                 .. ..    .      .         . .          .       .
.   .          .           .   ....              .             ...
.   .              . .       .                            .    . .
. .      . .  .                    ...         .        ..       .
.    ... .   .. .   .  .          ..    .  .    . .    .  . .X   .
..    .             .                 .         . .  .           .
.   .  .   .                         .           .     . .       .
.    .       .   .       ..              .  .    .     .         .
.    .  .     .               .  .    .       .      ..          .
..................................................................
