................................................................................................
.    . . . .. .      .      ..   .   .       .   . ..   .  .            ...   .     . . . .   ..
.       .    .         .    X. . . .       .   . .            . .   .. .     ..  .         .   .
. .        .   ...         .   .        .   ...    .        .             ..     .  . .  ..  . .
. .    .  .   . .   .             .                .    . .  .  .....  . ..  .   ..    .  . .  .
.  .     .   ...     . .              .   . .     .. .    .     ..      . .       .. ..    . ...
..     .     .  ..  . .           . ...   .S.   ..         .   .   .  . .  .      ..  . . ..  ..
.  .     ..       . ..  .  ...  .   .      .       .  ..   . . .   .  .    . .  .. .      . .  .
.     ..  .  . .    . .. .  . .           . ... ..    . .       ..          .   ..  ..      . ..
.      .  ..  .. .             ..  ..   .        . .    ..  .         .  .     .  .. .. .. .  ..
................................................................................................
