.....................................................................................................
.  . . . . .  ..  .  .     . . . . . .     .   . .    .    ... ..    .. S       ...      .       . ..
.  .          ...   . .   ..  .         .    . .     .       .        .         . .         ..      .
.  .   . ...  .    .   . .              .          ..       .  .     . .  .   . .. ..  .      .... ..
...        .            . .   .   .   . .     ..   ... .   ...         .    .... .  .      .    . ...
.       .   .  .. .   .       . .   ..   ..    .   .. .. .   .      ..   .       .      .  . ..     .
.  .  . . .     ..  .   .. ..  .     .     .    ..      .  ... ..   .  . .     ..   . ...   .    .  .
.       ..  ..     ..      .  .  . . ..     ..         . .  .         .  .     .  .  .         .. . .
.      .    . .   .  ...  .         .     . . .   ..  .  .       ..    .    .      ..  ..    . .    .
.   .    .  .  ..  .       . . .  . .  .    . . ...  .  .. .        ..   ..   .   .     . ..        .
. . .   ... .    .   ...   ..       .  .  .         .   ....  .           . . . ..  ....   . ..   . .
.    .. .. .     . .  .      .       ..X  .   . .     ..      ..  .  . ..    ...  .....   . .      ..
. ..    .. ...       ..   ..  .   ..  .    . ...        .    .   .     .    . .  .      . . ..      .
.  ..   . . . .  .  . . . .   ...  .  .  .             .   ..     .     ...   . . .    .. .     .   .
.         .    ..   ..     .   .. .   . .   . .      .. .  . .   ..          .   . .     . .     . ..
.     .   .  .  .   .        .         .   ..   .   .. ...   . . .                ..  .     .      ..
..    .  .. ..     ..       . .           ..   .          .    . ... . . .. .. .       . .   .. .   .
.   .  . .     .. .. . . .    ..   .  .....  ...    ...  .     .   ...  .    .         .      .    ..
.  .  . ..       ..    .    .          ..   ..               ..      .. .... . .  .    .    .     . .
.....................................................................................................
