................................
.       . .  .. ....      . .  .
.  ..   ..    .        . .    ..
.     .  .   . .   ..       .  .
.     ..      .     .       .  .
.           .  .....    .  .   .
. .   .  .  .   .  . .. X      .
.   ..        .       .  . .   .
.  .  ..       .     ..     .  .
.   .  . .  ..   .    ...    . .
..     .    . ...        ..   ..
..  .  ...   .          .     ..
.  .        .. . . ..     .   ..
..   . .    .. .  .    . .     .
. .S.   .               .      .
.   .    ..  . .   .    .   . ..
.        .     . .    .  .     .
.  .  . .  .     .           . .
...      .  . .  .  . .     .  .
..  ....  . ..  .     . .      .
.   ..  . ... .     . .   .  . .
.   ..    .     .           .  .
.  .         ..  .          .. .
.   ..    .      ..  ..      . .
................................
