..............................................................................................................................................
.. .        .    .     .  . . .   ..      ..          .. .          .  . .    .        . . .    . ..       .. . .  .  ...   .    .   .     . .
. . .. .   .  ..         ..   .. .  . .  ..     .  .         ...   .    .    .   .....   .. ...            .. .     .     ... .    ..        .
..      . .    .        .    .      .  .            ..  ....       .           .  .   . .           ...    ....    . . .      .    ...   .  ..
. .     .  ..   ..       .. .  .    .   .  .. .        . .     .        .  ..  .      ..    ...    ..  .      .    .. . .  . .   .  . ..  .  .
... .      . .. . .     . . ..  .   .          .   .  .        ...   .       .  .    .        .       . .. . ..    ..   ..            ... .. .
..    . .  ...  .   .   . .  .       ..     ..  .  . ...    .   .. ..           .   .            .   ..     . .      . ..      . .    .. .  ..
.     .. .. . . . .    .  . .         .. .     .      .  .     . .    .     ..  ...   .     .   . .          .  .  .    .  ... .       .   . .
.     .      .  .  .     .   ...... . .       ..      ..    .       .... . .    .  .. . .   . .      ..   .. . . .      ..    .       .. .   .
..  .  . .   ...  .  . ..  . . . . ..       .  ..      .  .  . . .    .   .  .       ...      .    .. .. .  ...   . ...     .   .    ... ..  .
..            .. .    . ..   .            .   . ...         ..      ..     .    ..       ... .          .  .         .         ..  .. ..  .  .
..  ... . .     .     .       ..     .. ..   . . .     ..      .  .   . .            .       .   .  ...    . .  .   .  .   . .        .   .  .
. .           . .    .     .     .    . . .           ..         . .. . .  ..   .  ..   X.   .        ...   .      . .    .  . ...      ......
.    ..   . .  .   .   .      .  ...   . .       . .   . . ... .   ...   .      .   .. .   .   .  .         ..  .      .  .  ..    .   .  .  .
.. . .   .. .  . .        .....       .....     .. ..     .     .....  . .   . .      . .  .  .   .. . .  .       ..         ..      .  . . ..
.   .       .     . .    .      .    . .   . .  ..          . .   ...   .. ..  . ... .  .  . ..    .      . .  ..   . .  . .   .   .   .     .
.  .   .     . . .     .... .. . . .      ... ..   .    ..    ..    .     .    .    .   .  .  .   . .     ..     .      .   . .    .. .      .
.   .   .  .   .  .      . . . ...             .    .       ..    .. . .   .              .  .    .   .   .                .  . S   .     .  .
..     .  .. .   .   ..  .    . ..      ..    . . ..  ...           .  .  ..  .  ..     .  . .  .  ..          .  . .  . .   ...     .. .  ...
..............................................................................................................................................
