.............................................................
.  ..     .   .      .       .     .               .. .     .
..     .     . . .     .                .... .            ...
. .     .                  .      ..        .  .       .   ..
.  ..   .     .       .   .. .  . .      .   .   . .  .   . .
.    .     .  .    .         .  .            . . .  . .. .  .
. .         . .                    .         .     ..  ...  .
.  .         .                     . .  .       .     . . ...
.  .     .          .       .        .          ..          .
.     .           .         .     ... . ..  .    . . ...    .
..   .      ...        ...   .         .    .    ..         .
..        .  . ..   ...    . . . ..          ..    .     . ..
.          . .     .   ...      .  . .       . .   . ..     .
...               .   .  .  X    .        ..  . ...    ..   .
. .  .     .  .. . . . .       ..    ...     .   .  .       .
..                 .  .  . . . .. ..    .      ..  ...      .
.... .    . .     .   .   ..           .            . ..    .
.....  .  .     .   S.  ...   . .   .            . .  ...  ..
.                  ..    .             .    ...  .. .       .
.  . .   .  .           .  . .      . ..               .   ..
...    .             .. .. .   .   .. .    .        . .     .
.    .            .  . . . . .  . .     .       .   .      ..
.. . .      . .     .    .                 ...  . .    .    .
.............................................................
