...................................................................................................
. .      .    .   . . . . . .             ..  .   .     .  .  .   . . ...     ....  .   .  ...    .
..  .           .....    ..         .  .    . .   .            .  .      .   . .   .  .  ...      .
. .   .    ..         .   . . .   .S  .  .  ..   .   .  .  .     . .   ...   .    . .      . .    .
.  .  .   .  . ..       . . .  ..     .      .    . ..    ..      ...     .. . .  . ...  ..   .   .
.   .. .. .     . . .   .       .       ..      .  .     .  .    .     .  .   . .   .     ..      .
. .  . .X   .                .       .   .          .  . .               .     .   . .  . .  . .  .
.     ..  .      .  .  .        .. . .          ..     .      .       .   . .   .....       . .   .
..    . .   . .  .   .      .   .. . .   .. .        .  ... .  ...     .     .  . . ...           .
...................................................................................................
