.............................................................................................................................................
...     . .   .  .  .                   .  .. . . .     ... .     ... .     . .   .       .   .     .     ..  . .     .      ... . ..   .. ..
..     ...      .. . ..       .     .         .     .    ..            ..  ..   ..         .   .   .  .    .   .     .    . . . . ..        .
.. .  .  .. .   .      . .  ..  .          . .        ..       .       .                   .  .            . .     . . .       ..           .
.  .   ... ....    .       . .           ..  .   .      .       .     ... .   ..   .. .   .    .          ..          . .   .    ... .      .
..     .         .  .     .     ...   . ..      .            . .               .       .  .. .      . ... .   ..         .      .           .
.     .      ..  .   .    . .  S      ..  ..     ..     .   .       X...   ...   .      .        .   ..  .  . .  .  .                ..     .
.     .          ..        .   . .   ..  .      .    .     . .         . .           . .  . ..   . .    ...      .                 .  .   . .
.   .          .         .   .  .     .    .        .    ..      ..  .      ... .         .   . . .. .                   .    .          .. .
.     .         .  ...    .         . .. .  .     .   .  .  . . ..  .  .  .... .    ..    .  ..  .  ..     .  .    .   ..       ..         ..
.. .    .  .                  .      .       ..    ..  . . .  .     . .     ..   .  . .  .. .   ... .  .          . .   .    . . . .   .  . .
..    .    ...  .      .    ..       ..   .      .  ..  .    ..     .       .   . .   .     . .    .   ..    .  . .      . ..  . . . ..  ....
.  . .         .       ..            .  .   .  ....     .         .            . .            .          . .     .   .  .       .. . . .    .
.  .  ...     . .           .         ...  .  .              . .       . .   .  . .    . .    .   ..  .       . . .    .   .   .     .      .
.............................................................................................................................................
