............................................................................................................................................
. .     ..      .  .       .     .         ..       .    .    .     .               .            .           .                        .    .
.   .                              .    ...               .       .     . .  ..   ..                 .. .       .                          .
.     .      . .        . .               .   .                     .           ..             ..      . .      .. .        ..  . .  .   . .
.     ..                .        .             .  .                   .       .                   .    .     .       . .   .      .  . .   .
.  .      .    .      .  .   ....            ..    .        .          .  ..        .  .  .         .                                    . .
.           ..                      . .   ..  .            .   .        .      .         . .    .       .                                  .
. .            S   .             .               ..   . .         .   ..   .         .  .                        .      .    .             .
.. .      . . .      . . .               .  .      .          ..    .                             .  . . .     .          .  ..      .  .  .
.             .        .     . . .   .       ..                 .    .                           .   .                          .      .   .
.           .. .       .     .   .           ..        .  .     .   .   .         .                  .    .          .   .              .  .
.   .  .   .. . .           . .                     .  .                       .    ..    .                     .    .      .              .
.    .   .   .    .      .              .    .          .. . ..      ..  .  .    .                        .     .. .   .      .      .     .
.            .                   ..                .    .            .   . .        ..    . ...       ..           .              .        .
.   .   .                             .              .    .   .              .               .              .    .      .       . .        .
.  .   .  X   .                  .               . .             .   .     .      .  .      .                   ..   .             .  .  ...
. .   .   .  .        .     .      ..  .    .   ..      .      .            .   .   ..  .      .                          .    ..          .
. . .      .            .        .    .           ..                   ..             . .                 .                         .    . .
.               .        ..     .   .  .  .     .     ..   .     . ..                          ..   .  .      .               .. .        ..
............................................................................................................................................
