.....................................................................................................................................................
...   ..           .  .  .. .  ..        .   .      . ..          . .                            ...        .     ....  .    .  .  ..    . .        .
..     ..   .  .  .    . ..    .  . . . .  .  ..   .     .  ..    .          .  .  . .  ..   .     ..   .   . .  .. .      .  . .               .. ..
..                    .      .    ..  .    .    .         .     .  .   ..   .    .        .    .       . . .     .        .   .   .   .             .
.   ..   ..         .   .. .       .    .  .. .  .          .  . .  .S. .. .         .     .          . ..     .      .      .      .    . .        .
.    .   .  ..     ...  . .   ... .      .  . . .             .    ..  .     .  .  ..  ..   . ..   . .                  . ..   ..  .     .  .. .    .
.   .  ...  .  .      .   . .  ..         .                 .        .     .      .            ..     ..      .            .  .    ..        ..     .
..     .        ..    .   .   .  .               .  .. .  . .                .   . . .            ..  .     . .  .   ..     . .   .             . ...
. .       . ..           ...            . ...  ..  .      . . .  .   .    .            .       .           . .    .   .        . .   .   .          .
.       . .. .              ....    .  .    . . ..   . .   .    .        .     .  .           .    .    .          ..    . .  .        .         .. .
.           .      ...  .         .  . .         ..         .  .     .  .   .  ..     .        .  .       ..     ..             .    .   ....    .. .
.  ..  .. .         .          .                .    .. .      .. .        .      . . ..         .  .  .    .        .          .     . .. ...     ..
. .     .  ..    .           .       .            .      .    .  ..      ...       ...        ...  ..     .         .    .  .  .        .  .   .    .
.    .. .          .        .. .                ..  .     . ..                .         .       .    .   ...    ..           ..          ..         .
.         . .  .. ..     .   ... .. .. .. . . .                .      . .  . . .   . .. .         .       .   . . ..  .    ....      .. .   .       .
. .      .     . . .    .   .     .  .       .    .    .      . .   .          .    ...       .. ... .    .X .   .      .     .     ...  .  .       .
.   ..     .   .    .   . .. . ...   . .    .      .    . ....          ..   .         .  .  ..       .    ..   ..         .         . .  .         .
.     .     .    .  .         . .     . .                  . .      .         .... ..   .           .. .               ..        .      . .    . .  .
. .   ... . ...     ..  . .  . .    . ... .         .            .    .  .    .      .   .        .    ..               ..               .    .. .  .
.   .   .     ..                   .       .    . .  .   ..             .    . ...              .             ..           .  .   .        . . . .  .
.          .   ..            ..          . .  .   .   ..  ..  .    . ... .       .          . .        ...                .    .  .   .  .  .  . .  .
.   .          ..  .        ..   .   .   . .. ..        . ..... .      .    .   .            .    .  . ..       .  .  .         .        ...  ..    .
.   .       .   ..      .      .    .             .     .           . .       .   ..      .     .      .   .     .     . .  .   .  . .     .  .     .
.    . . ...    ..       . . .  .    .   .. .  . . . . . ..    .     .     .      .     . .. .      . .   .   .   .  .. . . . .    ...   . .    . ...
.             ..     ..        .. ...  .  .. .     ..    .               .  .  .    .       . .    .    .    ..      .     .  .   .   . .   .    .  .
.....................................................................................................................................................
