...............................................................................................................
.         ..  ..         .     . .   .. ..  .   . ..   .             .      ..        .    .. . ...  .        .
.  . .         .     .      .      .  .    .  . ..   .  .      . ...      X     . . . . .    .      .. .  . . .
... .    .    .   . .       ...  .    .   .        ..    . .. ..  ..        .   . ...         ..        .  .  .
.    .                            . .        .S . .    . ...         . .....    ..   .         ..   ..  .     .
.    . . ...   .. ...     .  . ..      . .  . .  . . .  .  ..   ..   .. . .       .     ..  .  .       ..  .  .
.  .          .       .    .    . .         .      .... .        .. .  .     .    ... ..   .      .    ..  .. .
. .  .  .       ... .  ..  .. .  .   .        .    .  ...  .           .  .     ..   .    ...     .       .   .
.  .    .   . .     .  . .          .  .   .     .   .          .. . .. .. .       .. .  .   ..       .. .. . .
. ..               .  .      . .  . .   .        .     ... .  .            . .             .     .   .... .   .
. . .     .       .                 ...    . .       ..   . ..  .   .  .        .    .            .  . .      .
..  . ...    . .   ..   . .  .   .                 .     ..  .   .    .   .     ..    .   ..    ...           .
.     . .     . ..  .   .        ......     ..  ...       .    .     ..  ...             .      . .....     . .
.            .. .    .  . .. .  . . . ..         .    .  .    .  .        .   .. .  .    . ...         . ..   .
.            ....    .  ..    .   . . .       ... .    .    ... .. .    ..    .   . . . .  .     . .       .  .
.    .    .     .       . .   ..   ..  .   ..          .   .. .   . .       ..  .    . .   .        . .   . . .
.  . .        . . .... ..    .  .   .      .       . .  .. ..      .  .         .  .     .     . .. .    ..   .
..  ..      .            .. .       .                  .  .   ...  . . ..  .       ..   .    .          .     .
. . .  .... .   . .. .  . ..        .   .                 . .       ...                   .  ..            .  .
.     .         ....  .. .     .    .              .....   . .      .     ..        .    .   .          .. . ..
...............................................................................................................
