...................................................
.    .  .                .      .        .  .   . .
.        .           .     .                 .    .
.  .                   ..  .                .     .
.             .   .           .  .              . .
. .   ..                 ...    .                 .
. .               .  .           .          ..    .
.                           .                     .
.       ...      .     .                     . .  .
.       ..  ..      .                             .
.     .                     S    .          .   . .
.      ..       .       .      .                  .
.     .                    .                  .   .
.      .   . .              .                     .
.              . . X ..     .                     .
. .   .       .  ..             .               . .
. .                   .   .          .      .     .
...................................................
