................................................................................................................................................
. .   .                  .      .              .                 .         ...          .                      .   .            .  ..       .  .
.            ..    .. .  .  ..  .        .                   .  .      .           .     .        .                       .    .          .    .
. .              .              .  .    ..   . . .        .  ..                 .    .        .   .  . .   .       .           ..              .
.    .          .    .                ..           .       . .      .                .   .          .        .    ..                       .   .
.  .  .                              .   ..  .  .                                     .    . .        .   .     .   .             .          ...
..  ...  . .       .                .                   .      . .. .                              .         .          .             . .      .
.         .                    . .  .               .     .          .                    .       .         .      . .  X         .            .
..                                       .    .       .        ..      .                 .         . .             . .             .           .
.                    .     .          . .     .     .         .  .        . .     ..  .                    . .       .                         .
.  .  .    .  . .      .   .   .      .                        .                .       .   ..     .         .      .  S    . .         .      .
..    .               .    .        .  ..    .        .     .. . .  . .   .              .      .    .         .     .        .                .
.  . .. .. .  .  ..  .         ..     ..  .    .    .       .    .       .  .        .       .    .      ..         .     .          .  .      .
.      .    .            .           .                                     .     .  ...    .. .  .  .       .                          .       .
. .   .                           .       .            ..    .     . ...         .     .                 .                                     .
................................................................................................................................................
