........................................................................................
.   ..  .    .    . .        .           . .               .  ..   . .  . .    .. .    .
.. .   .   .. ..    .    .     ..  .            . .    .. .        .              . .  .
.   ...      .              .       ..          .  ..      . .   .   .     ..       .  .
.    . .          .         .          . .  .          .  . . . .       .... . .       .
.     .   .    .      ... ..  .  .  .  .  .. ..     ...     ..   ..   .        . ..    .
.  ..    .      .     ..   . .    . .   . .        . . .   .  .          ..   .      . .
.    .      ...         .   .       .    . ..    ..  .    .   . .  .     .    .      . .
.   .S        .    ..  .     .     ....     . ..    . ..    .              .  . .    . .
..  .    ..        . . .     .  . .   .  .       .    ... .   .  . .  .     .       .  .
.  .   ..         .  .   . .      .  . . ..     . . .X     .           ...   .     ..  .
.   .     .   .       .  .  ...   ..  ...    . .   .   .    .  .   .  ..  .  .     .   .
.        . ... .   .    ...     . .         .  .          .  .  .. .    .     . ..   ...
.      . .         .... .   ..        .    . . ..      ....       .. ..     .. . .    ..
. ...          .      .    .  . .     ..   .    .   .      .    ...  . ..  .        .  .
. . .     ..  .. .    ...        . . .   . ...   .    .   ..      ..    ..     .  .    .
.        . .    .       .     . ....   .    .      . .    ..     .           .    .    .
........................................................................................
