....................................................................................................
.   .      .  . .    .   .      ..  ..   ...    .   . ..   ..       ... . .    . .       .. .  . ...
.      .       .     ..           ...      .   . .           . .       . .  .      .  ..  .    .  ..
.   .    .    .  .       . .      . .  .  . .   . . .  . .    . . .          ...  .    ..          .
.  . .    .    ...  .   .      . .. . .. . .         X  .  ..   .  ..  .       .  .   .  .  .      .
.  .  .  ..     .    . .    ..   .   .     . .    .     .. .   .  .        .         .   .     .   .
.  .       . .        .        .   ...             .  .   .   ..      .. .  . .  .          .      .
. .    .  S .     .     .  .  ...  .  .     .  . . .          . ...  ..         .     .  .    .  . .
.     . .      .       . . .       ...   .  . .          .    .   .      ... .... .  ...  .        .
.  .   .   .  . .     .       ..   ..     .... ...     . .   ..  . .  . .    ..       .     . .    .
..      .              .  .       . ...   .  .       .. .          ..    .      . ..        .      .
..  .... . .          ..        .      .    .       .    .  .      .  . .     .  .  . .   .   .   ..
.     .      .   ... ..     .  .           .    ..     .    ..  .      . .        . .     .  .. .  .
.        .     .       . .   . . .   ....            .              . .   .   ..    . ...  . .    ..
....................................................................................................
