........................................................................
.      .    .       ....       .       .      .                 .   .  .
..  ..  .   .    .          . .       . .     . .    .                 .
.   ..   .  .     .                    .  .      .                     .
.   .  S      .  ..        .          .     .  .     ..  .     .       .
.   .         .  .  .. .        .     .                        . .    ..
.   .      .  . .     .   ..  . .           ..          .     . .      .
.        .              .              X .     .        .   .  .    .  .
.   .    ...     .  .  .  .               .     .     . .  .    .    . .
.           ...  .     ..   ...  . .    .          .           .       .
........................................................................
