.................................................................................................................................
..  ..         ..   ...              .. ..  ...       . ..    . .    .       .         .    .      . . . .      .     .   . .  ..
.  .  .  .  .         . .    .     .   .      .. ...           .  .         . .          ..  . .  .            .                .
.. ...             .   ..       .           ...  . ..        ...     .. ..     . .    .   .  .       ..   .   .     .         . .
.        ..   .            .  .           .    .  ..        .    .    .   ..  .     .           .   .          .     .          .
.  .      .    ..       .        .  ...    .         .    .                    . .       .           .    . ...          . .  ...
.   .   .  .    .  .     ..   ..          ..  . .   .        .   .. ...   .                 .  .      .  . . ..  .       .      .
. .   .  .  .  ..        . . .. .     .     .  .                      .. ..          . .  .         .    . ..  .           .    .
. . .      .   .     ....            ..  . .          .  . .     .  ..    .        .       .  . .   . .   .      .    ..   ..   .
.  .   .       .           . .. . .  .    .                ..   .         X.  .     .             .    . ..   ..     ..    .  ...
.    . S...     . .  . ....    . .     .      .  .  .          .         ...  ..              .    . .    .....       .         .
.          .  ..    .  .  . .       .       .   .    . .   .   .  .   .    . .    . .   .     .. .         ..      ..      .    .
.................................................................................................................................
