..........................................................
...   .                     ..   .   ..    .      .    ...
. .   . . .                        . .             .    ..
.   .     .       .  .         ..     .    ..    .  .  . .
.                    .       .      .       ..      X  . .
.   . .. .   .     ..   .        .      . .      .      ..
..   .S  ..        .       .  .  .    .   .     .     .  .
.     .       .       . .            .   .  .            .
.   ..               .  ..               .        .      .
.         .      .        .     ..  .   ..               .
.        .     .           .         .              .    .
. .   ..    ..  . ..      .     .  .    . .   .       .  .
. ..    ..        .             .   .                   ..
.   ..                 .  .. .             .             .
.        .  .           .  .       .                     .
.   .  .      .    .       .     .  .  . .             ...
..........................................................
