............................................................................................................................
.     ..  ..      .  ...  .  ... . .     .  .    ..  .           ....   .       .  .  .      .     .        .....       .. .
... .         .  .              .     . .. . .      .      . .  .   . .  .  .   .     . .        .  .       ..  .  .       .
. .. ....  .     .  . .     ....      .  .   .  .. . ..  ..    ..     . ..  .   ..    .    .   .     . .      .  .  ..   . .
. .. . ....  ...    .   .   ... .       . .    .     .    .. .   .   .           . . . .     .     .   .  . .  .   .     ...
. ...     ..    .        .. . .    ..   .  .     . . .   . . . . .       . .      ..   .. ... .          ...  . .         ..
.  .  .   ..      ... . . .        . .  .    . ...     .    .  .    .        .. .      .. .. .   .       .   ..  .         .
. .   .     ... ..  . . .   . .. . .  . . .      .. .  ..   ..         . .  ..  . .       .        .  . .    .    ... . .  .
.  .   .  . .    ..  . ...  . .. .     ..  . .   .  ..   .  . .  ... .  .  .          .   .   .  .    ..   . .    .   .    .
... . .    . .     . .  .   . . . ..   . .. .         . . .     .  . ..  ..    .     ...   . ..   .   . .  . ..       . .  .
.   .         ..  .     .  ... .   . .          .     .         ... .  .  ..       . .  . ...     .             . ..    .  .
. .    . ....          . ... ..   . .      ...   .         . .  .         ..      ..      . .   .     .     ... .          .
.        .. .        ....   ..  . .  .  ..    ..    ..          .     .    . .      . .   .  .    .        ..  .          ..
.      .  .   . .   .    .    . ..             . ...     ..  . . . . . . .S    ..   .    . .  .  . . .  . .   .. ..     .. .
..    . ..    ..  ...X             . .  .      .  . . .  .. . .  .       ..     ..    ..    .. ....  . ..  ..... . .  ..   .
. . .    .     ..  ... .     .. .. ...      . . .....   ..        ...   ..      .    . ..  .      .   .     . .   .  ..  ...
.... .   .    ... .   ..    .    .        . .   .      ...   .  .         ..        .. ...        .    ..   . .          . .
.  . .     .    .  ..   ..     .  . ..  .    .    .   .  ..    .    ... ..   .     . .. .    .   .  . ...   . .    .  . . ..
...  .  . . ... .....    . .. .  .         .  .. . . .. . .. .  .    . ....        . . .      .    .    . .  ..  . .  ..  ..
.     . .          .        . .     .         ..... .   .      ..  ..    .   ...    . .  ..   ..    .    . ..    .. .  ... .
.     . .    . .     .  .. .      .     ...     .  ......  ....    . . .     .  . . . ...     . ..  . .   ..  .  .    .   ..
.   .....      ..   . .  . .    .      .  .  .  .             .     ..   . ..   .     .   ..        . .  .       ...    .  .
..   .      .    ..     .    .     ..    ..     . . ...      . .. . . .      .  . .                .   .. .  . ..  .    .  .
.  ..     .      . .  . .    .  . .       .  ...   .        .  . .. . .  .   ..          .          . ..  .   ..  .        .
.   . .. .                 . .  .     .... . . .         .   ..  ..    . .  . . .  ..   ..     ....  .       . .. ..       .
.   .         .. ..    .       . .     ..  .  .   ..      ..   .   ..   . .  .   .    . ... .  ..       . .   ..        ....
............................................................................................................................
