.....................................................
.               .   .       .        .  . . . ..    .
.     .       .                   .  .         .  . .
.       ..         .                .          ......
.             .       ..     . ..  .  . . .   .     .
.     . .                      .         .         ..
.             .    .     .      . .       .   .  .  .
. .  .  .        . ..     ..    .  .  .           . .
.    .             .    .         ...      .        .
.  ...       .    .  .           .      .      .    .
. ...         .      .       ..      .  .           .
.        .      .  .   . .        .         . . .   .
.             .X         .    .       .             .
.                         .. .. ...      .  .  ..   .
.  .       .   ..     .  .  S   .     .   .   .     .
.          ..      ..        .. .               .   .
.    . .  .   .          .      . .    .       .    .
.      . .       ..    .       .                    .
.         .        .            . .      .          .
. .     ..  .        .         .        . .     .   .
.         ..   .     .   . .   . .  ..   .     .   ..
.    .  . . ..    .           .    .    .       .. ..
.                 .         .    . .          ..    .
...        .      .   .           ..        . .  .. .
.   .     .. .   .       .   .            . .       .
.       ..         .     .       .       .         ..
.....................................................
