.........................................................
.       .  ..  .  .    .. .    .   .        .   . . .  ..
.         .      .    .    . .            .    .    .   .
.      .    .     .         .. . . .. . .            .  .
.                .    .      .   .   X ..  .     . .    .
. S ...  .         ..   ... .  .              .        ..
.       .             .      .                       .. .
.  ...   .   . .     ..             ...   . .  .     .  .
. . .       ..  ..    .    . .  .                  ...  .
.          .   . ..   .   . .  .  .       .         ... .
.        .  .   .    ..  .         .. ..      ....  .   .
.  .          .           .    .   .  . .      .        .
..        . .    .     .  .  .  ..    .   .          .  .
.     ..             ..     ..             .      .  . ..
..      . . .              .                      .  .  .
..  ...           .  .       ..           . .           .
. .  . .  .       .  . ..        .    .  .      .      ..
. .  .      ...    . .                 .   .           ..
.           ...   . .           .         .             .
..         .    .     .   .     .    .         .        .
..     .        .       ....      .    .  . .           .
.........................................................
