..................................................
.     .                                          .
..   .    .      .        .                      .
.    .                 .   . .      .  .         .
.  .  .     .    .       .   .       ...    .    .
.   .             ..  .  .  .  .                 .
.                     .        ..      X     .   .
.      .           .    .             .S    .    .
..  .      ....                        ..       ..
.            .       .   .        .              .
.      ..                .     .          .      .
.         .   .     .       .     ..        .  . .
..................................................
