.............................................................................
.       .....      .    ...   . .  .  .    . .    S        .   . . .     . ..
.   ..   .X  .      . .     . .. . .   . .          .   .     .       . .   .
.    .   .   . .   .. . . .        .          .     .. .  .        . .      .
..   .     . .     .  .        . .    .   .      .. .  . .            .     .
. .      .          .          .   .  ..    ..   . ..   ...   .           ...
.  .           .  ..   ..    . .   .    .  .  . .     .  .   ..            ..
.  ..   .  .     .   .          .    .    ..   .    .   . .  .    .   . .   .
.  .  .      .       ..  .      . .     .   .        . .      . ..    ..  . .
.............................................................................
