.....................................................................................
..  .   .          . .  .  . .    ...    . . .  .   .      .  . .   .          .   ..
...       .   . .  ..    .                .    .      . ...    .    .        . . .. .
.       .  . ..      .      .             .     ..  .       . .    .       .        .
.S .  X  .. ..       .        . .   .. . . .   . .    .     . ..  .    .  .  .   .  .
.    .  ..   . ..     .      .   .       ..  .     .     .   .      .     . .       .
.. .. .  . ..   .     .. ...       . .......       .   .   ...  . .    .      . .   .
..  . .      .   .  . .     ..   .  .      .  ..    .        .... . . .  . .   .. . .
. .   . .  ..  .  .      . .         . .      .  . ... ...      .. ... .  .       . .
..        .     . .   .           .            .  .    .    .       ...      ..   . .
. . .. .       .  ..  .   .   .     .                .               ...       .   ..
.. .. ..      .   .   .  . .. ..  .   ..           ..   .   .    .   .    . .   .   .
.....................................................................................
