...................................................
..  . . .       . ....       ..     .    ...      .
. ... ..      ..  .     .  . . .      ..  .  .  . .
...  ... .. .     ... .  . ..   ..   ....  .  .  ..
.    . .    .          . .    . .   . .  ..  ..   .
...  .  .    .        .. .           .   .        .
. . . S   ...    ..   .     . .             ...   .
..   .        . .              .     .       .   ..
.  . ..     . .  .       ....    .  . .     .  .  .
. . .      .             .   .     .     . ..  . ..
.  .  .. .. .. .      .   ..           . ..    .  .
.              . . . .     .     ..         . ..  .
..      .  . ... .  .  .  ...             .. .   ..
. .   . .         ...  .  .    .    .        .    .
..    . .   .  . .  .  .    ...   .   . .   .     .
.   . .     .  .    .                    . ...  ...
...   .  .      ...   . ...         ....  .. .    .
. . ..    .      ..  . . . .     ..   . . . .   . .
.      . .. .   . .   .   .. .               . .  .
. . .      .     .  ..          ... ..    .    . ..
.    .   . .  .. . .. .  ..      . .   .  .   .  ..
.       .      .       .      .      .            .
.     . ...   ...X .. . . ...  . . .     .        .
.  ..  ..      ..     .  .  . .. .  .  . . .  .   .
...................................................
