........................................................................
.      .               .         .        . .                 .     .  .
.                    .         .          .      .   .   .      .  .   .
.    ...        .       .    .         .                 X  .. .    .  .
.  .              .           .     .  . . .. . .                   .  .
.         .  . . .        ...  .  .      .       .                .   ..
. ..   .                   .        .. .        .    .             .  ..
.. .     .            .    .  .            .  ..             .         .
.   . .  .         .  .          .      .            .  .              .
.    ..  .               .         .         S   .       .       .     .
.      .          .  .      .  .            .                   .      .
.. .   ..    .   .  .   . .  .      .    .     . .  .         .. .    ..
.                  .    .           .  .       .   . .. .     . .     ..
.   .          .   .     .      .  . .               .              .  .
.         .  .   . .                  .. .                            ..
..        . .        .   .. .        . .          . .   . ..           .
.   .      .           .       . .   ..      .           .   .   .     .
.     . .        .. .          ..     .    .    .   ..     .  .     .  .
. .       . .       .  .. .        .             .           .      .  .
.       .    .    .            .         .  ..  .. .                   .
.  . .     .     .        .. .                   .      .        . .   .
.   .  .. .     . .    .                .  .       .     .      .      .
.                       . .                  .   .   .   .   .      .  .
........................................................................
