..............................................................................
.  .. .    . .         .   .  .                     .   .          .      .. .
.       .                  ..  .      .  ...   ....   .. .     .             .
.  .   . ..     .  .    .  .           .     .  .   .      .                 .
.        .     .      . .    . .  .        .   .  .   . .     ..           S .
. .  .    .       . .   . .  .         ..    .           .  .  ..     . .    .
.      .   .. . .   .. .    . .       .         .    .   .    .   ..  .      .
.     . . . ... .      ..   . .         .   .   .    .       .. .......     ..
.. . .   . .. .       . .     .       .  ..     .    .        .  ... . ...   .
. . . . .    .  .  .  . ..    .       .   .   .     .  .    . .. .    ..     .
.. .   . ..  .       .     . . .  . .. .     .      ...     ..         .  .  .
.    .   .  . .  .. .    .     .      .    . . .  . .   ..       .   .       .
.                .    .    .   .       . .. .          .  .     .      ..    .
..   .         . .    ..      .     ...     .  .  .       ..   ...           .
.. . .   .  . . . ..         .     ...     . .      . .       .  .     .   ...
...   ..   .  .X    .  .          .. .  .   .. .  .   .    . ..   . .  ..   ..
. .  .     .     .       . .         .               .    .     ..     ..    .
.. .   .  .  .     ..      . .           . .    .     .              . .  .  .
.   ..        ..   .  .     .  ..    .    .      .       . .  .    ..  .. .. .
.     .     ....     .   . .            .   .      .      ..        . ..     .
..............................................................................
