.....................................................................................
. .            .       .      .                           ..  . .  .   ..       .  ..
. .                  . .      .     .     .            .   .      .  . .  .   ....  .
.  .       .     .                      .           .    ..          .              .
.             .    .   . ..                          .   .   .  ..  ..       .    . .
.   .     .   ..         .  .                           .  .                        .
.  .            . .     ...                      .                     ..  .        .
.             .  .   .       . . .     .     . .  .   . .          .           .    .
.  .      .         ..        .       ..  . .. .         .  .. .         .         ..
.               . .       ...               .       .      .  .      . .    .       .
. .   .        .                .     .   .   ....                       .    .     .
. .             .       .. .         .  . .   .     .. .      .       .     .       .
.  . . .  ...    .. .        . .  .   .  ..  .         ..                 .   .     .
. .    ...  . . . ..       .                 .      .   .          .       .       ..
.  .                          .       ..   .                 .. .       .    .  . . .
.              .         .                 .  . . .          .               .     ..
.       .               .       .. .      ..          .                    .  .     .
.                    .              .   .           .    .    .   .    .      .  .  .
.   .     .        .         .   . .     .        .   . .      .          ..  ..    .
..  ..    .   .              .      .          ..         . .  .       . .         ..
.  ..   .         .    .  .     .  .    .        .     .                       ..   .
.  X . .  .    .            S       .        .        .                  .   .   .  .
.  . .    .   .  .     . .              . .. ..  .          .   ..       .         ..
.    .                    .         .      .     .   .     .   .  . . .     .  . . ..
.           . .     .  .  .   ..    .   .    . .                .     .             .
..                 .  .  .       .. .  .   ...   .               .                  .
.                        . .. .   ...           .  .        .   ..  .               .
.....................................................................................
