.............................................
.   ..    ..      .     .   . ..    . .     .
. .  .   . .  .. .              .   .     . .
.    ..  . . ..     . .    . . ..     .     .
. .            .     . ...      .      ..   .
.  .         .. .  .  .      .       ..  .  .
.. .           .           . .   .      .   .
. ..      .    .          ...  .        ..  .
.    ..        .   .  ..   .. .   .  .  .   .
.    .            . .X  . .     . .   .. .  .
. .   ..      ..  . . .       .  S      . . .
.   .   ..       .. .. .        .    ....   .
.  . .   .    .  .   .    .. .   .      .  ..
..  . .     ....   .   . .   .      .   .  ..
.............................................
