...........................................................................................................
.     .   .  ... .     ..     .        .      .     .      .   ..        .. ..        . . . .             .
..             . . ...        .    . .  ..           ..      .   . . ... ..     .    .  . .             . .
...         . .        ..           .    .  ..    .     ..               .  .  .                ...       .
.  ...      .                  .          .    ..   ...      .    .      ... ..    ... .           ...  . .
.     ..  ..          .      .   . .       ..         .        ..  ...        .      .. .   .      . . .  .
.     . .      .                    . ..  .   .        .    .  .. .        . .   .            .  ...      .
..  . . ...     .    .                .  .        .       ...  .                  .     ... .  .   . .... .
.     .     .  .    . .      . .      .       .         . .        .              . .          . .      . .
.     .     . .    . .   .   .   .   .. .    ..  .     .     . .       . ..         .     .       .    .  .
.   .         .   .   ..  .. .   .   .  .  .         . . .       .    .      .. .  .          . .     .   .
.      .   .   .               .  . .       .      .  .      ....       .         . .  ..    .    .    .  .
.         .  ..  .         .. .  .        .     .         .   . .             .     ..       .    . .   . .
..  .  . ...     .        .             .X       .           .     . . ...  .                     S.      .
... .      .     .    .  .     ... . ..     .  . .      .       ..   .        .  .             .  ....    .
...........................................................................................................
