....................................................................................
.  .                    . .         . ..   .          ..             . . .        ..
. .         .   .           .         .  . . ..     .. .          .    .   ...     .
.      .    .   ..  .  .                .     .          . . ..  .   .   ...       .
. . .       . .     .   .  . .  .             .     . . .           . ..   .       .
.    ....  .     ..   . .           .         .      X       .                  .  .
..    S    .        .. .. .    .     ..            ..     .    .     .      .      .
.      ..  .  .    ..  ..    .              ..     .    .. .     .        .     .  .
.  .    .     .          .        ..    ..       .  . .        .     . .           .
. .   .  . .      .   . . .. ...     ..                .       .  .        .  .    .
. .   . .      ..   .. .           ..    ... .   .         .         .         . . .
..   .           .   ..       .   .   .    .. .  ..              .     .           .
..     .      .    .    .     .                ..   .   .      .  ..  . .     . .  .
. ...  .   . .   . .                   ..  .        .  .     ...            . .  ...
..       ...  .  ..   .     .   .           ..      .          .   .           .   .
....................................................................................
