.............................................................
.       .   .. .     .   ..   .    .                  ..   ..
..      .  .          .                          .   .     ..
.    .     .   .S   .       . .         ..   .     .        .
.      . ..           .              . .  . .               .
.        .. ..                         .          .         .
. .  .                 . .    .  .    . ..         .        .
.         .    .. ..    .          .            .         . .
....       ..  ..    .    .    .    .                .      .
. . .          .. .  .   ..    . .   .       . .   .       ..
.    .                  . .           .  .       . X.       .
..     .  .                             .         . .       .
.............................................................
