..................................................................................................................................
. .          .            . . ..         .             ..  .            . .  .       .  .  .  .      .        .  . .     .       .
.     .     .     S               .                        .        . .     . .    .  .        ...   .     .              . .   ..
.  .   ... .    ..      .  . .    .  . .     ..   .   ..    .  .    ...      . .    .  ...       .                            .. .
.   .     ..         . . .   ....     . .. . .  .   .               . .               .       .     .  ..  .           . .       .
.     . .   .    .. ..    .    .    . .. .   ..          .                  .    .    .  .       .          .                    .
.   .  .     .                   .              .              .      .  ..  ....    ..    ..       .   . .              ..  ..  .
.  . .      .. .          . . ..  .  . .  ..     .    ..   .                     .     .          .       .  .    .         .    .
.. .   .    .     .      .               . ..     . . .           ..   ..  .  .      .          .      ... .                  .  .
.    ..    . .      .          .   .  .   .   .                . .       ..        .   ...  .   .        .              ..   .....
.          .  . .           .   .               .         .   . .  .    ..   .                ..   .   . .        .            . .
.X..     .       . .      .      .       .        .    .       . .    .        .  .     .     .  .  .       .        .. .        .
.     .            .              .  ..              .       .   .   ..        ..  .  ..    . .    .    ..   .  .         .      .
.  .  .      ..      .  .     .  .   .       .    .  .   .       .. .  . .  .   . .       .           ..      . .       .   .    .
..................................................................................................................................
