.......................................................................................
.  ..     .                .    .   .            .             .                      .
.. .     .            . .   .   .     .           .         .    ..   .   .  .        .
.    .   .     .          .                ....           .           .       . ..    .
. .             .         .  .  .         .    .. .         .S           .    .     . .
.                            .        .    X.    .               ..   . .             .
.     . . . .                                     .  .              .           .     .
.       ..                 .         . .                .       . .           . . .   .
.                ..       .                .     .   .. ..   .        .  .  .     .   .
.......................................................................................
