................................................................................................................................
. .   .      .                 .. .                                   .   .   .. .            .           .   .     .          .
.       .           X     .                              .     .    .  .....                             .   .    . .   .      .
.  .         .        . .               .                      ..          .           .        .  .     .                     .
.       .    .                                 .            . . .      . .             .  .   .          .            ..       .
.    .   .  . .             .              .  . .   .            .     . .       . .                         .     .....       .
.      .               .     .   .   .                .    .        .                        .                 .              ..
.  .  .         .                      .    .      .     .    .                   .       .                .             .   . .
.                     ..     .         .                    .                          .   .     .                       . .   .
.           .   .     .          .                  ..                     ..           .    .   .                             .
.       .  ..       .      ..    .      ..       .            .      .  .  .  .                 .   .                          .
.  .   .   . .                          .                     .    ..           .    ..         . .                           ..
.           .           .              .      .        .            .           .    .  .   .                       ..         .
.   .    .        .          .         .                  .   . .                .      .     ..       .  .   .       .      . .
.                       .      .       .      .               .            .        .     .  .  .       .       .     .    .   .
..   ..    .                    .              .      .             ..   ...                   .            .           .      .
.      ..      .      . . .      .     . . .            .                  .               .      .  .     .                 . .
. .       .   .    .   .                 .    . .     . .    .      ..     .       ..                       .   .     .  .     .
.  .. .. .               .              .      .      .                           ..    .    . .          .             ..  . ..
. . .        .     .      .         .       .. .   .    .          ..     .                     .           .      .           .
..    .                 .     .  .          .             .               .    .          .             .       .              .
.       .  .             ..  .   .     .                . ..          .     .      .             .       .                     .
.      .  .       .         .      .          .                  .      S  .              . .. .     .      ..      . ..       .
.       .  .   ..            .   .                      .  .           .  .             ..         .            .     .       ..
.        .    ..                             ..   . .         .          ..          .         .    .  .       . .             .
. .              .       .      .   . .     .  .         .             .               .  .     .  .....                     ...
.      .       .    .          .    .     ..    .     .          .        .       .     .                         .  . .       .
.   .   . .              .     .   .    ..    .. .    ..       . ..  .   .     .            .       . ... .               .    .
................................................................................................................................
