...................................
.    . .      .        .   .     ..
.     .       . .   .            ..
.       ..   .      .    .        .
.         .     ...          ..   .
.  .  .              ....         .
.  ..                  .    . .   .
. ..       ..   .            .    .
.   ..S .      . .          .   . .
.  .   . .           ..   .  .    .
.               .   .   .  X      .
.           .     .     .  .. .  ..
.   .         .  .          . .   .
...................................
