...............................................................................................
..     . ..   .      .        .   .        ...   . .        .. . .          .. .              .
.        ..         .  .      .   ..      .  .         .      .   .        ..  .              .
.     ..   .  ..  .  .                . . .  .       ..        .   ..     .   ..   . .   .    .
.       .                  .         .     .     .                  .     .   .  .   ..       .
.     .              .   .  .   ..               ..  ..       ..       ..    .  . . .     ..  .
...      .    .          .   . .  .         . .  .           . . ...              .          ..
.      ..     .                .         .    .      .               .                     .  .
. . .   .        .. . ..     .    .     .          .  .        .        .    .. .   .      .  .
. .            .        .      .     .       .    .    .               ...       .     .      .
.  .  .                    .          .                     .  .   . .     ..   .           ...
..   .  .. .             ..       . .      .        .   ..   ...       .  . .               . .
..       .          .    .     .   . . .. .       .    ...      .   .           .  .          .
.          ..    .            .      .. .     ..                       .        ..  .     .   .
.    . . .             .       .    . ..         ..                           . .       ..  . .
.      .              .       .   ..  .    .              .        .    .       .     .   .  ..
.                 ..       .      ...    . . ..   . .        ..           .       .X .      . .
.       ..  .         .        .    ..        .   . .                    .  .  .    .     .   .
.           .  .    .           .      .       .. .            .  ..    .. ..    ..  .    .  ..
.     . .     .      . .    S      ..    . . .       .            ..          ..      .       .
..           .   .  .    .   . . ..     .  ..    ...   .               .           .   .    . .
.   ..  .  .           . ..           .    . .            .        .   ..     .. .     .      .
.     .             .      .            . .  .        .    ..     ..    .      .      .    .  .
.   .   .  .    . . .    ...      .        .  .  .   .    . .      .           .            . .
.               .  .            .           .   .        .     ..          .    .       ...   .
...............................................................................................
