................................
.        .    .  . ..  .       .
.     .. ..         .     .  . .
.      ...                   . .
.     ..   .  .              . .
.       .         .   .     .  .
..           . ..  X      .  . .
.  .      ..     ..    .. .. . .
.  .      . .  .     . .    . ..
. S           . .... .     .   .
.  .      .           .  .    ..
.      ...   .  .  .         . .
................................
