...............................................................................................
...                 .                ..X            ..      .                          .      .
.  ..     .            .  .              .   .           .    .            ..         .     . .
.   .. .       .   ..   .      S     .       . .  .  .      .   .              .  .    .      .
.       .    .      ..                    .     .    .     . .            .    ..  .        . .
.    .  .. . .                .                       .               . ..           ..       .
.                       .                    .        .   .   .                               .
. .         .    .     .            . .  .   .  .   . .   .              .                    .
. .      .                      ..        .  .          .    .            .    .  .  ..   .   .
.                        .             ..  .  .      .    . .        .                        .
..                           . .         .   .        .        .    .                        ..
.          .      ..          .    .       .                         ..                       .
. .  .             .  .        ..             .    .  .         .  .  .   .                 . .
...............................................................................................
