..............................................................................................................................
..      .    ..      . .            .  . .   .           .              .     .           .  .     .    .           .      . .
.              .     ..      . .      .  .  .                          .                    .       .            .          ..
. .    .  . .          .      .   ..                  .   .        . .        .  . .                      ..      .   .  .   .
.       .             .. .           ..         .        ..           .    . . .   .      .. ..   .       .    .     . .     .
.     .       .        .            ..                .      .         .                . ..               .         .    .  .
..            .     ...    .     .  ..              .  .  ..              . .                   .     .  .                 . .
. .  . .         .      .    .        .   .  .        .    . .    .                    ..                .            .   .  .
.     .       . .            .                       .       .    .           .         .  .       .           .    .        .
..  . .     ..          .         .     .      .      ..  .      .. X       .                 .          . .  .          .   .
.     .     ..             .     . ..                      ..       .                  .        .   ..               .       .
.   ..     .    .      .   .      ..      . .    .    .         ..           .            .      .     .   ..  .    . .    . .
.    .    .       .    .   .   .      .         . .  .       ..         .       .   .         .      .          .            .
.       .            ...      .      . . .  .    ..  .    .     .    .         .       .        .          . ..   ..        ..
.    .                      .  . .   .  .             .             .                                 .      . .      S  .   .
.       .    .     . . .              .                    .      . .  .       .           .           .  .   ..        .  . .
.  .  .                         ..     .  .    .              .     .                   ...  .   .        .         .       ..
.    . . . .          .      .       ..  .                            .  .  ...      .          .        . . .            .. .
.    .    ..        . ..              .      . .    .    ..         .   .           .  .     ..                   .          .
.  .   .           . .     ..     .      . .        .           .    . .  .   ..              .  . ..  .   .       . .       .
.         .    . .         .     .     .   . .            .         .   .      .           .         .                .. . . .
..............................................................................................................................
