......................................
. . .     .    .     ..  ..   .      .
..            ..   .   .     . .. . ..
. .  .  . .                  .   .. ..
. . .       .   .    .   ..      .   .
..        .   . . ....     .   . .X  .
.          . .   .    ..      .    . .
.  . ...    .       ..   ..   .    ...
.. .    .       ... . .      .   .   .
. .   .    . .  .  .. .    .  .. ..  .
.   .        . ..    ..           .  .
.               .     .   . .      ...
. ..  .                   .. ..  .  ..
.  . .       . .   ....  . .  .   .  .
.  .      .   ..     ..    .         .
.  .     .    .      . . .    .      .
.     ..   . .  .            .     ...
.  .   .          .    .             .
. ..  . .       .         .  .     ...
.    S    .   .    .            . ....
.          . .... .. . .    .     . ..
. . ..  .      .  .     .       . .  .
.  .... ...                   . .    .
.     .            .               ...
.     .   .                ..    . ...
. . .  .                ..       .   .
.    .   . . .    .  .   .  . .    . .
.      .   .            . .      .   .
.         .   .   .    .   .  ..   ...
......................................
