..........................................
... ...   ... .  .   .      .  .   .  .  .
...       .  ...  ..   .   ..    ..      .
.         .    .S    .   .       .  ..  ..
.         . .  .  .. .              .... .
.   .      .  .  .. ....      .     .    .
.    .       ....    . .   . .  .  . .   .
.      .      .    ..       .   .        .
..    .  ..     .   ....  . .  . .      ..
.    X  .    . .  .        .  ..  .      .
.        . .       . .  .   ..   .  .  . .
....  .             .                    .
.    .. .   .   .    ..   ..   ..  .   ...
.  . .       .       . . ....     . .  . .
.   .  . .. ..    .     .    . .   .     .
....  .  .   ..  . . .        .     .   ..
. .  . .  .                       .   .  .
.    . .  ...                .      .  . .
...  ..   .    .     . ..  .    .   .   ..
.            .  .    .  .       .  ..  . .
...  ...        .   ..    .     .. .  .. .
. .  ..     . .        .    . .     . .  .
.   .  . .    .           .     .   .  . .
.        .  ..    .       .  .   .     ...
.  .         .....     . ..   . .    ..  .
.   ..      .  .     .     .. .      .   .
. .                          .    . .    .
..........................................
