...............................................................................................................
.  . .. .                 . . ..               ..  .  .  .  . .      ....   .    . .   .   . .    . .    ... ..
.    . .   .  .  . .     .        . .    .           .     .  .       .    .       .    . .   ..  ..          .
.    . ...      . . .      .  . . .   .        . ...   . .           ..       . .              . .        .  ..
. ... .  . .            .  .    .     ...    ..  .   .    .   .       .       . . .     .  .  .  .       .  . .
.   .         .   .     . . .. .      . .   .     .. .  ...        ...   .   .      .    .   ..   ..     .  . .
.      .         .  ..   ..  . .       .          . ...         .        . .      .  . .               . .   ..
.    .     ..    .. .. .. .   .  .          ..   .            .        .    . .          ..     .        .    .
.....     ..   . ..  .        ...     .  .               .    .      ..  .         .. .  . ..   .   .         .
.      .       ...           .  . .. . . .    .. .    .    .      ..   .   .  . ..... .  .       .  . ..      .
..  .. .. ..     . . .      ..   . .          .  . .. ..     .  .. ..  ..    .  . .      .  .   .  .   .  .. ..
. .        ...  .     . ...            . .  . .   .   .  . .        .    .       .        .  .         .      .
.         ....            . .              .      ..     . .       S     .  .   .  . .   ..  ..               .
.          .      .            .  .  ...        .  . .  .                .    .       .   X...   . .   ..    ..
. ..         ....  .    . ...  .            ....         .        .         . ...        . .  .    .  .       .
...............................................................................................................
