...............................................................
. . ..  .                          . . .   ....    .     .    .
.     .  . .   .  .   . .    .    .. .. ..  .           . .   .
.    . .          .   .  .   .  . .  ...  .   .       .     . .
..    .   .   . .  .  .         .  . . .        .. ..       ...
...  ..     ...    . ..            .     .   ..   .  .    ..  .
...         . ..    .       . .   . .     ..  .  S    .       .
. .     . ..   .    .         . .     . .. .     .       ..   .
..        .  .  .     . .    .  ..   .   .  .     .     ...  ..
. ...    .  .  ... .  . .               .     .  . .    .    ..
.     ..         .  ..      ... . . .  .X            ..   ... .
.   .    .   .   .  . . . ..      .   .. . ..  ..    . .   .  .
...............................................................
