...................................................
.   . . .  .  .     ..   .  . . X  . . .     .   ..
...  ....     .    .     ..          .  . .   . . .
...    .    . .    .        .     .         .     .
.      .        .    ... .          .    . ..  .. .
.   .  .  .  S.      . ....   ..    .. .  ..     ..
. . .      .          . .   .     .   ..       .  .
.  .  ...  ..   .  ..  . .  ...     .   ...       .
.   .         .   .     ..  .  .        ..    .   .
.. ... .  .. . .       . ..  .  .  .  .  . ...  . .
.    . . .   ... .   ..      .  . .        . ... ..
.     .     . .  .    .     . ...      ..       ...
.  .      . .  . .        .      .    .           .
.     ..         . .    .   . ..  .  .   . .      .
...   .. .       .    . . .  ......     .   .     .
.   .. . .   ..  ..      .  ..     .   .      .  ..
...................................................
