............................................................................................................................................
.                                 . ..    .           ..         .     ..  .     .                   .    .   .              .     ..      .
.   .       .                    .     . .      ..      .  .          .    .               .. .    .    .     .    .      .         .  .  ..
.    .  .   .   .      .   . .    .         .           .                     .         .  .  ..      .           .    ..         .  .     .
.    .   .         .    . ..  .        .  .     .         .     .               .        .        .             .        .  .     .      . .
.     .      .                                        .     .          .              . .         ..                   .       .   . .     .
. .   .                  .               . . .   .       .  .         .   .    X          .             ... .          . .                 .
.   ..    .     .                                .         . ..      ..         .   .         .     .      .           .  .             .  .
.          .. . .       .                                        .                            .                     . .      .            ..
.                            .   .    .    . .   .    . .         .      .     .                       .          . .      .      ..       .
.         .                       ..  .   .. .    .                         .               .       .     .      .   . .      .  .         .
.               ..    .                              ..                     .     .  ..        .              .   .   .          .         .
.  .  .                            .                    . .         .          .       .       .        .         .      . .        .   .  .
.       .           S       . .  .  .              .   .       .        .   .  .. .         .    .     ..  .       .   ..   .    .         .
. .  .    .             .    ..  .         .                .   .                  . .       .  .  . .          .       .          .    .  .
.      . .    ..          .                            .             . .          .   .                        .  .   . ..          .    . .
. .   .   ..          .   .       . .      .                                  ..                   .  . .               . .        .   . ...
............................................................................................................................................
