.....................................................................................................................................
.    .    ..     . .    .          .             X.       .       ..  . . .          .     ..   .    ..  .  .  .  .  .  ..   .   .. .
.       . .           .  ... .   .    .        ..   . .  .      .     . . .    .  . .   . ....    .       ..    . .  . .. ... . ... .
.          .         .    .      . .. .. .    .       . .    .  .. ..  .  . .      .   .    . ... . .  .. .. .  ..   .   ..  . ..   .
..       ..   ... ...     .      .. .     .  . . .    . .          .   . ..    .        ..     ..  . .   .S      .  ..   .  .   .....
.     .   .  .. .      .          .  .  .  ...       ..  .  . .. ..       .          ...  . ..   .    ...    ..   ..     . .   .  . .
.  . .  .   . .. ...      ..       .   . .   .      ..              . .  .  . . .           ..     .    .   ...   .      .     .   ..
.        .         .  ..  . ..     ... ...             .       .    . .       . .   .  .. .          . . .   .  ..    .. ..    .   ..
.                .   .. .. ..  .  ...  .  ..  .      .      . .           . .    .     .   ..   ..    .  .       . . .  .   .       .
.    . . .  .   . . ...   .    . ..      .  ..     ...  ...           .  .. .. .     .. .          . .      .  ..  .  .. ... ..    ..
.... ....   . ....  .. ..... .      . ..  .    ...     ..  .. ..    .             .    .  . .. .  ..         . .  . ...    .        .
.  . ...     .      .      ... .       .  ...      .     .  ..       . ..      .             .      . .    . .    .   .  .  . .   ...
. ..        .  .  ....   .       . .. . . .      .  .    .. ..              .    .   ..  . .. .   .  .  . . .  ..     .  .  . .. .. .
.   .       ..   ..   ...    ...     .    ...             .   . .  . .   ..         . . ..    .        . .       .       ..  .    . .
.....................................................................................................................................
