............................................................................................................................
.      .                                                 .   .  .      .   .                .                        .     .
. .  .   .   . .       .  . .       .    . .   .            .   ..    ..        . .   .   .  .    ..  .    . .             .
..       .  .         .              .   .          .   .            . .               .  .     . .  .           . .   .   .
. ..    .           .    .         ..    .      . ...    . ..   .             ..             .                ..    .    . .
..   .        .  .             .     .        .  .              .  .               . .           .. .      .     .        ..
.  .   .  .     .    .    .       ...        .  .                      . .       S     . .     .             ..  .  .  .  ..
. ....      .  .    ..     . ..   .     .  .    ..         .     . ...  .     .          .      .      .           . .     .
. . .        .. .. .      .. ..           .      . .  ..            . ....    .                      .   .  .  ... .. .    .
.   .         .    .        .   .  . .  .    .... .              .    ..               . .       ..      . .        .  .   .
.       X..           .   .   ...     ..     . .    .. .           ..       .   .. ..               ..            .        .
..        . . .   .        . .    .   .  . ..     .  .     . .    ..          .. .  .   .   .  .      .  .     .   .       .
.. .  .   .     .  .   .        .          .      .          .        .  .   .   .   ...  .    .    .....        .  .. . ...
.     .. .     .   .  ...       .      .     .  .  . . .                             ..   .   .         .              . . .
............................................................................................................................
