.....................................................................................................................................................
.     .  .    .                   . .. .     . .      . . ..  .        .  . . .  .. . ..   .    .    .       . . .  ..     ...   .        ...       .
.      ..  . .  ..  ..    .     .    .    . ..  . ...    .   .    ..     . ..         .  .   ..       . .   . .                . .  .  .  . ..      .
.      . ... .             ..         . ..   .                      . .           .    . .  . .   . ..    .    .    .. ... .      .   .   .  .      .
. .   .   .     .         ..    .. .    . .  ... .   .  .  ..    ..  . .. .  . . . .  .     ...  .      .         .  .      . .     . .   .   .  . ..
.       .   . ..  .   .          .    ..  ...  .   . . . ..   . . .    .  .     .    .     .. .    ..  .       .       .   ..            ..  .    . .
.. . .    ...     .        .   ... .      .   .. .X     .      .   .   ..        .    ..   .  ..         ..  . .    . .   . .  .  .        .    .   .
...     .          ..   .     .  .    .    .          ..     .        ....  ...       .. .  .    .    .. . .. . ... . . .. ..   . ..        .  .  . .
.  .         . ..        . .     .  . .  .  ..  .          . . .        ..  . .        . .. .   .     .   ....    ..         . .  ..    .   ..      .
.  .    S . ..    . .    .         .  . .         .    . ..    .        .  ..  . .. . ..       . .. . .   . . .. .. .. . .. ..    .   .   ..    . ...
. .    . .        . .    ..   .  .   . .  . .  .  ..  .  .  ... .  ..   .  . .    . .        . . .    ..  .   .    .         . .. . ..     . ..     .
...  . .   .     .   .       . .     ...... .  .  .        .      . .  .     . .               . ...  ....      .    .     .  ...   ..  .. .   .. . .
.....................................................................................................................................................
