......................................................................
.   .                            ..    .      ..  ..               . .
.      ..       .                          .             .  .        .
.           .    ..  .               .          .            .      ..
.                           .   .              .                     .
.                    .              . ... .     .        ..          .
.     . .     .   .        .       .                        .        .
.   .                    .   .   .       .            .   .    .     .
.     .      .        .                                     .  .    ..
. . .     .      . .   .  .    ..   .       .   .        .           .
.  .         .  .            .                            .          .
.  .          ..     .                     .    .             .      .
.                          ...  ...      .   .    .      ..          .
.  ..        .    .      .          .         . .             .      .
.        .              .                     .       .              .
.     .     .           .                   .   .      .         .   .
.  .      .    . .      .             ..           .   S  .   .      .
. .   . .   .  .    .         .        .. .   .   .        .         .
.                          .                 ..     .  .       . ... .
. .           ..                         .  X       .         .   .  .
.          ....  .                 .       .     .            .      .
. .     .        .         .            .  .     .         .         .
.        .   .      .   .              .            .          .     .
......................................................................
