......................................
.                .          .        .
.    .     S                   .   . .
..  .         .  .     X       .     .
.   .          .    .                .
..                                   .
.  .      .       .            .  .. .
.  .       .      .                  .
.         .       .                  .
.     .                              .
.                     .  .  .        .
..  .     ..        . .              .
. .     .                            .
.      .     ..        ..  .   .     .
.              .            .       ..
......................................
