.................................................
.   ..         . .           .       ..         .
.             .     .   . .       .             .
. .      .   .    .    . .     .   . .          .
.    . .. .   ..         ...   .   .    . .  .  .
.                 .  ..     .   .       ..    . .
.   .      .    .  . .          .        .    . .
.   . .   .    .. ..         . .  .  .      .   .
... .     .. . .  ..    .       .  .  . .     . .
..  . .    .. .   .       .    .      . . ...   .
.    . .   ..    .   .                  .     . .
..      .                     .  . .       .    .
.   . .           ..   .   . ..    . . .     .  .
..     .         . . .    . .          .  .     .
.    .  . .    ..    .  .   ..     . . ..  .    .
.           .     .. .    .  .       .  .       .
.  .   .    .   .            . .   .  . . .     .
. X    .   .  ...                 .        .    .
.    .  ..  .       .  ...       .    .    .    .
.       ..         .        . . .      .  ..    .
.     S   .   . .    .       .   .  .  .      . .
.  ..              .     .   . .  .       .     .
.  . .   . .    .                    .    .     .
.       .        . ....           .       .     .
.    .     . . .             .  .     .    .   ..
.. .    .           ..    .  .  .     ...    .  .
.................................................
