...........................................................................
.    .  . .        .    .    .      . .  .                .   ..          .
.       . .      . ...    .    .      .         .  ..  .   .    . .       .
.   .                   .                    .               .    .      ..
..               .                                                  .  .  .
.           .                      .                             .    .  ..
. .         ...       ..                        ..        .   .  ..    .. .
.     .                   .  . .            . .    .        .             .
.    ..        .   .    .     .    .        .      .          .       . . .
.       .     .          .  . .   .       .   .           .    .  ...  .  .
. ..        .   .     .     . .       .   .  .      X        .        .   .
.     .. .          .  ..            .         .    .  .    .          .  .
..   ..              .  .. .    ..                     .    .             .
.     .               .                           . .                     .
.   .                         .  ...          .               ..        . .
..    .   ..                .     .        .        .        .     ..     .
.       ..           . .             .       .                  .         .
.          .             .    .     .    .          .       .             .
.     .  .           .    ..  .       . .             ..        .   ..   ..
.          .         .     .                      .   .      ...     .    .
.    .       .  .     .              .     .              .           .   .
.. .    .                  .  .                        .      .           .
....                 .         .  .       .         . ..          ..      .
..  .     .        .     .                                              . .
.           .             .         .  .           .       .   .         ..
.   .       .      . S   . .   .     .  .   .          . .   .            .
.                  .        . .      .                .   .    .    .     .
.                ..    . . .                     .    .. . .       .      .
...........................................................................
