....................................................................................................
..         .      .                  .    X .         .     .   ..       .  .        . .    . .    .
.   .                .     .      .       . .  .  .  .  .   .   . ... .   . .  .     .      .   .  .
. .       .        .                . .          ..    .   .      .        .    ...  .   . .     . .
.   ..     . .    . .        .   . .         .  .   .S    .  .  .  .       .  .    ...        .    .
.   .  .   ..      .                  .   .         .                   .  .      .    .     . .   .
.   .   .         .     .           ..        .       .     .     .   ..     .           ..     .  .
.                     .  .   .  .    .    .      ... .        ..        .         . .      . .     .
. .   .   .   .              .    .         .     . .      .   .. .            .       .           .
....................................................................................................
