...................................................................................
.    ..      ..         ..   X  .   .   ..    .. ..     ... .          .   .   .  .
.                    .      .            .      .  .          . ... ... ..  .  .. .
..  . . .  . .  . .   .    .              ...              .      .     .         .
..    .       ..S.         .    .       . .       .  .         .     ..  .    .   .
. .  . .         .        .           .    .       .       .  .     .          .. .
.            ..     .  .  .  .  .          .          .      . .   .  .   .. . . ..
.  .    ..      . .      .            .             .     ..       .       .    . .
......      .        ..     . .  .          .  .      . . ... .  .  . . ...   .   .
.            . .  .     .      .  .   ...    .   . .     .     .  ..  .     .     .
..    .      .  .     . .            .      .       .     .   . .. ..   .      .  .
. . ..      . . .   .    .       .      . .       . .   .  .  .    .        .. ....
.  .      .     .     .   .  .  .          .   ..   ...       .  .    .  .     .. .
..    ..     .   .  .     ..       . .  ..    ..    ..           . ..     .    .. .
.       ..   .  .   .   .   .  .       . .        .         .      . .   .      ...
.   ..  .        . ... .. ..   .          .. .   .  .      . .  .  . .  ..        .
. .    .   ..    .       .    . ... .   .    .               .      .    .    .   .
.    .         .    .. .             .    ..      .  .     .. .  .          . .   .
.   . . .   .   .    .         .                .   .         .      .     . .  . .
. .  .  . ..   .          .            .      ..   .         ... .     .          .
.   .   .     .               .  .    .           . .  .        ..   .    . . .   .
..  .       ..  .           .     .     . .. .    .       .    .   ..     .  .    .
.           .      .  .     .  .   .    . .   ..         .   .    .              ..
.                 .         .  ..      .. .      .             .  ..  .. .  .   . .
...................................................................................
