.............................................................
.            .   .    .   ..  .        ...           ..   . .
..  ..         .       .  .   .   .  .  . .       .  .  .  ..
. .. ..    .   .   ... .  .        .  .         .    .  .   .
. .    . .. .             .   .  .            . ..   . .    .
.         .   . .   . .    .  . .    . .     . .          ...
.   . .      .         ...   ..  .         .  . . ..   .   ..
.     .           . ... .       . .   .  . .    ..  ..      .
.          .   . .            ... ...  .   .    ..  .    .. .
..    .     ...      .      ..S  .  .  .           .   .    .
.  .                ....  .      .. . . ..     ..  .  .     .
.     .  .     ... . .                   .  .   .. ..    . ..
..      .     .      . .         .. . .       .           . .
. .  . .. ..      ....       . .   .. .  .      .         . .
.    .. . ..       .. . .            ..  .... .    ..  ...  .
.   .  .   .  .. . .                  ..  .    .  .  ..     .
.  .       ..  . .        .   .    ....   .                 .
. ..     ..   .    .   .         .    .             ..    X .
.    .. .  .         ..    ..       ...       . .   ...    ..
. .   . .    ..   . .  ..      .    .  .  .   .. .  .       .
.      .  .   .      .            . .      .  .    . .. .   .
. .   .     .            . . ..     .     . . .  . .    .  ..
.        . .         ..  ..   .. ..           .    .     .  .
.............................................................
