............................................
.                    .   .                 .
.     .     .       . .                 .  .
.               .  .                   S   .
.            .    .            .           .
..              ..        . .              .
.     .     .       .       . .            .
.  .                  .               .    .
.               .          . .    .     .  .
. .                    . .  .       .      .
.. .                  ..  .     ..  .      .
.                   .  .       .  . .     ..
.       .    .        .            ..      .
.      .     .   .          . .  .         .
.      ..                                  .
. X             .          .       ..      .
.   .    .                    .  ..       ..
.              . .. .                 .    .
.   .    .       .       .             .  ..
.           ..      .             . .   .  .
.                                          .
. .  ....  .    .                     . .  .
............................................
