................................
. .  ..  .  . .   . .     ..   .
.  . . .     ....  ...         .
. ..     .. . .     ..X   ..   .
. .     .     .     .       .  .
.       .     .            .  ..
.  ..                          .
..    .    ...    ...     .    .
..       ..      .  .. ..      .
.           .  .               .
.          . .S     .     ..   .
.  ..         .                .
.  .         ..   .   .. ..    .
................................
