.................................................................................................................
.    . .  . .  .  .            .   .. . .  .  .   ..  ..   ..  .     ..  . .   . .  . . . . ..   ..             .
.  .            .  .   . .     . .  . ...     .. .  ..     .    ..  ..         .  .  .    .    .     ..      .  .
.  .       ..    .   ..   ..      .       .. .  .          ..        ...   . .        .   ...     .    .   .    .
.  .               .   ..  .  ..  .       . .       ... .  .   .      ..               .. . ..     ..   ....    .
. ..  ..      .      .  . .  ....    .   . ..       .         . ..    .   ..                  .   .         .  ..
. .      .     .   .      . .      .         .    ..    .    .           .      ....         . .    .  . .  .  ..
.  .... .   . . .    .  .    ...  . .             . .. .    .. . .   .   .       .    . .  .. .  .       .      .
..X.        . . . .   .   ... .  .         .     .        .       . .     .            ...  ..    ...   .  ..  ..
..   S...    ..  .. . .    ..   .    .     .... .  .       .        .   .   .  .    .        .. ... .  .   ...  .
. .   ... . . .       . . .    ..      .  .. . ..     .    .          .    .       .        .          .   .. . .
. ..  .          .   . .. ..  .. ...                    . .               ..   . . .    .. .     . ..   . .   ...
. . .   . .  .     .... . .  .      ..   ..                . .  .. .  .           .     . .. .. .        .     ..
.  .   .     .    . .        ...  . ..  . .  ..... .  .          .  .              . . . .. .  . . .   .  ...   .
...   .        .. .  .  .  .         . .  .    . ..         ..  ....   ..     .     .. .   ...  .   .      .  ...
.  .      .  . .  .  .   ..     .  . ...      ..   .  . .  .  ..   ..  . .       .. .  . .   .       .    .. .  .
.. .. . .      ..   .     .  . .         .. ..      .   .   . .    .   ..  ..   .  .      . .     .  .     ..  ..
...       .. .         .   .      ...     . ..  . .     .  . ..    .     ..  .   . .          .  .  .      .    .
.     .    .  . . ...      .  ..   .    ..  . ..  .  .         ..        .  ..  .  ..  .. .  .        ..        .
...     .. . .  .  .  . . .   .  .   .  .          ...  .             .. .         .  ....      .     . .  . .. .
.  ...   .      .  . .     .      . .    .   .  .    .   .  . . .           .    .        .    . . . . ..  ... ..
.................................................................................................................
