......................................................................................
.           . .                            .            ..   .     . .         ..    .
.  .  .     .      .    . .      .       .  .    .          .    . .   .       .  .  .
.  .  .  ..           .    .    .      .  .    .  . . . . ....   .     .          .  .
. . .          .     ..     . .        . .          ..    . .                  .  .  .
.       ..   .  . . . .    . ..    .     .                     .              . . . ..
. .    . .         .           .          .   .       .   .  .   .            .     ..
.   .        .          .        . ..     .    . .   .          .    .. .            .
. .      .       .   .          . S       . .    . .  .    .    .          .        ..
. ..  .      .     ....  .           .  . .  . .  .  ..           .  .  . .          .
.              .  .     .    .    .           .  . .  X        . .             ..    .
.. .    . .         .     ..      . .    . .     .  .    . ...     .    . . . .  .   .
.     .              .  .    ..  .  . ..                  .    . .           .      ..
......................................................................................
