.................................
.       ... .      .. .         .
.            .   ..          .. .
.  .   . .  .     . .       .   .
.      .              .   .  .  .
..         .    ..       .      .
.       . .  . ...      ..   .  .
. ..X       .   .         .  .  .
..       .    .            ..   .
. . .            .     .  .     .
...  ..          ...          . .
.      ..        .              .
. .                     . .     .
. .      .  .        . .     .  .
.     .   .    ..          .    .
..    .    .        . .    ...  .
.     .     .   .  .            .
.  .  ..           .  .  ..  .. .
.         .      . . ..         .
.  . .   .           .  ..   .  .
... .  .          ..         .  .
.    ..  .      .         .     .
.     .  .       S  .          ..
.    .   . .     .   .   . .    .
.  .      .     .   .    . . . ..
.     .. .       .       .      .
.   .    .   ...       . .    ...
.  .     . .        ..  .       .
.................................
