..........................................................................................
. .     .. .             .      .  ...        S      .  .  .     ... .          .      ...
.    ..          ..               .     .   . .      . .   . .  ...  ..    .      .  ... .
.  ..       .  .    ....       ..  . .  . . . .            .  .    .   .. .       . .    .
. .. . . .    .  . . .      .  .         .  .     .    . ..       .       .          ... .
...  .     .           .      .      .        ..       .  .      .            .      ..  .
.  .                        .      .    .. . .   .   .   .  .          .         .       .
.          . .  ..    .       . .   ..     .       .        .     .    .  .. . .     ..  .
. . . .         ..   .      .  .    ... .   X .         .     .    . .       .  .        .
.     .     .  ..  .    .    .  ..  .         ... .. .  .           .    .     .  ..    ..
.   .     .                  ..    .. .     ... .        .     .  .     .    . .     . . .
..........................................................................................
