.....................................................................................................................
.      ...       . .    .     . .    .           .             ...           ..     ...     .    ..       .  ..     .
. ..  .  .        .   .       . .  . . ..         .                      ..        .      .          ..             .
....       . .              .   .       . .               .    .. . ..       . .   .          ..        .           .
. .  .   .    .      .. .           ..   . ...   .   ..        ..       .  .  .     . .        .      .    .  .    ..
.  .           . .  .  . .         ..       . .    .               .  .        . ..    .  ..   . .        .  .. .   .
..             .       .      .  .         .            .        .   .. .     ..      .     .              ..    . ..
.    ....        .             .    .   ..     .           ..   .    .  S       ...       .   ....  .    .   .     ..
.           .  . ..                    .        .. .   .      ..        ..         .  .  . ..   .        ..         .
..   .  .       . .  .  .                     .   .       .    .  X  .   ..       .  .    ..             . .    .   .
.    .  . ..      .. .    .         .          .   .   . .  .      .   .     .     .  ..   .   .    .. . .    . . ...
.      .             .       ..       .    . .       .  .         ..     ...    . .   .         . ..             .  .
. .    ..       .   .       ....             .. . .     .     .. . .      .  .. . ..   .  .   .   . .  .            .
.....................................................................................................................
