..................................................................
.. .. . ..       .  ..   . .      .   .   .  ..    .   .      .  .
.  .     ...  .       .  . .     .. .   ..  .          .   .  .. .
...    . .  .. .    . .    .      . .....   ..     .     .  .  . .
.  .. ..  .. X  .       .   ...     . ..  . . .        .     ... .
.. .    .        .                     .  ..  ..          ..  .. .
.   ..  .      .   . ..                  . . ..  ..   ..    ..   .
. .  . ..  .. .. .  . . .      .    .     .            .        ..
. .  ....  .  .     . . .   .   .  .       .      ..   ..  ..  . .
..  .      .      .  .  .   ..        .   ..  . .       .  ..  . .
.          . . .. .  . . .   ..     . . ..            .         ..
.       .     .   .  .. ...   . . .   .. .   . .     .  .. ..    .
...   .    .      .     ...    .      S...          . .    . .   .
. .    . . .. ..   .          . .   .       .     .  .       .   .
.   ..   ... .   .     .  ..  .     .          .  . .   .    . ...
.   .. ..  . ...  .  . .     .  . .     .    .       .           .
.    ..        .   .     . .   .. .     .    ..         .  ...   .
..   .   .     .     .  ... .. .   .    . .  .  .  .   .   .     .
.       ...        .  .  ...     ..     .     . .    ..    .     .
.  .  ..  .      ....  .  .  ..    .     . ...   .      ..  ..   .
.  ...      .       ..    .   .    ... ..    . ...  . .         ..
..    .  .. .  ...  .   ..     .       ..       ... .   ...   .  .
. .. ..  . .     .    .   .  .. .  .            . ..  .   ..  .  .
.     .  . .. .   .  .. . .     .     .       ..        . .. .   .
.  .         .  .              ..     . .    . . .    .     . .  .
. .    .   . .  ..  ..          . .. . .      .  .  .    .    .  .
..................................................................
