..................................................................................................................................
.       .        . .  .      .  ... ...   .   ..       .       .   . . .      .  .     . . .     ....                ..  .   ..  .
.  ...  .  .  ...    ..       .    .   . . .          . ..      . .    .            .  ..  ...    ..   ...   ...     .    .    ...
..   .   . .     ... ..   .     ..   ...  . .  ..    . . .         .      ..  .   .       ..      ...     . .  .    . ..   .     .
... .        .   ..         ..  . .       ...    .   . . .  . .  .  ..    .  .    ..                   ..  . . .     ..  . .     .
..  .      . ...     .   .    .  .         ..  .  .     .    . ..   .     .    .   . .   .            .    .     . . .   . ...   .
.  .    .  ..  .       .     .     .            .        .        ..    .  .   .   .    .   ...   .           .        . .  .  . .
..         .   .  .      .           ..   .    .  . . . ..     .   .   ..  .          .  . .     ... .  .         .  ......  . . .
. ..    .     .. ...         . . ...  . ....   .        .. .   .  .    . ..    .   . .             .     ..       .   .    .     .
.  ...    .          .    .   .. .    .   . .  ...    .     .     .  .      ..    .  .   ...       .   .       . .. .. ...  .. ...
.   .      .     ...    .   .   .  .. ... .   .  . .  ..   ..  .    ...   .. .      .           .     .  ..   ..  .       ..   . .
.     .....        ..  ...         .     . .  .       . ... .. .      ... .      ..           .      .    ..      .   .   ...    .
.  .      .    ... .  . .     .     .. .   ...    .       . .           ..     ...     ..  . ... .  .       ... .    .     . .   .
. . . .  .  .        .     S   .     . .     . .      .. ... .. . X   . .    .     . ..  .  . ...               . .. .        .  .
.        ...  .        .. .. . .  ...     ..               .   .     .   .      ..          .      ..    .  .     ..  .  .   .   .
.    .        .        ..   .       . ..   .    .     .   ...   .  .    .       .. ..       .  ....                      . .     .
. .   ..     .. .        .       ...   ... . .       ... .          .    . .  .            .   ..     .     . .  . .  .. . .     .
. ..     . .   .     . .             .    .   . .     ....     .   . .  . . .       .    ..         ..      .  ... .     ..      .
..................................................................................................................................
