.................................................................................................................................
. . .         . .  ..  .  ..           . . ..    .     .       .. ...   ..  ...  . . .   . .      ...    ..       . .      .   ..
.  .. ..  ..    ..  ..   .  . ...  .  . .   ..   .  .   .   ..  . ..  ...  .       ..    ..    .  .. . ..            .     ..  ..
.     .    .. .. . .    .  .        . ..   . . .          . ..  .    .    .      .       ...              .   .        .  ... . .
.. .. ... .. .. . . .     .             .   . .            .    .. .     .     ...   .     .             .  .  . .   .    .    ..
.            .  ..   ..            ..  .     ..      .. .. .  .  .. . ..     .     .. .  . .  .       .. .    ... .    ..      ..
..         .   . .   . .  ..   ..    ..    .     .      .     .. ..             .           .  ..  .  .  ....           ..    ...
.  .  X           . . .  . . .       . . .. . ..  . .. .  .    .   .    . . .  . .    .    .. ..   .   .       .   . .   ..   . .
..        . .  .. ...  .        ...     .    .  . . .     .      .      ..    .   ..... .  .    . .   ..  . . ..                .
.                       .    ...  .   .   ..  . .   . .     .  .           .   . .      .  .        .    . . .  .    .   .     ..
.        .      .   . ..  . ..   ....    .  ...                 .  .    . ...       .    .    .    .   . ..  .  ... .  .     .  .
.     .   ..   .    .         . .         . ... ...  .    .         ... .. ..  . .        .    . ..          . ..  .       .    .
.           . .     . .  ..   . .         ..           .       . .   . . ..  ...   ..  .. .      .  ..   .   . .            . . .
. ...   .   . . .   .     .   . . . ..       .   ...   .... ..  .    .. .       .  .           .  .  .  .. ..  ..     .       . .
. .   .. .. .       .  . .  ..        ..   ..  .   .. . . . .   . .      .         .. . .       . .         .. . .  .. . .     ..
.   .  .  .   . .  .    ...    .    .    .     .   .    .      ..      . .   . .  .. .    .    .   . . .           .   ..   .. ..
..   .  .....          .   .      .  .  . .    . .  ..   .  . . .  .         .  .  . .      .  .     .... .     . . . ....    . .
.      .    . .   . .S   .      .     . .       . .    . ..  .. .  . .     .     .    .       .     ..   . . ..       .       . .
...  .  .. ... . .. .      . ....    .    . ..        ..     ..     .  .     .  ..     . .     . . .      .         . . .  .  . .
.       .  .  . ... ..    ...         ..     .   ..   .  .     .  .      . .  ...          ...  .   .   ..      .   .. .. .     .
..   .   .   .   . . .     .  .   .   ..     .  .  ....  .   . .       .      .    . .  .  .  .          .       .    ... ....  .
. ....          .  ..         . ..     .              .  ..  .   . . . .  . .  . .   ... .    .     ..  .   ...      . .   .    .
. . .     . .       .   .  .  .       .. .. ..  .  ...  .. ..         .   ..       .  .      . .      .    ...  .      .   ..   .
.    .       .   .  ...    .   . .. .   . ..   ..         ..    ..    .     ..     .    .. .        .  . .    .   .   . . . .   .
..    ..  . ..   . .   . .       ..   .      .    .   .       .  .   ...       .            .      . .      .  .     .    ..  ...
. .  .   .. . .   .      .   .. ..   ..    .  .     .        ..    . .     .. .. ..    .. .                   .  . .       .    .
.................................................................................................................................
