......................................................................................................................................................
.    .  .. .    ..    .      .  .         . .. . ...  . .   .  .  .     ..   .        .          .. .     .. . .      ..   .. .      .       .   .   .
. . . . .   ..        . .. .     .. ..        .        .   .  .. ..   . .   ..     . .     . ..  ..          ..     .  . ..       .       . .    .  ..
.      .. .     .     . .         . .   ... .    . ..  . .... .        .  .  ..    .  .... .. .     ....  .   .   .     .  .  ..      .    ..     .  .
.       .. ...    .. . .   ..    .      ....  ..   .  .  . ..   ..    .     ..  ..   .. .                 . .   .  ...  ...  .     .. . .  ..  ..  . .
...     . .  ... .  . ..    . . . .   . .           .     .      .. . .  ..   . .  ..      .  .  .       . .  .  .  .  .  . ..   .  .         ...  ...
. .. ... ... .  . .  ...  . . . .   . .  .          X..    .  . . . . . ..    . .    . .     .  .  ..  .       .. ..  .    .  .       .   .        ...
.     .   .  . . .  . .   ..      .         ... ..  ...  . .   .   .       . .           .   . . .  .  . .      .    .  ..   ..... ..       .  . ... .
.  .            .  ..      . .. . . .  .. .  .   .       . .   . . . .     .  .   . . .. ..  . ....        .. . .   .. . ...  .  .    . .    .  .    .
. . .. .    ..   . .  .  . .   . .. ..   . .. .. .   .         . .  .  . .  . .....  .   .  .... .      .         .  . . .  ..         .  .     . .  .
.  . ..... ..    .. ..   ...    .     . .     . .       ... .   .  . .. .   . ..    .  .    .   ..     .            . ..  .    .    .  .         .   .
.. .      .       .    . .   ..    .    .    ..   .     .       .. . .  .      .     .  . .. ..  .     . .. .   . ..     .  ... .          .. .   .  .
. . ..   .  .   .      ..   . .. ...     .  .  .. . . .   . .   . .  ..  .    .   .     . ..             . ...    . ...    .  .       ..... .     .. .
.    .   .. ..  .  . .   .  ..  ..    ...  .. ..  .  .   ..   ... .      .    .        .      .. ...  .     .     ... ..     .  .     . . . .        .
. .       .  .       .         . .           ..  ...        .        .  .   ...  ...  ..  .  . .           .       .  . . .    .            .   .    .
.    .   ..        .   .     .   ..       . .   .     .         .  .        . .  .  .    .   .   .  .  .       ..  .    .     .   .   .    .  .   . ..
.    .    ..    . . .  .   .        . . .       . .    .. .    . .  ..  ..   . . . ..   .  ..              . .     .  .              .  .    .    . ..
.   .            .   . .  .    ..     ..   . ..    .. ..      .  ..        .  .. ..       . .   .      .  ..  . ..    .  .  .      .       . .. .    .
.         ... .   .              .     .   .         ... .      . .     .      .  . ..  .    ...  . .  .    ..    .      .  .   .     .  ..    ...   .
..      .   .      . .      .    .  .         ...   ..         . .  .  .  .  . .        ..      .  .  . .   .. .  .      .  ...             .  .   ...
. .  .  . ..     . .       .  .  .     .  ..   . .  .  .. .  .  ... .      .    .    ...  .  ... .. .        .    ..   .   .   ..    .            . ..
.         .  .S  ... ...  ..       .   . .     ..          .    . .    .     .. . ...       .   .. .. ... . .   .                ..   .        . ... .
. .  ..   .  .       .   . ....          ... .. ....  .   .  ...  ..    ..      . ..   .. .       .          ...         .. . .  .      .. .. .   .  .
. .           ..   .  .  .       .         .  .    ..   .           . .         .    ...   . ...  ..       .. .  .   .. ..   .   .       . ....      .
.. .     .. . ..           .   . .  . ..     .  . . .    ..  . ..       .. . . . . ..      . . ..       . ....     ...   ..   . ..    .   .        . .
.    ... ... .   .   .    .   .  ..     . ..   . .     . . .     .                . .. ..  ...     ...     ..           .. . .      .         .   .. .
...  . .. .  .. .. .   .    ..  .    .    ..            .            .       .   .   .         ..     .  . .  .    . .   .        . . .   .     .   ..
......................................................................................................................................................
