..............................................................................
.    . .X   ..     .        .            . .                      .        . .
.  .   .      .             ..   .    .  .     .   . ..   .   .              .
. . .  .         .     ..       ..      ..       ..                        . .
.  .  .          .                   .        .  .  .  .      .  .     .  .  .
.      .            .  .  .                     .  .   .        . .      .   .
.                . .         .                                               .
.   .          .          .    .    .  .    .    .         .        .        .
.     .    .                        .         .         .            .       .
.                    . . .    .  ..         .                      .        ..
.   . .    . .              .      ...       . . . .                  S      .
.     .      .            .                   .          .   .         .   ...
.   .   ..        . ..  . .   . .         .   ..    ..       .               .
.                   .   .      .      ..    .      . .  .  .. .      .       .
..............................................................................
