........................................................
.      . .     .              .        .  .        .. ..
.      ..   ..  .. S .         .      .                .
.   .     . .     .                           .  . .   .
.  ..             . .    .   ..       .      .   .   . .
. .   . .             X .    . .        ..       .  .  .
.        .               .          .  .           .  ..
. .     .                     .     . . .      .       .
...      .  .   .  .. .          . .     .         .   .
. .  . .  . .       . .      . . ... . .            .  .
........................................................
