...............................................................
.    . .  .     ..             ..  .   S..      . .  .     .. .
.    . ..     .      .     .  .      . ..        . ..  .   . ..
..   .    .             .   .       ... ..    .  .   .  . .   .
. .   . .....  ...   . . .      .   ..     ...   .  . . .  .  .
. .        .             ..          .   .    .   ..   .      .
...  . . ..    .   . .   .  . .          ..  .  ...         . .
.           . ..           .   .    .  ..  . . .   .        ...
.. .       . .          . .           .   .      .  . .      ..
.      .             .        .   .        .                  .
..    . ...   ..       .    X       .. .           . .   .    .
.    . .  .. .   .            .  .      .  .           ... .  .
...  .   .       . . . .     .  . .      .       .   .        .
.   .      .  .  .  . . .          .   . .      . ..        . .
..  .   .          . ..     .      .  .     .            . .  .
.    ..   .    .  .  ... .   .      .  ..     ..   .    .     .
.  .  .                 .    ...   .    . ...    .   ..       .
..   .      . .                   .  . . . .         ..       .
.      .    .  ..           .    . .  ..            .       . .
...............................................................
