.......................................................................................................................
.  .  ..      . .       .    .   .  .    ..   ....   .  . .  .   .  ..  .   .   .         .     .    ...  . . .. ...  .
.    .    .    .. . .        ..      ..    . . .  .   .   ...  . .    .   .   .. .       .. .  . .  .  . . .   .      .
.        .  . .    .  .  . ..  .   X    ..   .  .     .    .        .  .... .  .  .   ..  .      ..  .    .       ..  .
.  .   .     .  .   ..         .    ..  .   .  ... .    .     .  ..   . .  .    .  .       ...   . .  .  . .  . .     .
. . . .  ...  .    .   ..    .               . ..   .. ..  .. .     .  .   . . .   .       . .             .      .   .
.    . .   .  ..      .    ..   .       .      .  . . .. .     .      .        ..      .    .. ....        ..  .. ..  .
...          . . .  .   .     . . .  .              ..  ...      .   ..        ... .      ..      .    .  .    .     ..
.  .  . ...      ..           . .      .     .   ..   .  ..   . .  .  .  ...      ...   ... .      . .   ..   . .    ..
.  . .  . .      .      .           .  ..    ..  .. . . ... .      .    ...    .     .  . .   . .       ..   . . .   ..
.      S  .    . ..   .  .  . .      .  .  .  .  .           .      .  .  .    .       .     .        .   .        .  .
. .     .... .   .  .    .  ..     ..  .     .  .                .    .      . .     .      .   .      . .  .   .     .
....    . .    . ..   .     .            .. ..   .   .       .   .     .    . ...   ...  .  .      .   .    .       . .
..  . ..    ..   .. .  .         .   .  . ..  .  .  . . ..    . .    .        .. .        .      .  .      .   .   .  .
. . .      . ....  .          .....        .. ...  .   .        .  .           ...   .  .    .   ..     .   ..     . ..
..      .         ...     .     .. .  .   .  . .  .      ..   .      ..   ..    .   .      . .   . .      ..   . .    .
.      .      .       .   .  .  .       .....  .   .  .    .    ..   ..  .              .    . .  .. . ..   .         .
. . . . .  . ...     . .  . . .     ..        .   ..          .                   .                     ..  ..        .
.. .  .    .  .   .       .      . .   .         .          .    .   .       . ..    . . . .        .    . . .  .. .  .
..     ..   .  .    ..  . . .   .    . ... .. . ..         .. ...  .    ..    .   .        ...    .      .    ...     .
.      .  .  . . .   ..  ..    ...    .       ..  . . .  ..       ..   ..      . .     .     .. .. . .    .  .        .
..               . ..             .  . .. .. .           .      .    ...     .          .   .       ..       .        .
.   ... .      . . .    . .        .   .   ..  .     . . .  .        .    .  .    .      . .                  .      ..
.          ..  .    .       .       .   .  .        .     ..  ..           . . . . .. .  . ..... . .  . . . .   .   . .
.......................................................................................................................
