...............................................................................................................................................
... . . . .     .         .   .  .   .     ... . . . . .                  . .  .   . . .   ..  .. .   .   ....     .         .             .  .
. . .. ..        ..     .    .  .         .  .         ..   ...  .   .     .  .  ..  .        .. . .   .  .    .  .  ..                  ...  .
. ..     ..   .       . .. .    .     .. . . .  . .           . .. ...    .       .. .            .  .  .. ..  .  . . ..  .      . .. .  ... ..
.  .      .  .    .    .  .       . . ..  .    .   .. .     .  .. .   . ... .  .   . ..  .          . .. .   .  .. .            ... . ....   ..
. .  .. . .        ..   .  .    .     .....  .  .. .  ...       .          .  . .... .       . . .   .  .  ..    .   ..  . ..   . .     ..    .
.    . ..  . .. ...  .     ... .  .          .  ..              .  .. .  .   . .         .  .   .     . . . .  ... . ......     .           ...
..          ..    ..  .   . . . .       .  . . .... ..    . .. .    ...     .  . . ..  .  ..    ..         .. ..     .    .     . . .  . . .. .
.  .  ..     . . .       . .       .       .      .  .      ..          .            .   .. .  .  . .   ..   ..         .     ..     ..  .   ..
. ..   .    .     . .  .     ...           .. . .     . . .     .   . ....     . .         .    .   ..  .       .   .   .  .. . .  .  .    .  .
.               . ..    ...      .   ..    .  .  .  .     .   ... .      .  . .. .  .  ..         . . .  . ..  ..   .. . ...   .         . . ..
.   . . . . ..      . .  ... .   .    . .              ... .. ..         .        .        ..      . .. .          .. . . .         X.       ..
.    .      .    . ...     . .       ...  ..     .. ..    .   . .  .     .      .  ..  ... .   .    ..    ...   .    .. .    .  .        .. . .
..    . ..  .. . ..  ..      ..     .             .           ...       ...  .  .  .  .      .   ..  ...   .  ..   .    .   . .      ..  .  . .
.. .        ... .  . ..     .     .  .                    .S  ..  ..     . .   .      .     ..      . . . . ....   ..   .   ..   .    . ... . .
.   . . ..   .   .  .          .    .  ....   . .   . .      . .        .. .     .  .  .     ..  .   .        ....    .  .    . . . ..  .     .
. ...   .  .   .  .             .. .. . .    .  .        .       .      .   .. . ...  .   .   .     .      ...    ...   .  .       . .. ...  ..
. .     .  .        .  .    .  .   . . .    .      ..  ....  ..   .  .  . .      .. ..  ..   .  .. .      .. .. . .     .    ....... .  ....  .
.  .     . .     .   .  ..  .   ...     .   .. .  .        .  .   .   .   .  .  ..    .  .       .     . .. ..       .  .    .  ..   . . ..   .
.. .  .    .          ....   .. . .   ..         .   ...   .    . ..  ...     .           . . ...      ...    ... .  .  . . .                 .
. .   .   .     .      . .  .  . ...  . ..  ..  ..     . . .              .   . .  .  ..  ...        .  . ..       .      ..         .   .  . .
. .. .   .   .  ... .         .        .   ..   ..   .      ..  .. .        .  ... .  .              ..    .  .     .  .     .   .  ..  ... . .
...............................................................................................................................................
