...................................................................................................................
..          .    . .                .        .  .       .    .               .      .  .   .   .      .     ..    .
.       . ..                ..       ..            .           .         . .    ..          .          .        . .
..  . .           . .   .               .    .       ..    .                  .                  . .        . .  ..
.  .          . . . .     .       . .    .  .                     . .          .  .. . .  ..    .         . ..    .
..   . . .      .            .      .   ..  .  .     .         .             .     .                 .    .       .
.         .          .         ..   .     .   .      .           .         ..    .    .                         ...
.  .. .             .          .      .      .              .       .     .        ..           ..             .  .
.              .              .               .. .     .     ..    .  .            . . .     ..        .          .
.           .           .   ...   ..       .     .     .  ..                    .             .                 . .
.  .       .       .   .                           ..      .        .     .          .             .              .
.   . . .                    ..  .  ...   .         .             .  .     ..   . ..  .             .             .
.          ..    .       .     .                .         . . .  X . .                             . .            .
.  ..    ..       ...        ..       .          .  . .                      .            .  .                .   .
.      .        .                 .     .      .              . .    .         .  .               .     S      .  .
.  .       ..          .    .        .   ..    .         .         ..                  .   .         .    . .     .
.   .     .   .     .       .            . .    .         .            .    .                          .  .    .  .
. .          .   .   .       .       .           .                 .     .. .         .. ..     ..         .  . . .
.  .            .                     .       .   .   .         ..   .       .      .          ..  .    .  . .    .
.   . . .    .       . .   .    . .    .     .      .     .  .    .           .      ...                          .
.   .  .           .    ..              .      ..   .   .     .   .     .  .  .      ..      . .   .       .  .   .
.   ...                                  .                ..   .    ...  .      .       . .  .   .  ..         .  .
...................................................................................................................
