............................................................................................................
.  .   .   .    . . .        .      .              X  ..               .         .      ..     .           .
.                               .     .   . .   .                .     ..               ..      .        . .
.                .             .                .      .         .          .    .            .            .
.  ..                      ..          .      .       .     .                                    .  .      .
.       ..              .          .   .                 .   .        .      . .   .        .         .    .
.      .    ..          .   ..                       .      .       .                    .   .       .    ..
.          .    .    .   .                 .                                     .           .             .
.    .                .           .       .                     .            .           . .       .     . .
..       .  .  .   .               .                                                                .      .
.  ...            .   .     .                 .               .  ..         .                .  . . .      .
...          .     .                 .     .    .   .           . .     . . .                .     .       .
.    .  .    .    .   . .           .     ..      .  .                                 .  . S      .       .
.           .                         ..                    .    .         .                             . .
.                                                       .  .        .      .  .                  .         .
.             . . .                   .                .                                    .      .   .   .
.          .              .                      .             ..      .        .          .              ..
.     .               .    .  .        ..        .           . .. .            .                           .
.  ..            .   .  . .  .   .                                                               .   .  .  .
............................................................................................................
