.....................................................................................................
. .     .     .        ..  .    .         .. .    .            ..   . .        .        .   .       .
.  ..  .           .              .   . .  .        ...       .                             .  .    .
.     ..           . .     . .            .  . . ..                .. .             .               .
.             .    .               .    .  . . .  .     .     .   .                .         .      .
.. .       . .       .     ..     . .            . .                  ..   .        .            .  .
.. .    .   .   .    .  .. . .      .   .     .           . .                   .. .      .   .   . .
. .  ...      .. .       .                     ..   .  .  . .        .   .   .                   .  .
.         ..  .  .           .        .   .         .  X .               .       .  .        ..   . .
.       .    .    .            .  .   .    ..    .        .           .          .   .  .        . ..
. ..  . . .     .. .           .  .   .. ..   .        .   ..  .  .             ..            .  .. .
.       . ..    .   .       .    .     .   ..        .             .    ..  .        . .            .
.     ..                        .     ..   .                     .      ...  .   . .       .     . ..
.  .   .   .         .          ...   .  . .  .       .      .    ..   .     .      .      . .  . ...
.     .    .    .            ..   ..   . ..        .               .             .     .            .
.            ..    .  ..    ..     ..   ..        .  ..    .   S     . .     ..        ..    .      .
.   .   .   .       .   .   .               .         .    .           .               . .. .       .
.....................................................................................................
