......................................
.  . ..  .  ...  .    ..       ...   .
.  .       ... . .      . . ...      .
. .   .. . .     .  .     .  .       .
. . .... S      .        . ..        .
.. .        ....            . .     ..
..       .    . .        . .  .  .   .
.  . .        ....    X         .    .
.  .           .   . ..  .        .  .
..      ..        ..       .    .    .
. .      ..   . ..   ..  .  .  . ... .
.     . .     .. .  . .  . .. .      .
..  .          .   .    ..  .        .
.        .   . . ..    .  .     ..  ..
.  .           .    ...  .       . ...
.    . .      .. .    .   . .  . .   .
..         .        . .. ..      . . .
....      .   . .  .   .  .          .
. .          ..   .  .... .    .     .
... .      .  .    .  .       .    . .
.. .  .  .    .            ..  ..   ..
.   . . .   . .    .  .   . . .... . .
......................................
