..................................................................
.   ...  . ..    .. .  .   . .       ...  . .   . . .     .. ... .
. . ..        .     ..     .   . .           .   . .. . .     .  .
..          .       .   .  . ..                 ..     .. .      .
.. . ..     .  .  . ..   .  .   .    .     .  ..    .       .. ...
. .  . ..  .  .. ..  .               . .           .  .  X       .
..  . .  .       ..   .   .            .          .       .     ..
. . .       ..                 .  ...     .    . .       .  .   ..
.      .  ..   . .    .   .    .      .. .     .  .    S   . .   .
..        .    ..    .     .     .. .               .. . .. .  . .
.  .    .     .   .  .  .        . .    .    .. .  .   .      .  .
.  ..  .             ..  ..   .         .           ..    .      .
.  .   ..     .   .    ..   . .         ...       ..    .        .
. .            .  .   .       ..  .             . .        .. .  .
. .     .    ..      .       .     .             ...     .  .   ..
.  .  .  ..        .   .     . .         ..            . .  .   ..
.          .  ..       .   .    .     .  .   .   .   .       . . .
.      .   .         ..  ..           .   .             .   ... ..
..     .       ...             .   .    . .     .   . .  .     ...
.. .      .    .  .  .  . .   . .      .. .  .     ..  .  . .    .
. .  .. .   .   ..  .    ..   ..          ..                     .
. .  ..          ..         .   .           .  .  .          .. ..
..   .           . .  ..           . .    . .    .. .     ..     .
. ..   . .   .. ..    .. .       ..    . ...     .. . .... .   . .
..  . . ...     . ...   ...    .      .. .   .        ..       ...
..................................................................
