...........................................................
. .           .     .    .   ..     .       . .     ...   .
. .     .    .        . ..           .       ..        .  .
.. .             ..  ...       .      .   .  S    .  . .  .
.    .      ..   ..   . .      .                 ... . .  .
.   .       .   . .     ..      .     ..   .   .X         .
.       .. .    .  .  .    .    .  .   ..         .     . .
.    . .  ..   . . .      .        ..   .. .   .       .  .
..  ..            .         ..     .        .  .     .    .
..  .       .    .       .  ..   . ..   .    . .     .... .
.     .    .  .    .      ..      .   . .  .       .      .
...........................................................
