.............................................................................................................................
..  ....        . .           . .  .  . . .      .    .        .  . ...         ... ...   .  .      .  ..     ...    . .   ..
..      . .   .              .       .    .     . .               ... . .   .  . .          .      .  .  .    . .  .     .  .
.          .  ..    .. .      ....      .   .. ..            S  .  .                .     . .     .   .   .   . .   .    . ..
..    .   .. .            . .  .      .  . ..    .. . . .             .     .        ...     .     .      .              .  .
.   .   .      .       .       .....  .       . . ...      .     .  ..   . ..      .  .. . . . . ...         .   ..       . .
.    .   .     .  ...     .  . .  . ..  .       . ..      .    .   .           . .   . .  ..  .     ..   .            . .   .
.   .   . .    .    .  .       . . . .   ..      .        ..  ..        . . .   .     .  .      .      .. .    .   . .  .   .
.  .. .  .... .    .       . . ..   . .        .  .       X  .   .   .     .  .   ...      .        ..  .  . . .  ..  .     .
. ..        .    .                     ..     .  . .    .   .       .. ..        .   .                .  .  .            .  .
...        .        ..   ..  .  .        .   ..      .           .       .          .      .        .   .                .. .
..  .            .  .   .  .       .  .  .                  .     .   .   . ..  .       ... .       .      .     ..    . .  .
..   ..       . .  .     ...          .    . .   . . .    . .      .        .    . . .      .     .      . .           . .  .
.   .      ..      .           . .     .         . ..  ..        . .      .  .              .  . .  .     .. . ..   . .     .
. .  .  .   .  . . .   .   .        . .      .              ....    . ..   .  . .      .   .   .  . .. .    .      . ... ....
. ... ...   .   ..          ..   .    .  .     .         .  .    ..                .         .      .                . ..  ..
. .                                  .    ...           .     .  . . ..    ..    .    .  .     . .  .  .           .  .     .
. .      .    .    .      ..           .   .            ..             . .        ... . . ..      . .      .     .         ..
.  .         . .       .    . ..   . .  .       .        .     .                  .  .   .   . .            .    . . .    . .
.  .  .        .  ..   .. . .     .  .  .   . .. .  .  .        ...       ..       ..   .    .   ..         .       ..      .
..      .  .  .  . ..        .  .      .    .   . .               .    .           . . ...  .     ..     .  ..   .         ..
.  ..  . .    . . .  .  .  ...    ..         .    ..      .    .   .      .           ... .                 .     .    .    .
.   ..       ..  .      .  ..  .      ..    .        ...      .     .        .     .    ..  .          . ..  .  ..     .    .
.  .    .    .       .   .   .   .    .             ....     ..   .   .      . .     . .  .     ..     .       .          . .
.       .        ..   ...         ....   .           .         .                  .          .    .      .                  .
.............................................................................................................................
