..........................................................................................................................
.  ..  .  ... ..    .    .  .       .  .   .   . ..              .   .  .     . ..  .     .  .       .S  .   ..   . .... .
...    . ..         ..          . .        ....  . ..     .   .       .   .   .      .     .       ..          .        ..
.  .   ..   .        .  .  .   ... .  .  .. . ..    . . .  .   .  ..     . . . . .. .  .. .    . .  .  . ..   ..   .     .
.     .  .   ... ..  .       .  ...             ..   ..    .       ..     .  ...   . .     .       ...   ..     . ... . ..
.. .   . .  .        .   . .    . .   . . ..        .      .   . .      . .    .                 ..   ...    ..  .   . ...
.  .... ..    .         .   . .  .    .  ..  . ...  ....        .  .            .... .        ...  ..   .   .        . . .
.    . .   . . .         .   .                 . .   X  . .         .         .    . . ..          .   .    . . .    .  ..
. .     . ..    .         .         . . ..  .  .   .   . .  .       .    ..  .   .   . . ..      .. .. .  ....    . .  . .
...      .   ..      .   .      ....  ..  .. .. .  . ..    ...   .       .   . ..  .. .  . ....          .  . . .   . ....
. ..    .   . .  .  . .    ..  ...   ... .  . ..... .  .     .   .. ..  . ..  . ..     .   .  .   . .     .       .. .   .
. .  .  .   . ..  .    .   .  .  .      .  ..     .  .     ..  .    ...      . .  ..    ..     .  ....   ..  ..  .    . ..
..   . ..    . .  ......      . . ..        .  .  .. .         .  .       .  .     .     .   .    ... .. ... ..      .   .
.. . .       ..  . .  . .     .  ..      .. .    .   . .    ..       .     .  . ..  .      . .. .      .. .  ..  ..   . ..
.   . .     ..    ...  .  . . .. .    . .        . . .  .   .    ..       ..   ..    . ..        .  ..   .   .  ..    .  .
..  . .  .    .  ..  .   ..     ....    .  . ...           ..  .. .     . .   ... .     . .. .  . ..     . ....  . .     .
. .   .    .    . .    .            .  .   .  .     .. .    .       ..  .       .  .   ..  .     .  .   .          . .  ..
.  .. . . .   .          . ...              ..  .        .  .  .             .. .       .. .  .  .  ..  .   .         .  .
.. . .    .... .      .. ..   .   .  .  . . .    .   . .  . . .    ...  .      . ..    .     ...  . .  .     .   .     . .
..         .  .     .   .. .. .      .    ... .  ..  ... ... .  .     . .  . .   . .    .   . . . .   . . .....  .  . .  .
..         .     . .        ..    .  . ...   .                .   ...  . .       ..     ...   .   .    ..    .   .. ..  ..
. .   .     .    . ..            .       ..      .  ...     ..            ...  ..  .  . ...      ... .. ..       .. .    .
. .    .      ..   ... ..  .  .      .    ..  .. ... ..   .       .                .       .     .   .      .    ..      .
.      . .  .. ..     .   . .   ....      . .  .. ..   . . .. .    .     .    ...     ..     .        .   .    .. . . .  .
. .     ..     ..     .. . ..        .  .   .  . . .    ..    ..  .      .     .. ..       .... . .        .  . .   ..   .
.     .     ... .       . . ... .    .  . .. .. .     .. ...  . .. .  .      .          .    ..     ..                . ..
.     .    .    ..  .   . . .   .   ..      .    .    .....    .. .      ....     . .     ..   .     .         . .  ...  .
..........................................................................................................................
