..........................................................................................
. .     .   .    .             ..    . . . . .                  .     .   .  .        .  .
.           ..   S .   ..           .                .               .          .    .   .
.  .  ..     .              .   .        . .     .       . .         .  .   .           ..
.        .           .                    .     ..     .     .     . . . .               .
.  . . .            .     .  .   .                  .                           .        .
.. .  .                .      .                    . .    .            .   .             .
.          . .                   .  ...    .  .       .    .  .               . ..       .
. .     .        .          .      .            .          .   .  .                 .    .
..   .  .  .    .         .           X                           .            .         .
.                  .    . .     .      .                  .  ..               .        . .
.    .. .    .                .  .          .      ..            .    ..        .        .
..........................................................................................
