.................................
...  . ..  ..          ..      ..
...  .  .   . ... .    ...  . . .
...  ..     . .  .   ...   .   ..
...    .   ..  .      ..     .  .
. . .  . ...  . . .  .     .    .
.  . .. .  . .   . .     S  .   .
.  ...  .   .        . .  .     .
... .   .....   .   .   . .   . .
.  . .     .      ...    ...    .
.. .......      ... . .   . ..  .
.   .. .      .   ..  ....      .
...  ... ..       .  ..  X      .
.       ..    ...  .  .    . .  .
. . .        .    .   ...   .. ..
.     .    .       .     .  .  ..
. .....       . .  .  .        ..
.  .   .  .      . .    .    .  .
. .       .  .  ... . . . .   . .
..       . .....           . .  .
.................................
