....................................................................................................................................
.   .       .   ...  ...             .       . ..      . ... .   . . . .    .     . ..             .        .            .   .    ..
.     .     .    ...   .   .           S    .    ..        ...  .      ..    .     .   .. .                       .    X  .    .   .
.     .   .                   .    .      .       ..                          ..  .     .  .     ..                .    ..  .      .
.  . .       .   .  .        ...       . . .  .          . ..   .  .      .          .             .        . .     .        .     .
.                .   .              .  .  .                 .     .          .      .    .         .    .            ..     .      .
.    .             .       ..  .    ..  ..          .          .         . . . ..      .  ...   . .            .  ..        .    . .
. .         .    ..      .     .         .       .    .  .    .          . .   .    .       .  .  . .    .   .    .           .    .
.  . . .                .   .   .    ..         .      ..    .                  .                 ..  .       . .  .          .    .
.   .          .  .        .              .          .        .                 .       .      . .          .   . ..     .         .
.  .        .                                 .          .  .  .    .      .      .  . . ..               . .    .      .    .     .
.           .    .       ... .                .       .    .           .  .                 .       .    .   .   . .    .   .      .
.    .. ..   .  ...  . . .               .  .        . .     .    ..      . .   .                .  .  ...     ....   .    .     . .
.                                   .      ..     .   .       .    .    .      .     .                 .      .   . .    .     .   .
.          .                      .        .  .            .  .       .   ..   ...       .  .   .                .        .   .    .
....................................................................................................................................
