.................................................................................................................................
. ..   . .  . ..  .   .        .   .     ..   .    .  .  .    ..   ..  . .          .    .     .  .   .    ...     .         .  .
.   .. .      .. .      . . .         . .. .  . . .  .        ..       ..       ..   . .      .   .... .. .   . . .           . .
.  .     .. .. . . ...  .       ..    ..         . . . . .....          .  . . .   .       .    .      .    .     .    . ..     .
.. . .. .          . . ...   .    .    . .          ....      ..      . .    .    ..    .       .  . .     .        .   . .    ..
.     .  .     ..    . ..            .   .    .       .   . ..  .. .           . .  . . .   . ..  ..    .. .  . .     .   .     .
.  .  ..        .      .    . .        .  . . .. .    .      ..    .  . .        .             .   ...    .   .....      . . .. .
.       .  .  .    . .        ...    . .    . .   ..    . .   . .    ..  ..  .  . .. . .. .    . .  . ..    .      . .  .  . .  .
.         . .   .  .   .         . . .  .  . .    .    .       . . .   .    . . .  ..        . ..  .        .. ..  ...    .     .
...          . .  .   . .. .    . ...      .  . ..  ...... .   ..  .  . .          .   ..  ..       .  .   .        .. .......  .
..       .  . .... ..      ..  .  .   .  .. . .  .  . .           .  .    . ..    .         .  .          .  .       .   .   . ..
.. .           ...             .   ..              .   .  .  .....   ...        .  ..      .     ..   ..     .      .      .   ..
.           .   .. .   ..    .   .. .       ....  ..       . ...      . .  . .. ..  .   .  . . .     .     .  ...     ..  ...   .
.   . ..    ..  .      S  .  .      .. ..    .. .            . ..      .     . . . ...      .   .    ..  ..  ..   .   .   .    ..
.  .   . ..   .   .  ..      . ..     .   ..  .. ..   .    .  .        ..  .. ..   .  ... .   . . .  ..   .    .    . . .       .
. .  .           ..X     . .   .  .  . . .  .      .     ..   .      ..       .  ..    .  .    .  .      .    .  ..        .  . .
.   . .  .  .  ... .. ..  ...      ..   . .. .. .  .    .    .       .    .  .   . .         .  ...  .      .    .... . . .     .
.. .  .  . .    .   .   .        ...  .  ..     . .   . ..        ..  .   . .   . .  . .        . . .              ..  . ..   . .
.    . .    . .    .   .    .   .  .  ...     .     .   .  . .   ..  ..      .. .    ..         ...     .  .  .       .    .    .
....   . ..    ..   . .   .....   . .  ..              ...  ..     . .  .   ..        . .  ..       ...       .. ...  .     . . .
.  .  .  ..        .  .  .  .    . .. . .. ..       .              .        .     .     ...     . . .    . .     .  .         ...
.................................................................................................................................
