..............................................................................................................................
.   . .        .                              .              .        .      ...  .   ..     .                       ..   .  .
.      .      .                  .                               .  ..         .        . . .      .                  . . . ..
.          .                     .  ..  .          ..                        .  .           .    .          .       .     .  .
.    .  .        .            ..      .          .  .     ..  .                   ..                  .           .          .
.   . .    .                 .       .  .    . .           .                   .                            .   ..  .        .
.  .         .              .              .                      .      X        .   .    .         .     .            . .  .
.     .            .        ..           .      .              .   .   .   .    .    .  .                    .       . .     .
.    . ..                              . .   .            .              .    .           .               . .                .
.   . .    .. .    . ..       .          .        .          .                            .                                  .
.  .         .       .           .            ..    .   .        .         .  .        . .      .         .   .    .     ..  .
.      . ..                  .  .              .     .       .                       .  S .        .  .  . . .         .     .
.      .          ..                . .   .                .           .           .                     .          . .      .
.    ..                     . ..               .                  .    .             .       .                          .    .
. ..     . .    .       .     .  .         .   . .         .            .        .  .     .        .     .    .         .    .
..............................................................................................................................
