.................................................................................................
.    .        . .  . .    .      .  . .  .    .  .             .    . .       .    .     .      .
. .  ...  .    .             ..         .  ..     .     .     .         ..          .   .  .    .
...  .      .  . . . ..  ..  .       .   .  ..    .. .  ..   .   . . .     .       ..  .      . .
..        . . .  ..   .       . .  ..  .  .      ..   .  ...   . .    .   .        .         .. .
.        .   .. .           .     .     ..  . .            .        .     .       .          .  .
.   .. .     .  .       ...  . .   ..   . .         ..   ..   ..  ..     .               .     ..
.     .       . .       . ..    ....     .   . ..  .      ..   .  . ..     .. .     . .    .    .
.    .       . .   .    . S           .  .               .   .  .   .        ..       .   .   ...
.  .    .. ..            ....   .       . .   .      .       .   ....       .    .    .     . . .
.. .      .      . .        .  . .          .   .          .  . .      . .            .         .
.     . .    .  .          . .            .   .      . .         . .  .  ..               ..    .
.    .    . ...    .   .     .                .        .         .  .     . .. .   . .   .  .   .
.    .. ..            .  .   .   .            ..          . .  .  . .   .        .   .     ..   .
...  .    .      . ....   .     .          .         .  .     . ..  .     .   .   .    .    .   .
.    .     ..     ..  .   .  X     ...      ..        .      . .      . .      .      .         .
.     .        .  .  . ..    ..       .        .    ..              ..             ...    .     .
.     .  .     .  .   .           .                  .  ..   .     ..  .  ..       .            .
..   .                    .          . . . .      .               ..       . . . .       .  . . .
. .  ...         .     .. .   . .                .             .    ..        .       ..  .     .
.................................................................................................
