....................................................................
.                .     .   .         .    .      .. ..            ..
.       .   . .    .     .   ..  .  . .   ..    . .     .    .     .
..   .         .    .  .               .  .  .  .      . ....     ..
.       .. .   . .    ... .           . .      .   .     .. .      .
.  .     .  .        . ..                ..     ... .. . .  ..   . .
.  .     ..       . .     .   .    ..        ..    .     ..    ..  .
. ..    ..    .   .        .    .  .     .     .       .           .
.S        . .  .   .   . .                 .     .    .   .   .    .
.     .  .   .         .  .  .   .  . .             ...         .  .
.      .    ..          .. ...  . ..  ... ..    .. .        .  . ...
.   .   .   ... . X.  .   . .  .    . ..              .  .       . .
..   ..  .       ...  .  .   .          ..  .    . ..              .
..   . .   .      .    .  .  .     .    .   .        .  .   ..  .  .
.. .   ..  .     .. . ..    . . .    .       ..     .        .  .  .
..   ...       .  . .     .     .  .. ..   . . . .  .   .   .   .  .
.         .          .           .   .  . .                        .
..   .  ..   . .   . . .        .   .       .      . .      .. ..  .
.  .   .           ..        .     .  .               . .  .    .. .
.    ..   .          .  .       .     .   .    ..    .           . .
....................................................................
