.................................................
.          .     . .. .  . .   ..     .         .
. .         .. . S .          . ...         ..  .
.     .  ..   ....        .  .   ...   .       ..
. .  .        . .   . .       . .  ...         ..
.        .          .    . .       .. ..     .. .
.     ..              .          .. .     . .  ..
.    ..  ..     .   .      .  .       .         .
.      ..  ..  .     .                          .
...   .  ..     .  .    .  . . ...             ..
...... X    . .. .     .      .           . ..  .
.   ..  .        ..     .     . ..    .      .. .
..       ..    ...   ....  .     .      ..      .
.          .. .  .     . ..   ..          .     .
. .   .    ..  .  .. .  ...      . .            .
..      .   .           ..                . ..  .
.. . . .           .  .   .    ....          .  .
..     .     .    .   .  .       .   .  .   .   .
.................................................
