...............................................................................
. .  ..  ..             . .         X. .. .  .  .        . .         . .      .
.  .. .   .    .      .    ...  .  .   . .    .  ..     .  . .   . . ..   .....
.     .   ....     .  .. .  . . ...  .  .. ..     . ..   .     .    .. .  .   .
. . . .  . . ..  . . ..   . . ..  .    .  . .. . . ... .      .  ...   . ..  ..
.       .   ..   .  . .        .  ..    . .   ..  .     .     .  ...   .     ..
.  .     .   ...     .  .  .     .    .           .  .    ...   ...    .      .
....    .    .... .        .      ..       ...    .   .   .. . ..    ..    .  .
. .  ..   .. . .       .    . . .  .   .  ...      ..    . .             .   ..
. .    .....   .  .   .   .          ..  ..     .. . .    ......   ..  .      .
.  .          .        .  .    .  .  . . ... . . . .      .  .. . ....  ..   ..
. . ... .        .. ...  .     ..   ..           ..   ..        .  . .   . .  .
.    .     . .   .     .   ....        . . .. ..    . .   .      .   .  .   ...
...         .  .        . ..        .  . . ..   . .. . ..  .        .. .      .
. .      .      .  . . .      .... . .    ...                . .  .. .    .   .
... .     .   .      . . . .         ..     ..  ..    .       .    .   ..  . ..
.     . .        . . .          ..   ..   ...        ..  . .   ..      .   .  .
.     .        . ....  .   ..     .      .. .   .      ... .         .   . .  .
.  .. .       . .      .    .........    ...     .   .   . S .  ..    ..    . .
. . .  .  .    .    .  .. .....    .         . . ..     .              .      .
...............................................................................
