..............................................................................
.           .      ..    .  ...    .  ..    .   ..   .         .  .          .
.  .      ..             .. .. .     .  .  . .  ..  .  ..   .   .. ..        .
.         .         .          .  ....          . .     . ..         . .     .
...       .      .  . .      .  ..   .. ..  ..     . .        .  .   . .   . .
. . . .        .                        .   .   .  .  . ...   .   .     .  ...
..   .       S .    .      ... .. . ..  ..    .     .. ..  .     .  .        .
.    ..   .  .      .  .  . .       .. .       .     .   .   .          .    .
. .. .  .   . .   ..     .X  .    .  .     .    ..    ..        .       .   ..
.    ..         .        .. . .  . .          . . .    .     ...    . .   . ..
. ...     .   .   . .        .... .      .   .    .. .  .   .. .    . . ..  ..
. . . ... .  .  .     .       ..  .                ..     .  . ..   .  .   . .
..............................................................................
