..............................................................
.   .   ..            .            .   . .                   .
.             . .    ..   .               .       ..    . .. .
.       .        . .  .       . .       .     .        . .   .
.     .        .   .    . . .  .           .   .    .. .    ..
. ...    . .  ....    .      .  .      S.   .   . .      . . .
..    .         .        .. ..          .  .   . .   .      ..
.   ..              .  .         . .         .   .     . . . .
..    .  ..  .  ..    .          .             .      .      .
.   .       .      .                         . ..      ..   ..
.    ..          .  .   .   ..   .  .. .         .     . .. ..
. .     .        .        . . .                        .     .
..               ..  .    ... .        .            .       ..
.      ..  .    .  ..    .           ...  .         .     .  .
.       .  .    .    .      . .  .       .     .     . ..    .
.          .           .   .. .  .  .    .    .     ..  .   ..
.     .       .                 . X. .             .         .
..    . .           .  .                   .    ..    . .    .
..............................................................
