.....................................................................................................................................................
..  .     . .        . .        .       .                           .  .  .              . . .. . ..          .    ..                 .    .      . .
.            .    . .  .         .       .        .     .             .              .  .      .                    . ..  .      .         .    .   .
.    .   .               .      .      .         .                           .            .      .     .      .      .                .       .    ..
. .              .   . .     .             .     .     .       .         . .   .                      .       .        ..      ..    . .  .         .
.         .   . .     ..         .  .     .   .. . .                .     ...          .  ..      . .  .     .                       ..    .       ..
. ..               . .      .   .         . .     .  .    . .     .                     .    .   .             .  . . .  . .     . ..     ..  .     .
.    . . .   .        .      ... .          .       .. .   ..  .         .    .                 .       .      ..   .  .      .      . .      ..    .
.              ...    .    .                        .  .           . .   .  .. .                 .     . .   .      .         .                  .  .
.    .. . . ..   .       ..      .   .  .                .       .           .     .    .   .                       . .       ..      .. .    .  .  .
.      .        .  .        . .     .                                .          .       .   .              ..            .  .        . .   ..       .
.   ..                     .   .   .    .   .             .                       .       .  .    .     .                       .      .   .        .
..    ..          .     .  ..    .       .                       .  .         .        .  .                                ..    .   .     .    .   .
.         .X .             .   .                        .  ..       .       .             .  . .     ..     .     .                   .          .  .
. .           .. .       .  S.          .       .   .     .  .    ..  .       .               .       . ...        .  .      . .  .  .    ..        .
.         .                .       .        ...        .         .                                 . .  ..                                 .        .
.....................................................................................................................................................
