.............................................................................................................................
..        .  ..    . . .    . .    .        .     ..              .          .           . .      .  . .  .  .  .          ..
.     .          .     .  ..             .   .    .                    .            . .   .         .      .             .  .
.   .  .    .   ..       .    .  .           . .    .      .  .   ....                      . .  .  .                    .  .
.    .          . .  . ..                .    .    .    .  .              .   .   .                .   . .        . .      ..
.               . ..    . ..    .   .    .    .  .  .  .      .  . .. .              .     .. .... . .    .    ..        . ..
..  .  .    .     . .. ..             .     .       .. .            .          .    .        .                   .  . .......
.      ..         . .    .       .   ..     . .   . .  .             .              .   .        . .   ..         .    .   ..
.   .. .          ..         .   .  ...           .  .     ..  ...       .         .       .  .       .    .    .         . .
.    .    .     .  ..   .       .   . .      ..     .           . ...      ..  .  . .         . .         .    .  .   ..    .
... .    .     .             .            .    .  ..   ..  .    .. ..     .   ...... . .     . .                   ..      ..
.    . .        ...   .            .          .        .    .        .  .     .    .    .       . .  .  .     .   .         .
.            ..       . . . ..                .    .  .    .    .     ..     .     .            . .     .  .    .   .  .    .
.   .  .  .           . .               X.  .. .     .           .   .   ..  .   .   .         .     ..                 .. ..
. . ..    .   .    .   ...           .    ....         .  . . .        . .       .     .         .          .    ...   .    .
..   .     .    ..   .  .     .    .    . .       . . .   .  .. .          .  .     .       . .   .       .   .. ..         .
.                    . .  .   .  .   .              .    . ..              .   .    .                  ..         .  ...    .
.. . . .  .     .. . .         .       .  .          . .        .    .    ..    .   ..        .   .                  .   .  .
.     ..      .       . .         .  .  .  .  .  .    .      .                . . ..                 .    . . . .           .
.                                  . .. . ..  .   ..              . .          .  .... .        .      .     .  .   .     ...
.       ...  .    .   .         ..  . .       . .            . .. .                 ..    .   .     .    .   .   . .      . .
. .  ..          . .. .   .  .      .        .     .  . S.  .         .       .      . ..         .         . ...  . .   .  .
.    .       .  .  .                 .       . ....     .      .    .  . .        . .    ..  ...  .  .       .      .       .
.............................................................................................................................
