.............................................................................................
.                           . .    .      . .          .                              .. .  .
.   .          .    .                .                        .             .               .
.  .           .          ...         .                            .             .          .
.      .                   .      .               .                .    .                   .
.              ..          . . .      .              . .           .                  .     .
.                               .           .      .              .                         .
.   .    .    .     .                .  .   .                   .                 .    .   ..
.             .             S     .  .     .     .                             .            .
.     .  .          . .               .       .    ..                     . X   .  .        .
.            .       ..  .                    .           .   .   .    .            .   .   .
.        ..     .                  .                  .    .                                .
.                                    .                                .                     .
.                          .         .                . .                       .       .  ..
.             .             . .                                    .                        .
.       .            .     .                                          .    .       .       ..
.          . .     ..                 .                 .     .     .    .  .  ..           .
.   .     .       .      .                         ..  . .      .     .               .     .
.   .       .    .       .             .        .            .                    . .       .
.         .           .           .        .        .                   .           .       .
.                      .  ..   .       .        .  .         . .                     .      .
.                  . .           . .                      .              .                  .
.............................................................................................
