........................................
. ..  .    ..    .   .  ... .    .     .
.       ..             .. .    ..    . .
.S .   .   ..      .    .         .    .
.     .     .     .      .             .
..      . .   . ..  .        .   ....  .
. .  .   ...  .   ..       .   . .     .
.            . .     .    .  .  . X. . .
. .  ... .  .   . .        . ..  .     .
........................................
