......................................
.   S .         .  .. . ..           .
...    ..    .  . . .       .      . .
.   ...  .  .                 .      .
.  .. . ..   .         .        .    .
.  .          . ...   .     .     .  .
..       .        .  . ..        . ...
..      .       .    .           .  ..
.        .           .   .       .  ..
.      .     ..   ..  .         . ....
.   .  .   .  .  .   .     . .   .   .
.    . .                . . . .     ..
.     .  .     .             .     ...
.. .    .   ..             .. .   .  .
.          .. . .   . . .    .  .   ..
.  .     .        ..... . .   .   . ..
.    .              ..     ..        .
.      ..    .    ..    .  .. ..     .
..   .  ..  .      .     .. ..       .
.     .   .X   ..   .   .       .    .
.     . . .        ...  .    .  .    .
.      .  .    .     .       .  .    .
.     . .  .   ....  .    . .      . .
.   .    ..         . ..       .  .  .
. .              . .         .  ..  ..
.... .. .           ..  ..  ..       .
......................................
