.............................................................................................................
.                             . .   .  .    .  . .              .    .    . .      ...  .     . .       .   .
.   . .        . .       ..   ... .  .  . . .   .   .     .    .  ... .           ..    .    .   . . . .   ..
.              .         .     . .  . . . .      .       . .                   ..   .   .      .      .  .  .
.    .                            .   .            .   .         .      .   .   .          .. .        .   ..
..   .             ..  .    ..   .. . . . . .   .            ..   .          .  .         ..     .   .      .
..       .     .   .          .             .     ...    .       ..   .              . ..         .      .  .
.      .     .     . ...     .. .        . .           .   .. ...  .    .   ..   .   .       .      .  .. . .
. .        .       .          . .        .  ..     .    .   .                   .  ... .  .  .    .    . .. .
.   .  .. ...   .      .  ..       .         .      .   .  .     .      .      . . . . . ...     .     .    .
.                .               .     ..  ..     .   .    .   .        .    .       .. .    .  . .   . ..  .
. .     .  ..     .  .     .   .     . .  .   .  . .  ... .        .          .    .   . ...  ..        .   .
.  .        . .  . . .             .   ..  ..    .     .       ..          ..      ..    .   .       ..     .
.  . . .   . .    .    .          . . .      .    . .   .        ..   .     .  .    .    .          .  .    .
.    .  .  . X. . .     .    .   S  .  . . .           .  . ..   .            .  ..                  ..     .
.       ..    .       .         .  .       .   .   .   ..      .          ..   .   .            .           .
.............................................................................................................
