...............................................................................................
. .     .    . S                      .   .     .    .. .          ...        .        .      .
.        ...     .        .                 .  .   .       .   .  .  ...        .     .       .
. .  .     ..       .. . ...   . .                 .    .          . .         .      ..  .   .
.   . .   .                                .      ..   .                 .                    .
.  .  .  .  .  .                 .      .           .                          . X    .       .
.              .  .     .          .           .                                  .   . .     .
. ..                           .      .                 .  .       .       . .   ...   .      .
.                         .               .                       .     .                    ..
.     .        .. .                    .  ..   .           .      .    .      .               .
...............................................................................................
