......................................................................
.              ..      .       .       .           .           .     .
. .  .  .        .        .   .   .           . .   .   . ..   . ..  .
.          .     .       .          . .     ..     .  .    .        ..
.   X    .                .            ..      .        ..      .   ..
..                   .    .  ..           .         .                .
.     .                  .        .   .              .  .           ..
..      ..                           .                   .       .   .
.   .             .    .            . S                         .    .
..   . .             .   ..        .              .               .  .
.    .     .     . .              .           .   .        .        ..
.                        .   .  .  .       .                   .     .
......................................................................
