...............................
.      S..      .         .   .
. X              .   .        .
.          ..      ..         .
.   .     .                .  .
.   .          .       ..     .
.  . . .   .     .   .        .
.      .   .     .  .         .
.    . .      .               .
.       ..       ...          .
.     .         .        .    .
..    .               .       .
.  . .     .    .             .
. .                .          .
..  .               .         .
...............................
