......................................................................................................................................................
.  .   ... .      .  .        . .        ..    .                              .        . .                 .  .        .   .  .  .       ..          .
.  .     .        .       .      .         .         .        .   .   . .       .               .  ..            ..   .       .      .        .  .   .
.                .   .                  .          .            .      . .        .            .       .     ...        S               .            .
.    .   .    .         .    .        .         ..     .      .   .  .    .   ..  .            .   .                   .        ... . .  .    . .    .
.  .     .            . .    .   .           .  .       .    .      .       . ... .    .            .     .    .  .     .              .             .
..                  .         .   . .                    .   .          .         . .   . .        .      . .    .   ...    .            .  .       ..
.     .     .    .  . .  ..  . .                     . .. .       . .               .        . .              .      ..                              .
.         .  .     .    .          ..       .                                      ...         .   .        .             .                  .       .
.  ... .                 .    .     .   ..     .        .   .        ..   .              .             . .      .   .           .   X . .            .
.    . .  . .   ..    .            .            ..              .      .      .                               .  . .    .        .               .   .
......................................................................................................................................................
