................................................................................
.     ...      . ..   ..  .  .  ...         ... . .  .           .       .     .
. .   .           .       .  .   .           .      .   .       .     .    . ...
.... .  . . . .   .. .   . .    . .  .   .  . ..      . ..      ..     .      ..
.   .  .  .  . .  .     . .     .     .   .  .               .        ....     .
..       .   ..     ..   .     .    ..    ..   .      ..    . ....             .
.     .    ..  .                ..  .   .  .     .         .  ..  .     .  ..  .
.  .  ...       .       ..          .      .              ..            .  .   .
.   .     .   .    .   ..  ..          .        ..         ..   .  ..     .    .
... . .     .        .           .    .     .. .            .  .   ..     .  . .
..    ..  ..    . .           . .      .  .  .  .   ...        ..   .      .   .
.  .     .   ...    .       .  . . .   .       ..                     . ... ....
.      ..       . .. .       .      . .  . .  .... ..   .           ..    .    .
..   .    .  ...      .      .   . ...  .                 .                    .
. .     .     . .   . .    .       .                          .      . .       .
.    . . ..     .          .   .       .         . .    ..       .   .   . .   .
. .     . .       ..    .                .  .          .  .   . . ..  ...   ....
.   .        .      .     .     .     .     .  .                  .           ..
. .  .     ...         .  .  ..    ..    .   .       ..        . .      .      .
.  .   . .        .    .           . .     .   .             . .            .  .
..      ..    .    .      .    .      . .     ..   .       . ..  .        .   ..
.   . ...     .  .       .     .  ..      .   .                  .  .   .  ... .
.  .     .       .     .  .    .   .  .  .  .   .   .             ..     .   ...
..  . .         .      . ..     . . .     .         .   . .           .    .   .
..             .     .    .     .       .    .   ..  .  ... ..       .. .   S  .
.    .     ..           .           .   .  .. .   .    . .            .        .
. .      . .   . .             .  .    .   .    .   .   .      .        . .    .
.          .  . .. .   ..  ..  . .           .  X       .      .     .  .      .
..                .     .     . . ..         .   .  ..         .  .. .      .  .
................................................................................
