...............................................................
.     .   .    .  .     . .       .                  .        .
.  .  .    .   .      . .. . . .     .   .           .        .
. .   ...     .   ..           .     ...  .     . .  . .    . .
.                 .. .   . .   .     . .      .      .     .  .
.    .     ..   . . .   .      .       .  ..       .    .     .
. .  .     . . .           .   . .           .   .  .. . . .. .
.       .    .           . .      .          ..   .. .  .   . .
.   .. .      .   .  .     .  .      .  ..     .         .  . .
. .. .      .    ..     . .       .        .   .     .  .     .
.  .. ..       .   .             .   .  ..   .. .    ...      .
.   .    .... .      .      . .     ...  . . . . . ...        .
.        .  ... .                        ..         .      . ..
.   .   .  . ..          .  .                .     .          .
.        .         .            .    .        .   .           .
.                      .   . .   .   ..  . .          .     . .
.        ..                     .   .   .  .      .    .      .
.    .. .. ...  .   .   .       .     . . .     .  .         ..
...   . . . .   . .     ..   .      .      .  .             . .
.         ..     . .           ..     .  . .       .  .    .  .
.    . .   ..       . .   . .   ..   . .  ..  X. S            .
.                . .      ..    .. .  .                .. .   .
.         ..  .  .    ...   . .. .  . . ...   . .            ..
.       . .   .      .   .   .  .  ...             . . .     ..
...    .  .     .  .      .    .          .  . .  ...      .  .
...     .     ...  .     .      .. .                . . .     .
.   . .   .   . .  .   .   .   .         .         ..  .. .   .
.    . ..   .     .       .   .             .     .         . .
.      .    .        .              . . .       .             .
...............................................................
