.......................................................................
.                  .   .   .   ..           .      ...  . .     .    ..
. .   .  .     ..        S ..      .. .  .   .      ..              . .
.   . .     .             .    .  .  .  .X       .            .   .   .
. .   .    .   . .     .  . . .   .... .   .   .                      .
. . .          . .  ..  . .     . .  .   . .    .          .          .
.     ....      .         .    ...    ..  . .   ..     . .      .   ...
. .        .   .  .. .       .     . .. . .      .  .                 .
.    ..  .   .   .. .  .  .  .     . .. .  ..   .       .   .. .     ..
..  .  ..     . .    .   .   .           . .  .. .   .    .     ..   ..
.. .     .        . . .   . .          .              . .    .        .
.......................................................................
