.................................................................................................................
. ..    . .. . ..   ... .  .. .      . .     . .     ...    .      .    .  .   ... .. .   ...              .   ..
.          ..  . .  ...      .  .  ..  .   .     ..  . .    .. ...  ...   .    ...  .. .  ..    . .. .. .  .   ..
. .   .   .   ..  .     .      .  . . . ..   ..        .             ..  .    .. .. .  .        .   .    .   .  .
. .  . .        .    .  .  ... .  ..   ...   . .           ..  .     .      ...   .  .  . ...         .       . .
. .        .   .   . .          ..  .   .      ..    .  ...     .         ..              .   ...          ..   .
.        .   ...  .   ... .  . .  .   . .   .. .     .   . . . . ... ..   .   . .  .    . .  ..  .     .   ..   .
..  .            .      . ... .       .      .   .   .....      .      .  .       .   .       .. . .    . .  .. .
. ..  .. .. .   ..  . . .  .     .. .  .   ... . ... .        ...              .   . . .            .  .      . .
. . ..      . ...  X           .      .   .     .. .   .     .            . ..  .      . .....   .  .        . ..
. ..  . .   .  ...  ... .           .      ..    . . ..      ..   . .    ..  ...   .     . .   .  ..        .   .
. . ....  .   ..  . .    . .    .. ..    .    .  ..   ..  . . . ..     .    ..       ..   .         .     . ... .
..       .       .   .   .    .  . .  .   .   .  .   ..    .       .   .         . .      .    .  . . .        ..
. ..     ..   .       . . .  ..  .    . ..     .      . . .         . .. ..       . .      .  ..  ..        . . .
. .. .       ..  ..  ..     ..   .    .     .    ..     .        .  .     .  .    .            ..   ..      . . .
..    .  .   ..  . .  .  . . ..       ..           .       ... ....       .   .   .     .   .        ..  .  ..  .
.       . .   .                ..      .. .     ..     .  . . .     ..  . ....    .  .. ..          ...  .      .
....          . .  ... .    .  ..  .. .     .       .             .  ..        .. .    .     ..     . .  . ..   .
.. .     .         .. ..         .  ...     .       ..     .    ..  . ...               ....    .     .  .. . ...
...  . . .. .. .            .  .  .          . . .    .      ...  .. ..      . ... .. .S          . .  .    .   .
.     ..    .   ..          .              .      ..  .     . ..    .. .      .. .. .                 ..  ... . .
. ...        .      ...   .  .   . .      . .            .  .   .  ..   .         ....   .. . . .. .            .
..  .. .. ...... . .. . .....     ..  . .     ..  . ..    ...  . ..     .. .      .  .   . .  .       .. .  . . .
. ....  .     ..   .  .  . ...   .  .. .        .      .  ..     . .     .       ...          .. ..  .          .
... . ..  .   ..  .  .   ..   .  ..   .. .  . ....    . . ..    . .    .  .  . . ..        .     . .  .    .  . .
.................................................................................................................
