................................................................................
.                               .  .   .  .   . . .          . X. . .          .
.  ..    .   .                    .        .       .       .    ..      .      .
.    ..    ..            . ..                      .             .      .      .
..                  .   .   .             .        ..  ..     . .              .
..         . .    .            .  .              ..                 .      .   .
.   .              ..  . ..          .     .                 .      .        . .
.            .  .        .       .   .   .  . .        .       .           .   .
.        .         .          ..            .   .        .   .    .            .
.  .      ..   .  ..  . .     .  ..             .          . .  .      ..  .   .
.           .. .        .  .      . .        .. .      ..   .    .      .   .  .
.     . . .  .              .   .                   .   .  ..                  .
. .  .     S   .       .                    . .   .      .   . .          .  . .
.     .        ..   ..        . .             .           .       ..        .  .
.      .    .           .      .                     .                     ... .
.              . .                        . .                        .         .
.    .                       .       . .   ..                .                 .
.        .         .                  . .  .   .                      .  .. .  .
.         ..         ..               .          .                      .  ..  .
.                                  .            .     .               .  .     .
. .  . .                           .           .      .   .  .     . .     .   .
.  .       .  .  .            .  .         .           .                  .. . .
.       . .  . .   .   .  .   . .       .           ..                         .
.           .     .     .              .      . .            .                ..
.               .   .  .      .        .  . .  .    .                     .    .
.     .    .     .  .       .             .    .       ..   .    .     .  .    .
.        .            .             .     .    . .   .    ..  .  .        ..   .
.     .             .   ..       .  .... .           .    .    .       .       .
.      . .   .   .      .   .                 ..     .     .  .     ..         .
................................................................................
