.........................................................................................................
. . ..   . .        .        ..     .   .         .  .  . .    .         . .. .        .   .  ..  .    ..
.  ..       .   ..      . .    . ......   . .    .        . .     .   .       .   .        ...  ..   .. .
.   . .    ..             .    . .      ...  ..         .  .    ..      .  .   .. . .  .    .    .     ..
.       . .....              .      S .      .    ...    .   X        ..             .      .       .   .
. .   ..      .    .         ....    ..   . .        .           .    .  .    . .  .   .    .         . .
..  .         .            .  .  .. ... .  .         . . ..      ..             . . .   .   .  .        .
.       .....  . ..      .  .  ..   .                   .    . .  . .  .      ..   .         .       .  .
. . .    ..     .  .   ...  .  . .  .   .                       . .  .. .      ..   .         .         .
.    . .        .         .      .   .    .     . .  .            .  .     ..   .  .      . .    ....  ..
.   .    .  .      .          ...  .    .   . .                     .  ..              .                .
...  .   .   .   .            . . . . .   .   ..  .           .. .                   . .       . ..  . ..
.   ...  .      . ...  .  . .. .  . ..         .  .          .     ..       .     .    . .  . .        ..
.     ..      ..         .      ...   .        .  ..  .         .      .   .    .    .      .    ..   . .
.      .  .  .   .       . .   . .. . .      .           .      . .  . . .      . .        .   ..     . .
.....    . .  .  .    .            . .       .. .       .   ..  .   . ..              . .   . .  .  .   .
.........................................................................................................
