...............................................................................................
..  .  ..         .   . .               ... .            .   ....   .     .   ..          .   .
..                 .        ..       .  .    .      . .      .   .                            .
. ...  . .   .   .   .     .    .   .                               .  .  .    . ..       .   .
...    .    .      .      .    .         .      ..  .     .           .  .   .  .   . ..   . ..
. .   . .        .        .    .         ...     .   .  .     .   .  .   ..  .   .     .      .
..       .  .   .       .  .      .    .  X .   .     .   .     .            . .. . .     .   .
..    .         .  ..        .                           . . .            ..      .           .
. . .    .           .  .   .  .  .   .         .  . ..   ...             . . .      .        .
.  .      .       .         .. .   .              . .  . .     . .            .         .  . ..
.  ..       .        .       .  .      ..        ..      . .    .                    .     .  .
.      .        .       .    .   .  .    . .     . .               .  .                .      .
.   ..              .       . .     ..          . ...   .. .             .         .      . . .
.  .                        .  .                    ..    .   . . ..    .    .  .     .      ..
.     .    .     ..       .    .      .  .        ...      .  .         ..  .           . .  ..
.  .     ..         .       . .. .                   ..  . . .   .        . .  .     ... .   ..
..         .   .       . .                .  . .  .                .        .     .           .
.                S            .  . .    ..  ..    .        .   .                .  . ...      .
.     .  . . .                 .       .           . ..  .        .  ..  .       . .   .      .
.                       .       .        .    .     .  . . .   ..  .     .  .                 .
.     .  .     .               .          .        . .       .. .. .       . ..               .
...............................................................................................
