.......................................................
.  .. .      .  . .  ..    . .    .. .  ...  .   . .  .
.              .     .        . . .           . .     .
. .      ..          ...  .         . . .  .        ...
.. .    . .      ..   .  ..     ..  .        .       ..
.  .      . .      .   .  ..   X .         .  .       .
..  ..         .    .   ..    .  .. S.  .             .
.    . ..              .. ...   ..  . .. .  .   .  .  .
.  .. . .  .  .           .  . .   . . ..      .  .. ..
. .  ......      .. .   . ..  .  ..   .  .  . .. .    .
. .. . .     .     .    .  . .     .. .        .      .
...         .. . .    .   .     ..   .   .   . .   . ..
..        . . ..  .. . . . .         .  .      .  .. ..
.......................................................
