....................................................................................................................................................
.                      .        .  .              ..       .   .     .      .              . .              ..           .           .   .     .   .
.                    .    .               .  .                .    .         X        .          .  .            . .   . .   . ..  ..    .         .
..                   .          .  .                 ..           .  . .       . .    .  .    .  .     ..     .      .    .              .    .    .
.    .    .                .                      .            .  . . .   .                   . . ..   .     . .   . .       .            .  . .   .
. .             .       . .        .   .      .                   .          . .                 .    .. .      ..                                 .
.     .         .        ..       .                          . .             .   .                        .        .     .    .. .             .   .
.       .   .  .    .  .     .    ..        .   ....           S     .        .                    .  . .  ..     .    .    .     .   .    .. ..  ..
.  ..                       .                          .                   .   .  .                    .  .                . .              .  .   .
..          ..   .    .  .     .              .               .      .  .                 . .     .    .  .             ..         .               .
.   .       ..   .  ..        ..           .           .       .           ...              .   .   . .  .   .  .  .      .   .     . .          . .
.     .      .   .    .  .     .     .. .   .            .  ..          .    . ..   .   .  .     .         ..  .    .  .           . ..       . .  .
....................................................................................................................................................
