...............................................................................................................
. .. . . ..                 . ..   ... .    .   .         ..   .. . ..  ....      .   S.  . .   .   .      . ..
.         .    .          . .    .      ..    X .            .   . .   . .            ..  .        .        . .
.           ..            . . ..  ...  .             ..        .  .          . ..  .   .   .   .      .. .  . .
.       ...   . .   .               . .   ..         .     .  .     ..           .     ..       ..   .  ..    .
. . .... . . . .. .   .  .           .  . .    ..          . ...  .  .      .  .     .   .   ..              ..
.   ..    .. . .           .. .           .    .  .     . ..      .        .   . .      . .       .  .      . .
. . . .  .       .           .  ..     . .   .  .  .   .     .    ..         ..  ..  . .          .  . .      .
.          .      .      . . . . .     . .. .    ..  .      .          .    .   . .  . ..   .  .   .        . .
.  . .  . .     .   .      .. .       ...         .        ... .     ..  .        . . .     .. . .  ..      . .
.     . .     ...     .. .                     . .. . .     .. . .     .  . .  .           . .      .. .      .
..        .  . .. . .         . .      .   .   .       .      .. .    ...        ..  ..               .     . .
..  . .               .   ..   . ..     .      ...           ..   ..   . .     .    . .   . . . .       ..  . .
. . .    .       .  .   .      ..                 .. ..          . .   ..        .       . .     .  . .       .
.  .. .      . ..     . ..      ..         .  .  .  .       .  .  .    ..   .. .     ..                       .
.      .   .    .     .           .    .             . . . .   ..      ...   . .     ...  .            ....   .
...............................................................................................................
