........................................................................................................................................
. .   . .  .. .. ..   .       .  .   . .   . .  .    .   .   . .     .      . . . .   . .  .    . .   .  .   .   .    . . . . .  .  .  .
. .     .                            ..  .   .      ..  .  . .. .   . .  ..            .      .  .              .       .  .  ...  .   .
.       . . ..      .   .   .    . .      .  .     .    .  .     .     .        .      .        .   .  .  .    .     .   .  . .  .  .  .
.  ...   ..  . . .  .     .. .. .           .      .   .           .       ..  . .  .   . ..         .  ..  .    .      .    .  .     ..
.. .          . ...             .     . ..... .    ..            .   .   .   . . ..       .     .   .  .  ..   .   .   ..        .  ....
. ..      .       .      .  ..    .    .  ..           .    .     .. . .    . .   .  ..        ..      ..    . .     .  . .            .
.        .. ..   . . .        .          .  ..          .  . .    .. .  .   .          .      .....         .     . .  .     ..       ..
.  . .  .    . ..    .        ..   .  ..       ...    . .         . .  .. . .     . ..   .          .  . .. .      .    .  . .    .  . .
.    . . ...    . .        .        .   .. .   .  .     . .       .  .     .     ..   ... .  .. .  .       .  ..  .            ..      .
. ....      S        . ..  .          ..   ..   .. .  .    . .           .. .    .     . ..          .   .  .    . . .     .  . ..     .
.        ..  .. ..    .          .     . ..  .   .             ..    ..     .  . .   .  .  .     .           .     .  .      . .     . .
..  . .   ...  .  . .     .   .    . .      ... .    .      .     .  . . .   . . .                 ..     . .  .    .          . ..    .
... .       .     .    .   .    ..  .    .    . .     ..  .     .         ...          ...    .     ...  .  X  .. .                . . .
.      ...           .    . .    .    .  ..   .  .     .       .   .     ..   . .  .     .      . .    . .. ..  .  .   ..   . . .    . .
. ..       .  .  .   .       ..  . .. .  ..  .  ..    .         ...    .    ..          .     . ... .  . .   ...    .  . .      .      .
.  .   ..    .        .   . .    .              . .   .    .              . .  . . .     ..      .  .     . .  .. ..  .    .  .  .     .
.        .   .         .. . .      .  .         . . .    .   .        . .  .. .            .. ..            .  .    .  .  .     ..   ...
.  ...    .  ..  ...  .     .   . .  .. . .     ..  .    . . .. .  .  . .    .     ...  .  .    ...    ..       .        .     .       .
. . .    .  . .      ... .. .  .     .  .              .  ..       .     ..    .  .  .   .   .           .. .                . .  . .. .
. . ..  . ..  .  .     .          .      .. . ..        .   .   .  .       .. . .   .          .     .  .    .    ..      .  .. .      .
.    ..   . .    .     ..  .    .      .         .       ...   .  .  .     .      . .    .  . ..   .    ..   ... . .. ..      . .     ..
.     .       ..        .       .   .   .  .   .           .  .  . ...      .. .   .      .. .  .    .   .    .  .         .     . . . .
........................................................................................................................................
