.........................................................................................................................
.   . . . ..  .     ...     .   .   . ..  .  .    .      .       .  .   ..   ...      . .  . .         .....  .   . . . .
..    .   .     .   ..  . . .       .        ..  .. .  . ..    .   .      .        ..  ..  .. . . ..   .   .  ...     ...
. .  .     . .  .    ..    .  .  .. X        .    .  . . .   ..     .. .  . .... .. .     ..     ..    ...  . .     .   .
. .   .    .   . .    . .   ... . .   .  . .   .  .    ...    .   .S  . .     . . . .     .  .   .   .   .    ..        .
... .      ..  ..  .  .  .  . ..      . .    ..            ..  . .   ...  .. .     .  . .. ..   .   .       .   ..   .  .
..      . .... ...     .       ..     . ..            ..       . .           .        . .    .  . .. .  . .  .     ...  .
...  .   ..    .. ..   .   . .      .    .  . .  ... . . .          .       ...  . . .   . . .   ..   . . ..    .  . .  .
.   ..   ..      ..                .. .   . .   ..    . .  .  . .    . .. .     .  .    .. .  ..        ...   . . .. .  .
. ...   . ...          .  .      . .    ..  .  .       .  . . . .        .. .    . .   ..               .    .  .       .
.........................................................................................................................
