.............................................................................
.. .  ....             . .      .  . .        .    .           .  .  ..  .. .
.        . ..  ..      .  ...   .   ... .  .     .  .. . . .        .   . ...
..        .  .. . .     .   .      .          ..  .     . .   .           ...
.        .  .  .   . .    ... .    . . . ..     . ...  .. .S    . .  . .. . .
.  .....   . .   . .      .   ..        .    .     .    .    ...   .. . ..  .
. ..   . ..   . .    ..  .         ..  .  .            .   ..       ...  .  .
...          ..    ..    ..       ..                 ..   ..  .          ....
.  .     . .   .  . .  . .    .  .       ..   .  .. .  .  .  .  .   .      ..
.       ... .   .  ..      .    .   .      .       .   .   ..   .  .        .
. . .   .. . ..   .     .  ..   .       .    ..    .    . .    . ..     . ...
. .    . .  .  .    . . .    . .           ..  . .  .   .  .     . .       ..
. .  .   ..        ..  .  ....     .    .          . . .. .. . .   . . .   ..
.   . . .   . .  .  .  .  .      .   .. .    .    . . . . ...           ..  .
..          ...             .  .  . . . ...    .      .    ..     .  ... . ..
. .        . .     . .. ..  .                               .        .    . .
. .  . .       .    .   . ..        ...  .     .     . ..  .      .     .  ..
......     .   . ...  .  .     . .. ..       . .  .         . .           ...
. . .   .     .. .   ..    .    .          . .             ..            .  .
..     .  ..        .           .    ...  ...  .  .. .   .   .     .    ..  .
.    .       ..    .       .  ..    ...   .  . .   ..   . ..  ..  .       . .
. .  .  .  . ...  .    .  .      .  . .     .         .  .. . .        . .  .
.    . .   .  .  .. .  .  .  .     .       ..     .    ....     .        .  .
.    ...      ...   ..   .        . . .      . . .     ..  .. ....         ..
..    .  . .  .    ..  .   ... .  .     .     . . ....  .    ..  ....   ..  .
.   .   ..   .        .  .  . .   . .       .. .     .....    .          .  .
.   ...  ..    .  .    . .  . .  X.    .    ..    ..  . .      . ....     . .
. . .  .. .  ...    ...  ..  . ..  . .    .      . ...       .. .      .    .
..  . . .       .   ... .      .. .         .      ..  . .        .  ..     .
.............................................................................
