..............................................................................
.  . . .        ...       .. . . . .   .    ...  .     . ..   .   ....    .  .
.        . .   ..  . .      . .     ...   ...    . . .   .        .     .    .
.  S . . .. . .... ...           .  . X .   .  .     .   .  .   . . .   ..   .
..    .                . .  .  .  ..       .  .    .. .  .  .     .  . .     .
.   .  .  .          . . ..  ....    . . .    . .     .      .    ..   .. ....
. .         .    ..       .   .   .   .            ...       .. .  .    . .  .
.. .     . .  . .     . .  .       .          .      . .  ... .    . . . ..  .
..    ..   . .           .. .  . .    .    .  . . ....     .   .   .    ..   .
.    .   .   .. . ..  ...   .  .. ..  .   . .  . . ..          . .    .. .  ..
.       . ..    . ..   .       . ..   . . .   . ..    . .     ...  .. .      .
.      .   . .    .     .  .  .      .   .        .  . .. ..           ..    .
.  .. .     .      . . ..     .                   .  ..            . .  .  . .
..  .       . .   .    .   ..   .    . .         . ...     .   .   .   ...   .
.. .. .      .         ..  .    .   .     .  ..   ..    .      .    .  .  . ..
...      . .        ..    .. ..  .  .     ..    .. .    .  .          ..  .  .
. . ...    .         ..       ..     .       .    .  .      .   .     ..  . ..
...    ....        .  .     . .       .      .    ..    .  ..             .  .
. . .       .   . .           ..   ..      ..         .. .     .    ... .. ...
.  ..   . . . .      ..   . .  ...  . .              ..    .  ..   .. ..     .
.           .   .     . .   .       .   .        .  .   .      .   ..    .  ..
..............................................................................
