..............................................................................................................................
.  .     ..    . .    .      ..      .  .    . .           .      .  .                  .             . ...       .         ..
.  .     .                             . . .   .      .            .    .     . ..  .                      .    ..           .
.    .  .        .             .  ..   ..      .        ..               .  .              ..         .     .   .            .
.    ..             .   .                   .   .  .   . .                         .          .    ..            .           .
.   . .    .            .        .      .              ..    .             .  .    .   .                      ...  .         .
.            .     .   .                             .              .    .      .              . .     .        . . . .      .
..                                      ..      .      .                                      .            .  .       . .    .
.              .    .     .  . .   .     ...                 .                       .                   .       .  .   .    .
..           . ..              .        .        . .         ..                  .                 .          .    .         .
. .               .   . .    .   .    .    .  .                                   .     .                       .            .
. .                .       .          X              .      .  .    .            ..             .                  .         .
.                                                  . ..        . ..          .                    .       .         .        .
.     .       .       .        .   .       .        .         .        .                ..         . .    .                  .
.                              .                    .   .. ..      .  .  .    .. ..      S .     .      .   .   .       .    .
.      .            .                ..     .         ..    .            .  .                      .       .        .        .
.    . .       .      .    .  .        . .    .                       .   .         .        .                    .      .   .
.    .              . .             .    .    .    .   .             .     .    ..  .          ..   .  . .     .            ..
.   .  .    . .        .      ..        .           .   .            .  .       .     .   .                .     .  .   .    .
. .        . .      . ..     .       . . .                     .   .      .    ..            .   .  .         .   .  . ..    .
.          .      .    .           .   ..     .  .      .       .            .  .      .            .            .     .     .
.        .         .    .                      .     .   .    . .     .   . .   .  .           .                             .
. .      .          . . .     .         .  .      .     . .               .   .  .      ..  .   .                         .  .
.    . .           .          .      ..  .           . .              . .    . .         .               .          .        .
.          .                   ..          . ..     .    . .           .          .  .  .  . .           ... ..            . .
.    .                      .                 ..   .     .                    .  ..                               . .      . .
.              .                                                  .                .         .              .       .       ..
. .                    .    .                   ..                .        ..     .  .. .     .         ..  .    ..       .  .
..............................................................................................................................
