...............................................................................
.    .           .             .        .      ... .      .. .          .  .  .
.                     .   .                                        .    ..    .
.        .      ..     .   .            X    .      .                         .
.   .     . ..                 . .          .    ..     ..               . .  .
. .          .              .         .     .              .              .   .
.                            .                       .        . .             .
.                  .            .                 .          .                .
.        . .    .  .      .       . .    . .      . ..      .              .. .
.   ..                       .    . .   ..            ..            .     S   .
..     .  .   .   .        .        .   ..           ...  .  .                .
.            .      .  ..                  .  .                     .       . .
.  .   .                .                    ...                              .
.             .    .                 .      .   .  .          ...        ...  .
.   .    .               .        .             .    .                        .
.     ..       .             .       .                .                       .
.      .  .   .         .  .              . .                . . .            .
.              .          ..                     .. .          .      .       .
.      .       .    .    .   .  .   .              .  .     .       .         .
..   .  .                 .    .           ..                             . . .
...............................................................................
