................................................
. .               .    .    .     ..   .      ..
.   .             .   .     .              .   .
.   .  ..      .    .      . .          .    ...
. .. ..    .      ..   .. .   .          . ..  .
.  .  .               .       .    .          ..
..    .X    ..      . .    .       .    . .   ..
.  .   ..                 .   . .       .. .   .
.  .         .   . . .      .            .     .
. .        ..       . .   .                  . .
.    .  .   .              .   .    .       .  .
..  .    .   .   .  .          .     .         .
. ..  .        ..              .     .      . ..
. . .    ..  .    . .            .      .   .  .
..   . .  . .   ..      .S    .. .             .
.   . .   .   ..            .   .        .   . .
.   ..     .. .    . .   .  ..  ... . .   .  ...
.       .    .           ..     .           .  .
.   .   .       .   .  .   ...      .          .
................................................
