..........................................................
.                                 .         . .          .
. ... . .  .  . .                    .   .     .         .
.          .    ..    .  .                               .
.              .           .  S .    . ..              . .
.   .              .       . . .   .    .                .
.       .    .        .  .   .    .       .. . .   .     .
.        . .. .. .     .     .         .     .        .  .
. .       .   .               .. .    ...     ... .      .
..      ...  .                 ..    . .    ..       .  ..
. . .        ..    ..     .  .      .       .    .  ..   .
. .    . . X.    .      . .    .  ....  .                .
.  ..    .   .        .    .      .        .          .  .
.    .   ..   . .      .           .                    ..
..........................................................
