........................................
. .  .     .           .     .         .
..      .     ..      .      ..        .
.             .   .        .    .   .  .
.  ..                        ..    .   .
.     .            .    .   ..    ..   .
...  .     . .    .         .          .
.    .                 . .      .  .   .
..            . .                .     .
.              . . .        .  .      ..
.   .   .     .               .  .     .
.         .      . . . .     .         .
.  .                     ..         .. .
. .         .    ..         .     .   ..
. .     .    .   .   .  ..             .
..   . .     .X...      .          .   .
.  .  ..          .         .       .. .
.  .       .  .  . .       .   . .     .
.        .                    S        .
.        .    .  .     .               .
........................................
