.......................................
..            .  .     .      ..      .
.        . .    . ... ..              .
.  .   .         .  ... . .   .       .
.    .    .     . .           .  .    .
..    . .. .. ..   .        .     . . .
. . ..   .           . .   .  . ..   ..
..       .       ..  .      .      .  .
.        .      .     ..          .   .
.  . ... ..    . .     .  .     .  .  .
.   .  . .   .     .   . .      .     .
.     .     .  .        . ..          .
.       ..   .   .     ..          .  .
.  . .    .  ..  X ..           ..    .
.  . .  .  .  .  .        .       . . .
.  .     .    .       .. S .  .       .
...  .     ..       .    .....    . . .
.......................................
