.........................................................................................................
.. . .        .   .         .   .       .     .       .     . .          .   . .  S   ..    .     .     .
..  . . . .     .         .   ..     X            .     . .        . .   . .    .     .   .             .
. .    .    .   . .. .       .  .. .             . . . .  . . .      .  .. .        ..   .              .
.   .. .          .  .  ..     ..            .    .       .  .           .           . ..       .  .    .
. .              ..                  . .      ..                 .        .            .    ..        . .
.     ..     .  . .      .          .  .  .  .         .    .          . ..            . .        .     .
.     . ..             .. .               .     .     .    .... .. .  .   .      ..                     .
.  .  .                     .       ..                                   . ..     .  .. .     .    .    .
.  ..        .    .  ..   .    .     ..       . .    . .    .      .          .     . ..     ..         .
.           .  .       .       .            .         .  .          ..           .        .  .    ..    .
.. .   .      .  .          . ..   . .           . . .     .    .     ..    . .      .  ..   .   . .  . .
. .     ..            ..      .      . .   .     . .    .    .      .   . .   .                 .   ... .
.      .   .. .    .    .  .     . .        .      ...    . .   .      . . .           .    ..          .
.         .      .  .  .         ...     .      .   . .   . .. .        .  .       .      .  .     .    .
.  ..    .            .        .   .       .        ...             .. .        . .       .    .        .
.       ..          .        .      . .      .     .    .           .  .   . .   .    ..  .   .        ..
. .  .           .     . . .       .      .               ..     .        .          ..    .    .   . . .
.........................................................................................................
