......................................................................................
..      . . .             .    .   .         .. .  .  .            .   ..  . .     . .
.   .      .     .  .    .  .          .  .  .    .         . .   .         ..       .
.                   .     .           .  .           .    .      . . .       .       .
.                    .                .         .       .   .   .                .   .
..   ..              .     ..     . .          .   . .        .     .        ..      .
.        .       .    . .            .    .      . .      .         .  . . .  ..     .
.    .      .   .       .         .            .         .                    ..   ...
.                .           . .              .      .   .             .  .          .
.   .           . .      .        .     .. ..           .    .      .  .      .      .
.      .         .  ..                                  ..         . .             . .
. . .   .     .   ....     ..                 .   .    .   . .   .             .     .
.    .         .                .  .            .  .                 . .  .          .
.                .   .   .  .         ..                 .  ..    .    .         .   .
.     .   . .           .        . .   .      .               .          .   .     . .
..   X                    ..   ..  .  .   .. .    S       .             .   .    .   .
..           .   .  .          .       .. . .   .    .  .          .                 .
......................................................................................
