..................................................................................
.    ..   . . ..     ..  . .  ..  .      ..        .      .     .   ...  .    ....
. .     .  .  ..  .  .  .   . . . . ....     .     .          .  . ..  .      . ..
.       .  ..  ...      ..   ..     .     .     . .     .  .    .        ..   . ..
..   .       ..    . ..    ..            .   .. .. .        S..     ..    .      .
.   ..            ... ...  ..       ..     .  . .   ..       . .   .             .
. ..     . ..             ..   .  .                 ..        ...   ..    .  .   .
....   .     .    .  ..   . .    .  .      .     .     .    .           ...   .  .
.   .  .    .        .              ...     .   .   .    .       .  .   ..    . ..
.  .         .  . .  . .  .     .  .   .      .   .        . .      .. .. ..  . ..
.       . .   ..    .  .    ...      ....  .     .   .   ..  .   ..   .. .  .  . .
.     . .  .         .   .. . .         .    .      .  . .  .  .      ..         .
.   ... ...   .  .      .     .    .   .   .        ..       .  .    . ..  . . . .
..    . .  .   . ..       .    . .  .   .. .                  .    .    ..  .  . .
. .        .  .      .      .  . .           . ... . ..         .  .  .   .  . . .
...  .       .  . .  ..                 . .       .                 .       X    .
.   .       ... ..    .    .   .  . . .     .  .  .        .  ..      ..     .   .
.  ..  . .    .   .    ..            ..                 .   . .     .   .   .  ...
.  .                ..    ...  . .     .      .    .     .... .  . ..     ...  . .
. .   .   .                   . . .  .    .    . .      ...               . . . ..
..................................................................................
