...............................
.       .. .   . .      ..    .
.  .  .. . .     .   .        .
.     .  .. .    ..  .      ...
..                   . . .  . .
..  . .    ..   .         .   .
.  ..     .   .      .X       .
..    .  S.      ..     . .   .
. ....  .          ..   .  .  .
.   ..      .         .  .    .
.     . .            ...  .   .
.....            .  .   ..    .
.        . .     .    .       .
..  .  .     .   .            .
.             .          .    .
. . .  ...    . .  . . . .    .
.             .  .   .        .
.        .         .   .  .  ..
. .       . ...     ..   . .  .
.          ..       .         .
...............................
