............................................................................
..  .   . .. .   .   ..    . .      .      .          .     .              .
..  .  .   ..   .    ..          .     .         . . . .               .   .
.                 .   ..           .           . .      .  . .       .   . .
.    .  .  .  .. .  . .   .  .                .           . .           . ..
.  .       . .   .  ..    .    .   .    .  .      .    .               . . .
.        . .                      .     .  .     . . .     ..       .  ... .
.   .. . .    . .              ..                 ..          .           ..
.    .                      .         .     .  .. .   .                .  ..
.            .    .  .     .. .           .  .                         .  ..
.   .  ..      .      .       .  .   X     .      .        .       .      ..
.  .                   .       ..    . .       .      .      .            ..
...        .   ...   .   .     .    . .          ..  ..   .    .        . ..
.                 .     .       .     . . ..  . . ..              .    .   .
. ..      .                                . .  .      .S        .         .
.       .  ..    .     .          ..         . .   .   . .     . . .       .
.         . ...        .    .   .                ....             .  . .   .
...      .      .   .   ..     .  .      .     .   .           .  . .      .
.  . .       .       . .        . .        .  .      .   .   .          .. .
.        .. .      ..    .  . .        .    ..              .           .  .
.                   .                     .   .        . ..      . ..   . ..
.               .                      .. ..     .     . .       . .       .
............................................................................
