..............................
.. .            .            .
..        .            .     .
.          .     .           .
. .                 .      ...
.   .                .     ...
.    .  .         .    .     .
..            ..    .    ... .
. .       .        ..   .    .
.                     .     ..
.           .     X     ..   .
.                       . .  .
..   .    .       . .        .
.         .         .        .
.       . .  ...   .  .    . .
.  .                         .
.   . .   .      .  S     . ..
.   .     .                  .
. .         .       .       ..
.. .   .                .    .
..............................
