.......................................
.        .     .  .     .          . ..
.    .    .     .  .X  . ..  . .      .
.     .        .   . .         ..   . .
..   ..               .    .        ...
.          ..      .   ..             .
.. .     .  ..    ..               .  .
..    .   ...     .          .        .
.    ..     .   .    .   .      . .  ..
.    .    . .  .    ..      .       . .
.        ..     .  .             S .. .
.       . .       ..  .  .  .         .
.  . .   . .    .              .   . ..
.            ...   .    .          .  .
. ... ....  ..            ..    .     .
.     .  .    ... .  ..   .  .       ..
.      .  .. . . . .        ..       ..
. .  ..         .  .  .  ..  .        .
.        . .... .  . . .      ..    ...
..  .. ... .   .    . ..              .
.     .  .. .  .  .   .    .        ...
.  .       .. .                .    . .
.  ..  .     .    .      . .  .   .  ..
.......................................
