.........................................................................................................................
.  .          . . .    ..          . .      .       .      .      .               .               .     .       .     . .
.          .      .  .. .  .       .                ..      ...    .          .           .  .      . .       ..    .  ..
.   .  .   .. .         .  .        S.                            ..   .   .          ..        .  .    . .        .    .
.  .    .  .   .        .  .      .  X    .     . .     .      .      .            .   .     .    .      ...    .       .
. ..   .        .     . .         ...   .  . .        .    . .        . . .     . . . .       .. . .       . ..   .  . ..
. .   .           .        ..                .. .          . . . .   .     .   ... .   .    . .    . ..         .  .    .
.   .  .  .     .   .    ...  . .    .   .   . .  .  .              .   ..    .        .     .           .              .
.   .  .   .   .   ...       ...   .            ..  .  ..   .   .. .    .. ..         .    .         .....     ..     . .
.       .       .    .       .  .     ..      .  .   .            .     ..   .  .                          .           ..
.   . .. .  . .  .   . .        .          .  .      .  ..   .    .  .  . .        .       .    .  ..        . .        .
.........................................................................................................................
