.......................................
.        .   ......                   .
.   .. .   ..    .    .              ..
.   . ..  . .     .  ..  .    ..      .
..  ..   ..       .          .  .     .
... .  .   . .         .         .    .
.         .    .  .          ..  .  . .
.       .         .         .    .    .
.     ..  .       . ..     . .  .  .  .
.       ..   .            ..  .  ..   .
...  .           .       ..           .
.        .    .      . .   .         ..
.   . ..  .                     .  .. .
..      ..      .          .    ..   ..
..   .  .  .         .          .   . .
. .          . .        .. .   .     ..
.      ..  .   ...   ...       .S     .
.        .    . ... . .      . ..  .  .
.     .             .      .     . .  .
.       X.         .       .     .    .
. .      .            . .  .   .      .
.     ..     .    .       .  .      ...
.......................................
